;PROVINSI;KABUPATEN;KECAMATAN;KELURAHAN;JUMLAH BUMIL;BUMIL TERDAMPINGI;BUMIL TIDAK TERDAMPINGI;JUMLAH BUMIL >=32 MINGGU;BUMIL >=32 MINGGU MENDAPAT INFORMASI KONTRASEPSI;BUMIL >=32 MINGGU TIDAK MENDAPAT INFORMASI KONTRASEPSI;BUMIL >=32 MINGGU AKAN KBPP;BUMIL >=32 MINGGU MEMUTUSKAN TIDAK KBPP;MENDAPATKAN TTD;TIDAK MENDAPATKAN TTD;MENGKOMSUMSI TTD;TIDAK MENGKOMSUMSI TTD;KIE PERSEORANGAN;KIE KELOMPOK;KIE PERSEORANGAN DAN KELOMPOK;TIDAK MENDAPAT KIE;MENDAPAT FASILITASI RUJUKAN;TIDAK MENDAPAT FASILITASI RUJUKAN;MENDAPAT FASILITASI BANSOS;TIDAK MENDAPAT FASILITASI BANSOS
0;SULAWESI BARAT;PASANGKAYU;BAMBAIRA;BAMBAIRA;36;40;-4;30;20;2;16;6;40;0;40;0;40;0;0;0;5;35;15;25
1;SULAWESI BARAT;PASANGKAYU;BAMBAIRA;KASOLOANG;9;0;9;0;0;0;0;0;0;0;0;0;0;0;0;0;0;0;0;0
2;SULAWESI BARAT;PASANGKAYU;BAMBAIRA;TAMPAURE;16;7;9;3;2;0;2;0;7;0;7;0;7;0;0;0;2;5;2;5
3;SULAWESI BARAT;PASANGKAYU;BAMBAIRA;KALUKU NANGKA;30;6;24;6;3;0;1;2;6;0;6;0;6;0;0;0;2;4;5;1
4;SULAWESI BARAT;PASANGKAYU;BAMBALAMOTU;BAMBALAMOTU;21;7;14;0;0;0;0;0;7;0;7;0;7;0;0;0;0;7;2;5
5;SULAWESI BARAT;PASANGKAYU;BAMBALAMOTU;POLEWALI;44;9;35;3;1;0;1;0;9;0;9;0;1;0;7;1;4;5;2;7
6;SULAWESI BARAT;PASANGKAYU;BAMBALAMOTU;RANDOMAYANG;31;12;19;2;2;0;2;0;12;0;12;0;12;0;0;0;0;12;2;10
7;SULAWESI BARAT;PASANGKAYU;BAMBALAMOTU;PANGIANG;10;0;10;0;0;0;0;0;0;0;0;0;0;0;0;0;0;0;0;0
8;SULAWESI BARAT;PASANGKAYU;BAMBALAMOTU;KALOLA;33;0;33;0;0;0;0;0;0;0;0;0;0;0;0;0;0;0;0;0
9;SULAWESI BARAT;PASANGKAYU;BAMBALAMOTU;WULAI;10;1;9;0;0;0;0;0;1;0;1;0;1;0;0;0;0;1;0;1
10;SULAWESI BARAT;PASANGKAYU;BARAS;BARAS;20;0;20;0;0;0;0;0;0;0;0;0;0;0;0;0;0;0;0;0
11;SULAWESI BARAT;PASANGKAYU;BARAS;BALANTI;30;12;18;1;1;0;1;0;11;1;11;1;12;0;0;0;0;12;1;11
12;SULAWESI BARAT;PASANGKAYU;BARAS;MOTU;18;0;18;0;0;0;0;0;0;0;0;0;0;0;0;0;0;0;0;0
13;SULAWESI BARAT;PASANGKAYU;BARAS;BULU PARIGI;10;2;8;0;0;0;0;0;2;0;2;0;1;0;1;0;0;2;0;2
14;SULAWESI BARAT;PASANGKAYU;BARAS;TOWONI;6;1;5;1;1;0;1;0;1;0;1;0;1;0;0;0;0;1;0;1
15;SULAWESI BARAT;PASANGKAYU;BARAS;KASANO;17;0;17;0;0;0;0;0;0;0;0;0;0;0;0;0;0;0;0;0
16;SULAWESI BARAT;PASANGKAYU;BULU TABA;LILIMORI;13;0;13;0;0;0;0;0;0;0;0;0;0;0;0;0;0;0;0;0
17;SULAWESI BARAT;PASANGKAYU;BULU TABA;KARAVE;14;0;14;0;0;0;0;0;0;0;0;0;0;0;0;0;0;0;0;0
18;SULAWESI BARAT;PASANGKAYU;BULU TABA;BUKIT HARAPAN;10;0;10;0;0;0;0;0;0;0;0;0;0;0;0;0;0;0;0;0
19;SULAWESI BARAT;PASANGKAYU;BULU TABA;KASTABUANA;10;0;10;0;0;0;0;0;0;0;0;0;0;0;0;0;0;0;0;0
20;SULAWESI BARAT;PASANGKAYU;BULU TABA;SUMBER SARI;4;0;4;0;0;0;0;0;0;0;0;0;0;0;0;0;0;0;0;0
21;SULAWESI BARAT;PASANGKAYU;BULU TABA;LELEJAE;16;0;16;0;0;0;0;0;0;0;0;0;0;0;0;0;0;0;0;0
22;SULAWESI BARAT;PASANGKAYU;BULU TABA;OMPI;2;0;2;0;0;0;0;0;0;0;0;0;0;0;0;0;0;0;0;0
23;SULAWESI BARAT;PASANGKAYU;DAPURANG;DAPURANG;39;14;25;5;1;0;1;0;14;0;13;1;14;0;0;0;2;12;1;13
24;SULAWESI BARAT;PASANGKAYU;DAPURANG;BENGGAULU;24;6;18;3;1;2;3;0;6;0;6;0;6;0;0;0;4;2;0;6
25;SULAWESI BARAT;PASANGKAYU;DAPURANG;TIRTABUANA;3;0;3;0;0;0;0;0;0;0;0;0;0;0;0;0;0;0;0;0
26;SULAWESI BARAT;PASANGKAYU;DAPURANG;BULU BONGGU;19;22;-3;13;3;1;4;0;22;0;22;0;22;0;0;0;0;22;0;22
27;SULAWESI BARAT;PASANGKAYU;DAPURANG;SARASA;12;0;12;0;0;0;0;0;0;0;0;0;0;0;0;0;0;0;0;0
28;SULAWESI BARAT;PASANGKAYU;DURIPOKU;TAMMARUNANG;12;3;9;2;2;0;0;2;3;0;3;0;3;0;0;0;0;3;0;3
29;SULAWESI BARAT;PASANGKAYU;DURIPOKU;SAPTANAJAYA;6;3;3;2;2;0;2;0;3;0;3;0;3;0;0;0;0;3;0;3
30;SULAWESI BARAT;PASANGKAYU;DURIPOKU;TARANGGI;8;2;6;1;1;0;1;0;2;0;2;0;1;1;0;0;2;0;0;2
31;SULAWESI BARAT;PASANGKAYU;DURIPOKU;SIPAKAINGA;10;0;10;0;0;0;0;0;0;0;0;0;0;0;0;0;0;0;0;0
32;SULAWESI BARAT;PASANGKAYU;LARIANG;PARABU;9;10;-1;3;1;0;1;0;10;0;10;0;9;0;1;0;4;6;3;7
33;SULAWESI BARAT;PASANGKAYU;LARIANG;KENANGAN;3;3;0;1;0;0;0;0;3;0;3;0;3;0;0;0;0;3;0;3
34;SULAWESI BARAT;PASANGKAYU;LARIANG;BAJAWALI;4;12;-8;8;2;0;2;0;12;0;12;0;9;1;0;2;1;11;1;11
35;SULAWESI BARAT;PASANGKAYU;LARIANG;SINGGANI;10;15;-5;11;5;0;5;0;15;0;15;0;13;0;2;0;14;1;3;12
36;SULAWESI BARAT;PASANGKAYU;LARIANG;KULU;8;11;-3;6;5;0;5;0;11;0;11;0;10;1;0;0;1;10;11;0
37;SULAWESI BARAT;PASANGKAYU;LARIANG;BATU MATORU;4;6;-2;4;3;0;1;2;6;0;6;0;6;0;0;0;6;0;0;6
38;SULAWESI BARAT;PASANGKAYU;LARIANG;BAMBAKORO;21;12;9;6;5;1;4;2;12;0;12;0;12;0;0;0;0;12;10;2
39;SULAWESI BARAT;PASANGKAYU;PASANGKAYU;PASANGKAYU;71;2;69;0;0;0;0;0;2;0;2;0;2;0;0;0;1;1;2;0
40;SULAWESI BARAT;PASANGKAYU;PASANGKAYU;MARTAJAYA;8;0;8;0;0;0;0;0;0;0;0;0;0;0;0;0;0;0;0;0
41;SULAWESI BARAT;PASANGKAYU;PASANGKAYU;PAKAVA;8;0;8;0;0;0;0;0;0;0;0;0;0;0;0;0;0;0;0;0
42;SULAWESI BARAT;PASANGKAYU;PASANGKAYU;KARYA BERSAMA;20;10;10;9;7;0;7;0;10;0;10;0;10;0;0;0;7;3;4;6
43;SULAWESI BARAT;PASANGKAYU;PASANGKAYU;AKO;16;17;-1;13;6;1;5;2;17;0;17;0;17;0;0;0;2;15;2;15
44;SULAWESI BARAT;PASANGKAYU;PASANGKAYU;GUNUNG SARI;2;0;2;0;0;0;0;0;0;0;0;0;0;0;0;0;0;0;0;0
45;SULAWESI BARAT;PASANGKAYU;PEDONGGA;MALEI;17;4;13;3;3;0;0;3;4;0;4;0;4;0;0;0;0;4;0;4
46;SULAWESI BARAT;PASANGKAYU;PEDONGGA;PEDANDA;8;6;2;4;0;0;0;0;6;0;6;0;6;0;0;0;5;1;0;6
47;SULAWESI BARAT;PASANGKAYU;PEDONGGA;BATU OGE;13;2;11;1;0;0;0;0;2;0;2;0;2;0;0;0;1;1;0;2
48;SULAWESI BARAT;PASANGKAYU;PEDONGGA;MARTASARI;9;0;9;0;0;0;0;0;0;0;0;0;0;0;0;0;0;0;0;0
49;SULAWESI BARAT;PASANGKAYU;SARJO;SARJO;28;0;28;0;0;0;0;0;0;0;0;0;0;0;0;0;0;0;0;0
50;SULAWESI BARAT;PASANGKAYU;SARJO;MAPONU;4;0;4;0;0;0;0;0;0;0;0;0;0;0;0;0;0;0;0;0
51;SULAWESI BARAT;PASANGKAYU;SARJO;LETAWA;17;0;17;0;0;0;0;0;0;0;0;0;0;0;0;0;0;0;0;0
52;SULAWESI BARAT;PASANGKAYU;SARJO;SARUDE;8;0;8;0;0;0;0;0;0;0;0;0;0;0;0;0;0;0;0;0
53;SULAWESI BARAT;PASANGKAYU;SARUDU;SARUDU;60;14;46;7;7;0;7;0;14;0;14;0;14;0;0;0;14;0;14;0
54;SULAWESI BARAT;PASANGKAYU;SARUDU;BULU MARIO;35;42;-7;34;27;0;7;20;42;0;42;0;42;0;0;0;0;42;9;33
55;SULAWESI BARAT;PASANGKAYU;SARUDU;KUMASARI;20;5;15;1;1;0;0;1;5;0;5;0;3;0;2;0;2;3;0;5
56;SULAWESI BARAT;PASANGKAYU;SARUDU;PATIKA;4;6;-2;3;3;0;3;0;6;0;6;0;5;0;1;0;1;5;0;6
57;SULAWESI BARAT;PASANGKAYU;SARUDU;DODA;10;1;9;1;0;0;0;0;1;0;1;0;1;0;0;0;1;0;1;0
58;SULAWESI BARAT;PASANGKAYU;TIKKE RAYA;TIKKE;17;18;-1;7;4;0;3;1;18;0;18;0;13;5;0;0;1;17;0;18
59;SULAWESI BARAT;PASANGKAYU;TIKKE RAYA;MAKMUR JAYA;7;6;1;4;1;0;1;0;6;0;6;0;6;0;0;0;0;6;0;6
60;SULAWESI BARAT;PASANGKAYU;TIKKE RAYA;LARIANG;21;20;1;5;1;0;0;1;20;0;20;0;20;0;0;0;13;7;11;9
61;SULAWESI BARAT;PASANGKAYU;TIKKE RAYA;PAJALELE;19;21;-2;13;11;0;6;5;21;0;21;0;21;0;0;0;1;20;0;21
62;SULAWESI BARAT;PASANGKAYU;TIKKE RAYA;JENGENG RAYA;14;6;8;1;1;0;1;0;6;0;5;1;6;0;0;0;0;6;0;6
63;SULAWESI BARAT;MAMUJU;MAMUJU;BINANGA;17;3;14;2;2;0;1;1;3;0;3;0;3;0;0;0;0;3;0;3
64;SULAWESI BARAT;MAMUJU;MAMUJU;MAMUNYU;27;19;8;5;3;0;3;0;19;0;19;0;11;7;1;0;0;19;12;7
65;SULAWESI BARAT;MAMUJU;MAMUJU;KAREMA;45;14;31;9;7;0;7;0;13;1;13;1;4;2;8;0;2;12;4;10
66;SULAWESI BARAT;MAMUJU;MAMUJU;RIMUKU;25;30;-5;23;17;0;15;2;30;0;30;0;13;3;14;0;5;25;2;28
67;SULAWESI BARAT;MAMUJU;MAMUJU;BAMBU;8;0;8;0;0;0;0;0;0;0;0;0;0;0;0;0;0;0;0;0
68;SULAWESI BARAT;MAMUJU;MAMUJU;KARAMPUANG;22;4;18;2;2;0;2;0;4;0;4;0;4;0;0;0;2;2;4;0
69;SULAWESI BARAT;MAMUJU;MAMUJU;TADUI;38;45;-7;27;15;0;15;0;45;0;45;0;24;0;21;0;0;45;15;30
70;SULAWESI BARAT;MAMUJU;MAMUJU;BATU PANNU;3;0;3;0;0;0;0;0;0;0;0;0;0;0;0;0;0;0;0;0
71;SULAWESI BARAT;MAMUJU;TAPALANG;GALUNG;25;11;14;6;4;0;3;1;10;1;10;1;11;0;0;0;0;11;7;4
72;SULAWESI BARAT;MAMUJU;TAPALANG;KASAMBANG;10;12;-2;9;8;0;8;0;11;1;11;1;12;0;0;0;0;12;0;12
73;SULAWESI BARAT;MAMUJU;TAPALANG;DAYANGINNA;27;12;15;4;3;0;1;2;9;3;9;3;12;0;0;0;0;12;0;12
74;SULAWESI BARAT;MAMUJU;TAPALANG;OROBATU;5;10;-5;3;3;0;2;1;10;0;10;0;10;0;0;0;4;6;9;1
75;SULAWESI BARAT;MAMUJU;TAPALANG;TAKANDEANG;24;0;24;0;0;0;0;0;0;0;0;0;0;0;0;0;0;0;0;0
76;SULAWESI BARAT;MAMUJU;TAPALANG;BELA;4;0;4;0;0;0;0;0;0;0;0;0;0;0;0;0;0;0;0;0
77;SULAWESI BARAT;MAMUJU;TAPALANG;TAAN;29;16;13;5;4;0;4;0;16;0;16;0;14;1;1;0;13;3;15;1
78;SULAWESI BARAT;MAMUJU;TAPALANG;TAMPALANG;21;2;19;1;1;0;1;0;2;0;2;0;2;0;0;0;0;2;0;2
79;SULAWESI BARAT;MAMUJU;TAPALANG;RANTEDODA;23;29;-6;19;14;0;10;4;22;7;22;7;25;1;3;0;2;27;1;28
80;SULAWESI BARAT;MAMUJU;TAPALANG;KOPEANG;0;0;0;0;0;0;0;0;0;0;0;0;0;0;0;0;0;0;0;0
;SULAWESI BARAT;MAMUJU;KALUKKU;SINYONYOI;21;9;12;8;6;0;5;1;9;0;9;0;9;0;0;0;2;7;3;6
;SULAWESI BARAT;MAMUJU;KALUKKU;BEBANGA;57;7;50;4;3;0;1;2;7;0;7;0;2;4;1;0;5;2;0;7
;SULAWESI BARAT;MAMUJU;KALUKKU;KALUKKU;51;19;32;16;3;0;3;0;19;0;19;0;19;0;0;0;0;19;8;11
;SULAWESI BARAT;MAMUJU;KALUKKU;SINYONYOI SELATAN;20;0;20;0;0;0;0;0;0;0;0;0;0;0;0;0;0;0;0;0
;SULAWESI BARAT;MAMUJU;KALUKKU;SONDOANG;15;0;15;0;0;0;0;0;0;0;0;0;0;0;0;0;0;0;0;0
;SULAWESI BARAT;MAMUJU;KALUKKU;BERU-BERU;52;26;26;13;10;0;10;0;26;0;26;0;26;0;0;0;1;25;3;23
;SULAWESI BARAT;MAMUJU;KALUKKU;BELANG BELANG;16;15;1;9;5;1;6;0;15;0;15;0;9;6;0;0;6;9;10;5
;SULAWESI BARAT;MAMUJU;KALUKKU;KABULOANG;26;19;7;11;7;0;7;0;19;0;18;1;15;1;3;0;7;12;6;13
;SULAWESI BARAT;MAMUJU;KALUKKU;KEANG;2;0;2;0;0;0;0;0;0;0;0;0;0;0;0;0;0;0;0;0
;SULAWESI BARAT;MAMUJU;KALUKKU;POKKANG;18;19;-1;9;6;0;6;0;19;0;19;0;18;1;0;0;19;0;3;16
81;SULAWESI BARAT;MAMUJU;KALUKKU;GULILING;15;18;-3;7;8;0;7;1;18;0;18;0;17;1;0;0;18;0;1;17
82;SULAWESI BARAT;MAMUJU;KALUKKU;UHAIMATE;7;1;6;1;1;0;1;0;1;0;1;0;1;0;0;0;1;0;1;0
83;SULAWESI BARAT;MAMUJU;KALUKKU;KALUKKU BARAT;27;1;26;1;1;0;1;0;1;0;1;0;0;0;1;0;1;0;1;0
84;SULAWESI BARAT;MAMUJU;KALUKKU;PAMMULUKANG;22;14;8;3;2;0;1;1;9;5;9;5;11;1;1;1;0;14;0;14
87;SULAWESI BARAT;MAMUJU;BONEHAU;BONEHAU;12;0;12;0;0;0;0;0;0;0;0;0;0;0;0;0;0;0;0;0
88;SULAWESI BARAT;MAMUJU;BONEHAU;SALUTIWO;6;0;6;0;0;0;0;0;0;0;0;0;0;0;0;0;0;0;0;0
89;SULAWESI BARAT;MAMUJU;BONEHAU;BUTTUADA;6;0;6;0;0;0;0;0;0;0;0;0;0;0;0;0;0;0;0;0
90;SULAWESI BARAT;MAMUJU;BONEHAU;TAMALEA;8;11;-3;5;4;0;4;0;11;0;11;0;11;0;0;0;11;0;11;0
91;SULAWESI BARAT;MAMUJU;BONEHAU;LUMIKA;8;1;7;0;0;0;0;0;1;0;1;0;1;0;0;0;0;1;1;0
92;SULAWESI BARAT;MAMUJU;BONEHAU;MAPPU;2;0;2;0;0;0;0;0;0;0;0;0;0;0;0;0;0;0;0;0
93;SULAWESI BARAT;MAMUJU;BONEHAU;BANUADA;10;0;10;0;0;0;0;0;0;0;0;0;0;0;0;0;0;0;0;0
94;SULAWESI BARAT;MAMUJU;BONEHAU;HINUA;6;5;1;5;4;0;4;0;5;0;5;0;0;0;5;0;5;0;5;0
95;SULAWESI BARAT;MAMUJU;BONEHAU;KINATANG;6;11;-5;5;4;0;4;0;11;0;11;0;7;3;1;0;0;11;0;11
96;SULAWESI BARAT;MAMUJU;KALUMPANG;KALUMPANG;2;0;2;0;0;0;0;0;0;0;0;0;0;0;0;0;0;0;0;0
97;SULAWESI BARAT;MAMUJU;KALUMPANG;KARATAUN;1;0;1;0;0;0;0;0;0;0;0;0;0;0;0;0;0;0;0;0
98;SULAWESI BARAT;MAMUJU;KALUMPANG;KARAMA;4;0;4;0;0;0;0;0;0;0;0;0;0;0;0;0;0;0;0;0
99;SULAWESI BARAT;MAMUJU;KALUMPANG;SIRAUN;1;0;1;0;0;0;0;0;0;0;0;0;0;0;0;0;0;0;0;0
100;SULAWESI BARAT;MAMUJU;KALUMPANG;TUMOGA;2;0;2;0;0;0;0;0;0;0;0;0;0;0;0;0;0;0;0;0
101;SULAWESI BARAT;MAMUJU;KALUMPANG;SALUMAKKI;0;0;0;0;0;0;0;0;0;0;0;0;0;0;0;0;0;0;0;0
102;SULAWESI BARAT;MAMUJU;KALUMPANG;POLIO;4;0;4;0;0;0;0;0;0;0;0;0;0;0;0;0;0;0;0;0
103;SULAWESI BARAT;MAMUJU;KALUMPANG;LIMBONG;4;0;4;0;0;0;0;0;0;0;0;0;0;0;0;0;0;0;0;0
104;SULAWESI BARAT;MAMUJU;KALUMPANG;SANDAPANG;4;0;4;0;0;0;0;0;0;0;0;0;0;0;0;0;0;0;0;0
105;SULAWESI BARAT;MAMUJU;KALUMPANG;KONDO BULO;2;0;2;0;0;0;0;0;0;0;0;0;0;0;0;0;0;0;0;0
106;SULAWESI BARAT;MAMUJU;KALUMPANG;MAKKALIKI;1;0;1;0;0;0;0;0;0;0;0;0;0;0;0;0;0;0;0;0
107;SULAWESI BARAT;MAMUJU;KALUMPANG;BATU MAKKADA;4;0;4;0;0;0;0;0;0;0;0;0;0;0;0;0;0;0;0;0
108;SULAWESI BARAT;MAMUJU;KALUMPANG;LASA';3;0;3;0;0;0;0;0;0;0;0;0;0;0;0;0;0;0;0;0
109;SULAWESI BARAT;MAMUJU;KEP. BALA BALAKANG;BALA BALAKANG;2;0;2;0;0;0;0;0;0;0;0;0;0;0;0;0;0;0;0;0
110;SULAWESI BARAT;MAMUJU;KEP. BALA BALAKANG;BALA-BALAKANG TIMUR;4;0;4;0;0;0;0;0;0;0;0;0;0;0;0;0;0;0;0;0
111;SULAWESI BARAT;MAMUJU;SAMPAGA;BUNDE;34;0;34;0;0;0;0;0;0;0;0;0;0;0;0;0;0;0;0;0
112;SULAWESI BARAT;MAMUJU;SAMPAGA;KALONDING;19;0;19;0;0;0;0;0;0;0;0;0;0;0;0;0;0;0;0;0
113;SULAWESI BARAT;MAMUJU;SAMPAGA;TARAILU;12;0;12;0;0;0;0;0;0;0;0;0;0;0;0;0;0;0;0;0
114;SULAWESI BARAT;MAMUJU;SAMPAGA;SAMPAGA;14;0;14;0;0;0;0;0;0;0;0;0;0;0;0;0;0;0;0;0
115;SULAWESI BARAT;MAMUJU;SAMPAGA;TANAMBUAH;4;2;2;2;2;0;2;0;2;0;2;0;2;0;0;0;0;2;0;2
116;SULAWESI BARAT;MAMUJU;SAMPAGA;SALUBARANA;3;1;2;0;0;0;0;0;1;0;1;0;1;0;0;0;1;0;0;1
117;SULAWESI BARAT;MAMUJU;SAMPAGA;LOSSO;3;0;3;0;0;0;0;0;0;0;0;0;0;0;0;0;0;0;0;0
118;SULAWESI BARAT;MAMUJU;PAPALANG;TOABO;32;51;-19;28;17;0;17;0;51;0;51;0;50;0;1;0;19;32;19;32
119;SULAWESI BARAT;MAMUJU;PAPALANG;PAPALANG;49;20;29;2;0;0;0;0;17;3;16;4;19;0;0;1;19;1;12;8
120;SULAWESI BARAT;MAMUJU;PAPALANG;BONDA;15;0;15;0;0;0;0;0;0;0;0;0;0;0;0;0;0;0;0;0
121;SULAWESI BARAT;MAMUJU;PAPALANG;TOPORE;22;1;21;0;0;0;0;0;1;0;1;0;1;0;0;0;1;0;0;1
122;SULAWESI BARAT;MAMUJU;PAPALANG;SALUKAYU;21;21;0;11;8;2;7;3;21;0;21;0;21;0;0;0;2;19;1;20
123;SULAWESI BARAT;MAMUJU;PAPALANG;SUKADAMAI;4;9;-5;6;6;0;6;0;9;0;9;0;4;0;5;0;9;0;9;0
124;SULAWESI BARAT;MAMUJU;PAPALANG;BODA-BODA;18;5;13;1;1;0;1;0;5;0;5;0;5;0;0;0;0;5;5;0
125;SULAWESI BARAT;MAMUJU;PAPALANG;SISANGO;2;4;-2;3;2;0;2;0;4;0;4;0;4;0;0;0;2;2;2;2
126;SULAWESI BARAT;MAMUJU;PAPALANG;BATU AMPA;21;13;8;1;1;0;1;0;13;0;13;0;1;12;0;0;10;3;2;11
127;SULAWESI BARAT;MAMUJU;SIMBORO;SIMBORO;100;17;83;12;6;0;6;0;16;1;16;1;17;0;0;0;6;11;1;16
128;SULAWESI BARAT;MAMUJU;SIMBORO;RANGAS;28;17;11;7;5;0;5;0;15;2;15;2;16;0;1;0;6;11;3;14
129;SULAWESI BARAT;MAMUJU;SIMBORO;BOTTENG;15;2;13;1;1;0;1;0;2;0;2;0;2;0;0;0;0;2;1;1
130;SULAWESI BARAT;MAMUJU;SIMBORO;SALETTO;17;11;6;8;5;0;5;0;11;0;11;0;10;0;0;1;3;8;5;6
131;SULAWESI BARAT;MAMUJU;SIMBORO;SUMARE;27;42;-15;25;20;0;20;0;42;0;38;4;3;34;0;5;2;40;1;41
132;SULAWESI BARAT;MAMUJU;SIMBORO;BOTTENG UTARA;34;28;6;14;5;0;4;1;26;2;26;2;7;1;20;0;0;28;13;15
133;SULAWESI BARAT;MAMUJU;SIMBORO;TAPANDULLU;3;0;3;0;0;0;0;0;0;0;0;0;0;0;0;0;0;0;0;0
134;SULAWESI BARAT;MAMUJU;SIMBORO;PATI'DI;12;7;5;4;1;0;1;0;7;0;7;0;4;3;0;0;7;0;7;0
135;SULAWESI BARAT;MAMUJU;TAPALANG BARAT;DUNGKAIT;9;0;9;0;0;0;0;0;0;0;0;0;0;0;0;0;0;0;0;0
136;SULAWESI BARAT;MAMUJU;TAPALANG BARAT;LEBANI;3;0;3;0;0;0;0;0;0;0;0;0;0;0;0;0;0;0;0;0
137;SULAWESI BARAT;MAMUJU;TAPALANG BARAT;LABUANG RANO;15;7;8;0;0;0;0;0;7;0;7;0;2;0;5;0;3;4;7;0
138;SULAWESI BARAT;MAMUJU;TAPALANG BARAT;PASABU;21;34;-13;15;12;0;8;4;31;3;31;3;34;0;0;0;5;29;9;25
139;SULAWESI BARAT;MAMUJU;TAPALANG BARAT;TANETE PAO;3;0;3;0;0;0;0;0;0;0;0;0;0;0;0;0;0;0;0;0
140;SULAWESI BARAT;MAMUJU;TAPALANG BARAT;PANGASAAN;8;3;5;1;1;0;1;0;3;0;3;0;0;0;3;0;0;3;0;3
141;SULAWESI BARAT;MAMUJU;TAPALANG BARAT;AHU;31;8;23;4;3;0;0;3;8;0;8;0;1;0;7;0;2;6;0;8
142;SULAWESI BARAT;MAMUJU;TOMMO;TOMMO;13;0;13;0;0;0;0;0;0;0;0;0;0;0;0;0;0;0;0;0
143;SULAWESI BARAT;MAMUJU;TOMMO;CAMPALOGA;16;3;13;2;2;0;2;0;3;0;3;0;0;0;3;0;3;0;0;3
144;SULAWESI BARAT;MAMUJU;TOMMO;BUANA SAKTI;21;18;3;9;9;0;9;0;18;0;18;0;17;0;1;0;8;10;3;15
145;SULAWESI BARAT;MAMUJU;TOMMO;TAMEMONGGA;3;1;2;0;0;0;0;0;1;0;1;0;1;0;0;0;0;1;0;1
146;SULAWESI BARAT;MAMUJU;TOMMO;TAMEJARRA;27;10;17;3;1;0;0;1;10;0;10;0;3;0;7;0;3;7;1;9
147;SULAWESI BARAT;MAMUJU;TOMMO;RANTEMARIO;17;0;17;0;0;0;0;0;0;0;0;0;0;0;0;0;0;0;0;0
148;SULAWESI BARAT;MAMUJU;TOMMO;MALINO;9;5;4;2;2;0;1;1;5;0;5;0;5;0;0;0;5;0;2;3
149;SULAWESI BARAT;MAMUJU;TOMMO;KAKULLASANG;13;0;13;0;0;0;0;0;0;0;0;0;0;0;0;0;0;0;0;0
150;SULAWESI BARAT;MAMUJU;TOMMO;LELING;16;14;2;9;3;7;9;1;14;0;14;0;14;0;0;0;3;11;12;2
151;SULAWESI BARAT;MAMUJU;TOMMO;KALEPU;11;1;10;0;0;0;0;0;1;0;1;0;1;0;0;0;1;0;0;1
152;SULAWESI BARAT;MAMUJU;TOMMO;SANDANA;5;0;5;0;0;0;0;0;0;0;0;0;0;0;0;0;0;0;0;0
153;SULAWESI BARAT;MAMUJU;TOMMO;LELING BARAT;9;3;6;0;0;0;0;0;3;0;3;0;0;0;3;0;3;0;3;0
154;SULAWESI BARAT;MAMUJU;TOMMO;LELING UTARA;9;0;9;0;0;0;0;0;0;0;0;0;0;0;0;0;0;0;0;0
155;SULAWESI BARAT;MAMUJU;TOMMO;SALUDENGEN;5;0;5;0;0;0;0;0;0;0;0;0;0;0;0;0;0;0;0;0
156;SULAWESI BARAT;MAJENE;BANGGAE;BANGGAE;26;1;25;1;1;0;1;0;1;0;1;0;1;0;0;0;0;1;1;0
157;SULAWESI BARAT;MAJENE;BANGGAE;BARU;30;0;30;0;0;0;0;0;0;0;0;0;0;0;0;0;0;0;0;0
158;SULAWESI BARAT;MAJENE;BANGGAE;PANGALI ALI;66;3;63;1;1;0;0;1;3;0;3;0;3;0;0;0;3;0;3;0
159;SULAWESI BARAT;MAJENE;BANGGAE;TOTOLI;33;1;32;1;1;0;1;0;1;0;1;0;1;0;0;0;0;1;0;1
160;SULAWESI BARAT;MAJENE;BANGGAE;RANGAS;49;0;49;0;0;0;0;0;0;0;0;0;0;0;0;0;0;0;0;0
161;SULAWESI BARAT;MAJENE;BANGGAE;GALUNG;13;17;-4;9;4;2;4;2;17;0;17;0;17;0;0;0;8;9;6;11
162;SULAWESI BARAT;MAJENE;BANGGAE;PALIPI SOREANG;18;3;15;0;0;0;0;0;3;0;3;0;3;0;0;0;0;3;1;2
163;SULAWESI BARAT;MAJENE;BANGGAE;PAMBOBORANG;22;0;22;0;0;0;0;0;0;0;0;0;0;0;0;0;0;0;0;0
164;SULAWESI BARAT;MAJENE;MALUNDA;MALUNDA;12;7;5;3;3;0;2;1;6;1;6;1;7;0;0;0;1;6;1;6
165;SULAWESI BARAT;MAJENE;MALUNDA;LAMUNGANG BATU;22;0;22;0;0;0;0;0;0;0;0;0;0;0;0;0;0;0;0;0
166;SULAWESI BARAT;MAJENE;MALUNDA;BAMBANGAN;15;10;5;1;1;0;0;1;10;0;10;0;8;0;2;0;1;9;8;2
167;SULAWESI BARAT;MAJENE;MALUNDA;LOMBANG;10;0;10;0;0;0;0;0;0;0;0;0;0;0;0;0;0;0;0;0
168;SULAWESI BARAT;MAJENE;MALUNDA;LOMBONG;28;21;7;2;2;0;2;0;21;0;21;0;1;0;20;0;15;6;19;2
169;SULAWESI BARAT;MAJENE;MALUNDA;MEKKATTA;23;7;16;1;2;0;1;1;7;0;7;0;3;1;3;0;7;0;7;0
170;SULAWESI BARAT;MAJENE;MALUNDA;MALIAYA;20;0;20;0;0;0;0;0;0;0;0;0;0;0;0;0;0;0;0;0
171;SULAWESI BARAT;MAJENE;MALUNDA;LOMBANG TIMUR;7;6;1;2;1;1;1;1;6;0;6;0;6;0;0;0;6;0;2;4
172;SULAWESI BARAT;MAJENE;MALUNDA;SALUTAHONGAN;15;0;15;0;0;0;0;0;0;0;0;0;0;0;0;0;0;0;0;0
173;SULAWESI BARAT;MAJENE;MALUNDA;LOMBONG TIMUR;15;25;-10;11;7;2;4;5;25;0;25;0;25;0;0;0;0;25;24;1
174;SULAWESI BARAT;MAJENE;MALUNDA;MEKKATTA SELATAN;15;0;15;0;0;0;0;0;0;0;0;0;0;0;0;0;0;0;0;0
175;SULAWESI BARAT;MAJENE;MALUNDA;KAYUANGIN;16;0;16;0;0;0;0;0;0;0;0;0;0;0;0;0;0;0;0;0
176;SULAWESI BARAT;MAJENE;BANGGAE TIMUR;BAURUNG;40;25;15;13;11;1;7;5;25;0;25;0;24;0;1;0;7;18;22;3
177;SULAWESI BARAT;MAJENE;BANGGAE TIMUR;BARUGA;6;14;-8;10;6;0;6;0;14;0;14;0;7;0;6;1;1;13;4;10
178;SULAWESI BARAT;MAJENE;BANGGAE TIMUR;BARUGA DHUA;12;35;-23;20;17;2;14;5;35;0;35;0;35;0;0;0;31;4;30;5
179;SULAWESI BARAT;MAJENE;BANGGAE TIMUR;LABUANG;29;43;-14;21;18;0;16;2;43;0;40;3;35;2;6;0;23;20;36;7
180;SULAWESI BARAT;MAJENE;BANGGAE TIMUR;TANDE;7;15;-8;10;7;0;5;2;15;0;15;0;12;1;2;0;1;14;10;5
181;SULAWESI BARAT;MAJENE;BANGGAE TIMUR;LEMBANG;35;33;2;22;11;0;7;4;33;0;33;0;33;0;0;0;5;28;18;15
182;SULAWESI BARAT;MAJENE;BANGGAE TIMUR;LABUANG UTARA;18;18;0;12;9;0;4;5;18;0;18;0;14;0;4;0;7;11;14;4
183;SULAWESI BARAT;MAJENE;BANGGAE TIMUR;TANDE TIMUR;12;25;-13;10;6;0;6;0;25;0;25;0;25;0;0;0;2;23;18;7
184;SULAWESI BARAT;MAJENE;BANGGAE TIMUR;BUTTU BARUGA;18;19;-1;12;12;0;12;0;19;0;19;0;1;0;18;0;3;16;16;3
185;SULAWESI BARAT;MAJENE;PAMBOANG;LALAMPANUA;11;4;7;2;1;1;0;2;4;0;4;0;3;0;1;0;0;4;1;3
186;SULAWESI BARAT;MAJENE;PAMBOANG;SIRINDU;8;6;2;2;1;0;1;0;6;0;6;0;1;5;0;0;0;6;3;3
187;SULAWESI BARAT;MAJENE;PAMBOANG;ADOLANG;6;12;-6;7;7;0;5;2;12;0;11;1;0;9;3;0;11;1;10;2
188;SULAWESI BARAT;MAJENE;PAMBOANG;BABABULO;29;16;13;2;2;0;2;0;16;0;16;0;14;0;2;0;14;2;16;0
189;SULAWESI BARAT;MAJENE;PAMBOANG;BONDE;27;1;26;0;0;0;0;0;1;0;1;0;1;0;0;0;1;0;0;1
190;SULAWESI BARAT;MAJENE;PAMBOANG;BETTENG;6;6;0;0;0;0;0;0;6;0;6;0;4;0;2;0;6;0;6;0
191;SULAWESI BARAT;MAJENE;PAMBOANG;SIMBANG;6;4;2;0;0;0;0;0;4;0;4;0;2;1;1;0;2;2;3;1
192;SULAWESI BARAT;MAJENE;PAMBOANG;BONDE UTARA;34;44;-10;23;20;0;20;0;44;0;44;0;17;0;27;0;6;38;44;0
193;SULAWESI BARAT;MAJENE;PAMBOANG;BABABULO UTARA;7;0;7;0;0;0;0;0;0;0;0;0;0;0;0;0;0;0;0;0
194;SULAWESI BARAT;MAJENE;PAMBOANG;BUTTU PAMBOANG;11;12;-1;1;1;0;0;1;12;0;12;0;10;0;2;0;8;4;11;1
195;SULAWESI BARAT;MAJENE;PAMBOANG;BANUA ADOLANG;23;25;-2;10;9;0;7;2;25;0;25;0;1;24;0;0;12;13;19;6
196;SULAWESI BARAT;MAJENE;PAMBOANG;ADOLANG DHUA;9;17;-8;12;7;0;3;4;17;0;17;0;3;4;9;1;15;2;14;3
197;SULAWESI BARAT;MAJENE;PAMBOANG;TINAMBUNG;9;7;2;5;5;0;5;0;7;0;7;0;2;5;0;0;1;6;4;3
198;SULAWESI BARAT;MAJENE;PAMBOANG;PESULOANG;7;9;-2;4;1;0;0;1;9;0;9;0;3;4;2;0;0;9;9;0
199;SULAWESI BARAT;MAJENE;PAMBOANG;BALOMBONG;5;0;5;0;0;0;0;0;0;0;0;0;0;0;0;0;0;0;0;0
200;SULAWESI BARAT;MAJENE;SENDANA;MOSSO;30;8;22;2;2;0;2;0;8;0;8;0;3;1;4;0;0;8;3;5
201;SULAWESI BARAT;MAJENE;SENDANA;MOSSO DHUA;14;16;-2;5;3;0;3;0;16;0;14;2;12;0;4;0;1;15;6;10
202;SULAWESI BARAT;MAJENE;SENDANA;TOTOLISI SENDANA;11;0;11;0;0;0;0;0;0;0;0;0;0;0;0;0;0;0;0;0
203;SULAWESI BARAT;MAJENE;SENDANA;TALLUBANUA;22;17;5;11;9;0;9;0;17;0;17;0;0;0;17;0;0;17;11;6
204;SULAWESI BARAT;MAJENE;SENDANA;LALATEDZONG;8;10;-2;4;4;0;4;0;10;0;10;0;8;0;2;0;3;7;9;1
205;SULAWESI BARAT;MAJENE;SENDANA;BINANGA;5;13;-8;9;9;0;9;0;13;0;13;0;0;0;13;0;0;13;13;0
206;SULAWESI BARAT;MAJENE;SENDANA;PUTTADA;7;4;3;2;2;0;2;0;4;0;4;0;2;2;0;0;0;4;4;0
207;SULAWESI BARAT;MAJENE;SENDANA;PAMINGGALAN;5;0;5;0;0;0;0;0;0;0;0;0;0;0;0;0;0;0;0;0
208;SULAWESI BARAT;MAJENE;SENDANA;LEPPANGANG;3;1;2;0;0;0;0;0;1;0;1;0;0;0;1;0;0;1;1;0
209;SULAWESI BARAT;MAJENE;SENDANA;PUNDAU;8;10;-2;6;4;0;3;1;10;0;10;0;6;4;0;0;10;0;6;4
210;SULAWESI BARAT;MAJENE;SENDANA;SENDANA;4;4;0;1;1;0;0;1;4;0;4;0;4;0;0;0;4;0;4;0
211;SULAWESI BARAT;MAJENE;SENDANA;BANUA SENDANA;5;5;0;2;2;0;2;0;5;0;5;0;0;5;0;0;1;4;1;4
212;SULAWESI BARAT;MAJENE;SENDANA;TALLUBANUA UTARA;6;2;4;1;1;0;1;0;2;0;2;0;1;0;1;0;2;0;2;0
213;SULAWESI BARAT;MAJENE;SENDANA;LIMBORO RAMBU-RAMBU;5;11;-6;6;4;2;4;2;11;0;11;0;1;10;0;0;9;2;11;0
214;SULAWESI BARAT;MAJENE;SENDANA;LIMBUA;7;0;7;0;0;0;0;0;0;0;0;0;0;0;0;0;0;0;0;0
215;SULAWESI BARAT;MAJENE;SENDANA;BUKIT SAMANG;5;14;-9;9;4;0;3;1;14;0;14;0;8;1;5;0;7;7;5;9
216;SULAWESI BARAT;MAJENE;TAMMERODO SENDANA;SEPPONG;16;32;-16;17;12;1;13;0;32;0;32;0;32;0;0;0;9;23;3;29
217;SULAWESI BARAT;MAJENE;TAMMERODO SENDANA;TAMMERODO;21;39;-18;22;9;1;10;0;39;0;39;0;14;8;17;0;14;25;32;7
218;SULAWESI BARAT;MAJENE;TAMMERODO SENDANA;ULIDANG;17;37;-20;26;13;5;14;4;37;0;37;0;26;6;5;0;18;19;22;15
219;SULAWESI BARAT;MAJENE;TAMMERODO SENDANA;TALLAMBALAO;10;31;-21;25;21;0;21;0;31;0;31;0;26;4;1;0;19;12;13;18
220;SULAWESI BARAT;MAJENE;TAMMERODO SENDANA;TAMMERODO UTARA;27;32;-5;11;8;0;6;2;32;0;32;0;31;1;0;0;9;23;12;20
221;SULAWESI BARAT;MAJENE;TAMMERODO SENDANA;MANYAMBA;8;26;-18;19;9;1;9;1;26;0;26;0;11;4;11;0;3;23;22;4
222;SULAWESI BARAT;MAJENE;TAMMERODO SENDANA;AWO;20;32;-12;20;16;1;16;1;30;2;30;2;12;6;14;0;32;0;11;21
223;SULAWESI BARAT;MAJENE;TUBO SENDANA;ONANG;20;0;20;0;0;0;0;0;0;0;0;0;0;0;0;0;0;0;0;0
224;SULAWESI BARAT;MAJENE;TUBO SENDANA;TUBO;5;0;5;0;0;0;0;0;0;0;0;0;0;0;0;0;0;0;0;0
225;SULAWESI BARAT;MAJENE;TUBO SENDANA;ONANG UTARA;6;2;4;2;1;0;0;1;2;0;2;0;1;0;0;1;2;0;2;0
226;SULAWESI BARAT;MAJENE;TUBO SENDANA;TUBO SELATAN;7;20;-13;15;13;0;11;2;20;0;20;0;2;0;18;0;11;9;12;8
227;SULAWESI BARAT;MAJENE;TUBO SENDANA;BONDE BONDE;7;5;2;1;0;0;0;0;5;0;5;0;5;0;0;0;0;5;0;5
228;SULAWESI BARAT;MAJENE;TUBO SENDANA;TUBO TENGAH;8;10;-2;8;6;0;5;1;10;0;10;0;3;0;6;1;6;4;2;8
229;SULAWESI BARAT;MAJENE;TUBO SENDANA;TUBO POANG;5;3;2;0;0;0;0;0;3;0;3;0;3;0;0;0;0;3;0;3
230;SULAWESI BARAT;MAJENE;ULUMANDA;KABIRAAN;18;2;16;0;0;0;0;0;2;0;2;0;1;1;0;0;2;0;2;0
231;SULAWESI BARAT;MAJENE;ULUMANDA;SAMBABO;12;11;1;2;1;1;2;0;11;0;11;0;11;0;0;0;4;7;6;5
232;SULAWESI BARAT;MAJENE;ULUMANDA;TANDEALLO;5;0;5;0;0;0;0;0;0;0;0;0;0;0;0;0;0;0;0;0
233;SULAWESI BARAT;MAJENE;ULUMANDA;ULUMANDA;20;0;20;0;0;0;0;0;0;0;0;0;0;0;0;0;0;0;0;0
234;SULAWESI BARAT;MAJENE;ULUMANDA;SALUTAMBUNG;13;2;11;1;1;0;1;0;2;0;2;0;2;0;0;0;2;0;2;0
235;SULAWESI BARAT;MAJENE;ULUMANDA;POPENGA;7;7;0;6;3;1;4;0;7;0;7;0;7;0;0;0;7;0;7;0
236;SULAWESI BARAT;MAJENE;ULUMANDA;SULAI;16;0;16;0;0;0;0;0;0;0;0;0;0;0;0;0;0;0;0;0
237;SULAWESI BARAT;MAJENE;ULUMANDA;PANGGALO;7;7;0;0;0;0;0;0;7;0;7;0;7;0;0;0;7;0;7;0
238;SULAWESI BARAT;POLEWALI MANDAR;ALLU;PETOOSANG;5;11;-6;4;3;0;3;0;11;0;11;0;11;0;0;0;0;11;4;7
239;SULAWESI BARAT;POLEWALI MANDAR;ALLU;MOMBI;15;12;3;7;2;0;0;2;12;0;12;0;7;1;4;0;2;10;3;9
240;SULAWESI BARAT;POLEWALI MANDAR;ALLU;KALUMAMMANG;14;8;6;1;2;0;2;0;8;0;8;0;0;0;8;0;8;0;8;0
241;SULAWESI BARAT;POLEWALI MANDAR;ALLU;PAO-PAO;25;47;-22;29;25;0;21;4;47;0;47;0;30;1;16;0;22;25;29;18
242;SULAWESI BARAT;POLEWALI MANDAR;ALLU;PUPPU URING;25;11;14;9;8;0;7;1;11;0;11;0;1;4;6;0;0;11;11;0
243;SULAWESI BARAT;POLEWALI MANDAR;ALLU;SARAGIAN;6;6;0;4;1;0;1;0;6;0;6;0;0;6;0;0;6;0;6;0
244;SULAWESI BARAT;POLEWALI MANDAR;ALLU;SAYOANG;3;11;-8;9;4;2;3;3;11;0;11;0;11;0;0;0;11;0;9;2
245;SULAWESI BARAT;POLEWALI MANDAR;ALLU;ALU;14;11;3;4;4;0;4;0;11;0;11;0;8;0;3;0;2;9;2;9
246;SULAWESI BARAT;POLEWALI MANDAR;ANREAPI;ANREAPI;22;7;15;3;3;0;3;0;7;0;7;0;0;0;7;0;4;3;7;0
247;SULAWESI BARAT;POLEWALI MANDAR;ANREAPI;DUAMPANUA;22;20;2;13;12;0;12;0;20;0;20;0;1;0;19;0;2;18;1;19
248;SULAWESI BARAT;POLEWALI MANDAR;ANREAPI;KELAPA DUA;18;17;1;6;1;0;1;0;17;0;17;0;4;4;9;0;8;9;10;7
249;SULAWESI BARAT;POLEWALI MANDAR;ANREAPI;PAPPANDANGAN;15;1;14;0;0;0;0;0;1;0;1;0;0;0;1;0;1;0;1;0
250;SULAWESI BARAT;POLEWALI MANDAR;ANREAPI;KUNYI;8;10;-2;3;1;0;1;0;10;0;10;0;7;0;3;0;0;10;4;6
251;SULAWESI BARAT;POLEWALI MANDAR;BALANIPA;BALANIPA;17;20;-3;18;7;1;5;3;20;0;20;0;18;0;2;0;2;18;14;6
252;SULAWESI BARAT;POLEWALI MANDAR;BALANIPA;TAMMAJARRA;19;9;10;4;3;0;3;0;9;0;9;0;9;0;0;0;7;2;7;2
253;SULAWESI BARAT;POLEWALI MANDAR;BALANIPA;TAMANGGALLE;21;0;21;0;0;0;0;0;0;0;0;0;0;0;0;0;0;0;0;0
254;SULAWESI BARAT;POLEWALI MANDAR;BALANIPA;MOSSO;5;3;2;1;1;0;1;0;3;0;3;0;3;0;0;0;0;3;2;1
255;SULAWESI BARAT;POLEWALI MANDAR;BALANIPA;GALUNG TULUK;18;1;17;1;1;0;1;0;1;0;1;0;1;0;0;0;0;1;0;1
256;SULAWESI BARAT;POLEWALI MANDAR;BALANIPA;SABANG SUBIK;16;0;16;0;0;0;0;0;0;0;0;0;0;0;0;0;0;0;0;0
257;SULAWESI BARAT;POLEWALI MANDAR;BALANIPA;PAMBUSUANG;66;37;29;16;10;0;8;2;37;0;37;0;29;8;0;0;30;7;34;3
258;SULAWESI BARAT;POLEWALI MANDAR;BALANIPA;BALA;80;24;56;12;8;0;8;0;24;0;24;0;24;0;0;0;2;22;3;21
259;SULAWESI BARAT;POLEWALI MANDAR;BALANIPA;LAMBANAN;9;16;-7;13;8;0;5;3;16;0;16;0;15;1;0;0;8;8;3;13
260;SULAWESI BARAT;POLEWALI MANDAR;BALANIPA;LEGO;11;20;-9;11;9;0;2;7;20;0;20;0;2;18;0;0;20;0;20;0
261;SULAWESI BARAT;POLEWALI MANDAR;BALANIPA;PALLIS;4;0;4;0;0;0;0;0;0;0;0;0;0;0;0;0;0;0;0;0
262;SULAWESI BARAT;POLEWALI MANDAR;BINUANG;AMASSANGAN;31;5;26;0;0;0;0;0;5;0;5;0;3;0;2;0;5;0;3;2
263;SULAWESI BARAT;POLEWALI MANDAR;BINUANG;TONYAMAN;30;0;30;0;0;0;0;0;0;0;0;0;0;0;0;0;0;0;0;0
264;SULAWESI BARAT;POLEWALI MANDAR;BINUANG;KUAJANG;38;12;26;9;9;0;9;0;12;0;12;0;2;9;1;0;6;6;5;7
265;SULAWESI BARAT;POLEWALI MANDAR;BINUANG;PAKU;12;2;10;0;0;0;0;0;2;0;2;0;0;2;0;0;2;0;0;2
266;SULAWESI BARAT;POLEWALI MANDAR;BINUANG;MIRRING;27;19;8;12;3;0;3;0;19;0;19;0;18;0;1;0;3;16;15;4
267;SULAWESI BARAT;POLEWALI MANDAR;BINUANG;BATETANGNGA;35;26;9;17;10;0;10;0;26;0;26;0;11;0;15;0;17;9;18;8
268;SULAWESI BARAT;POLEWALI MANDAR;BINUANG;MAMMI;9;22;-13;15;3;0;3;0;22;0;22;0;1;1;20;0;15;7;3;19
269;SULAWESI BARAT;POLEWALI MANDAR;BINUANG;KALEOK;4;0;4;0;0;0;0;0;0;0;0;0;0;0;0;0;0;0;0;0
270;SULAWESI BARAT;POLEWALI MANDAR;BINUANG;AMOLA;2;0;2;0;0;0;0;0;0;0;0;0;0;0;0;0;0;0;0;0
271;SULAWESI BARAT;POLEWALI MANDAR;BINUANG;REA;26;31;-5;13;9;0;9;0;31;0;31;0;29;0;2;0;1;30;14;17
272;SULAWESI BARAT;POLEWALI MANDAR;BULO;BULO;21;1;20;1;1;0;1;0;1;0;1;0;0;0;1;0;1;0;1;0
273;SULAWESI BARAT;POLEWALI MANDAR;BULO;PULLIWA;23;7;16;0;0;0;0;0;7;0;7;0;7;0;0;0;0;7;0;7
274;SULAWESI BARAT;POLEWALI MANDAR;BULO;PATAMBANUA;11;2;9;1;0;0;0;0;2;0;2;0;0;0;2;0;0;2;0;2
275;SULAWESI BARAT;POLEWALI MANDAR;BULO;KAROMBANG;13;0;13;0;0;0;0;0;0;0;0;0;0;0;0;0;0;0;0;0
276;SULAWESI BARAT;POLEWALI MANDAR;BULO;DAALA TIMUR;6;1;5;0;0;0;0;0;1;0;1;0;1;0;0;0;1;0;0;1
277;SULAWESI BARAT;POLEWALI MANDAR;BULO;LENGGO;0;0;0;0;0;0;0;0;0;0;0;0;0;0;0;0;0;0;0;0
278;SULAWESI BARAT;POLEWALI MANDAR;BULO;SABURA;10;5;5;0;0;0;0;0;5;0;5;0;4;0;0;1;1;4;1;4
279;SULAWESI BARAT;POLEWALI MANDAR;BULO;SEPPORRAKI;8;10;-2;5;1;0;1;0;10;0;10;0;10;0;0;0;0;10;0;10
280;SULAWESI BARAT;POLEWALI MANDAR;BULO;IHING;19;0;19;0;0;0;0;0;0;0;0;0;0;0;0;0;0;0;0;0
281;SULAWESI BARAT;POLEWALI MANDAR;CAMPALAGIAN;PAPPANG;27;15;12;15;10;0;10;0;15;0;15;0;13;2;0;0;5;10;12;3
282;SULAWESI BARAT;POLEWALI MANDAR;CAMPALAGIAN;LALIKO;31;10;21;8;6;1;7;0;10;0;10;0;4;5;1;0;0;10;6;4
283;SULAWESI BARAT;POLEWALI MANDAR;CAMPALAGIAN;BONDE;20;0;20;0;0;0;0;0;0;0;0;0;0;0;0;0;0;0;0;0
284;SULAWESI BARAT;POLEWALI MANDAR;CAMPALAGIAN;KATUMBANGAN LEMO;31;6;25;2;2;0;2;0;6;0;6;0;6;0;0;0;3;3;6;0
285;SULAWESI BARAT;POLEWALI MANDAR;CAMPALAGIAN;PANYAMPA;39;17;22;13;12;0;12;0;17;0;17;0;17;0;0;0;0;17;1;16
286;SULAWESI BARAT;POLEWALI MANDAR;CAMPALAGIAN;SURUANG;21;18;3;13;7;0;6;1;18;0;18;0;13;5;0;0;11;7;15;3
287;SULAWESI BARAT;POLEWALI MANDAR;CAMPALAGIAN;LAMPOKO;32;34;-2;31;19;4;14;9;32;2;32;2;14;11;9;0;17;17;26;8
288;SULAWESI BARAT;POLEWALI MANDAR;CAMPALAGIAN;KATUMBANGAN;51;30;21;18;9;0;7;2;30;0;30;0;30;0;0;0;10;20;23;7
289;SULAWESI BARAT;POLEWALI MANDAR;CAMPALAGIAN;LAPEO;33;9;24;4;2;1;0;3;9;0;9;0;5;0;4;0;9;0;9;0
290;SULAWESI BARAT;POLEWALI MANDAR;CAMPALAGIAN;PARAPPE;51;13;38;0;0;0;0;0;13;0;13;0;0;0;13;0;10;3;1;12
291;SULAWESI BARAT;POLEWALI MANDAR;CAMPALAGIAN;ONGKO;12;32;-20;27;17;0;12;5;32;0;32;0;32;0;0;0;0;32;8;24
292;SULAWESI BARAT;POLEWALI MANDAR;CAMPALAGIAN;KENJE;19;2;17;2;2;0;2;0;2;0;2;0;2;0;0;0;2;0;1;1
293;SULAWESI BARAT;POLEWALI MANDAR;CAMPALAGIAN;SUMARRANG;26;35;-9;34;2;0;2;0;35;0;35;0;16;2;13;4;4;31;30;5
294;SULAWESI BARAT;POLEWALI MANDAR;CAMPALAGIAN;BOTTO;38;12;26;5;3;0;2;1;12;0;12;0;11;0;1;0;11;1;10;2
295;SULAWESI BARAT;POLEWALI MANDAR;CAMPALAGIAN;GATTUNGAN;23;19;4;9;7;0;7;0;19;0;19;0;19;0;0;0;19;0;19;0
296;SULAWESI BARAT;POLEWALI MANDAR;CAMPALAGIAN;PADANG TIMUR;19;0;19;0;0;0;0;0;0;0;0;0;0;0;0;0;0;0;0;0
297;SULAWESI BARAT;POLEWALI MANDAR;CAMPALAGIAN;PADANG;6;0;6;0;0;0;0;0;0;0;0;0;0;0;0;0;0;0;0;0
;SULAWESI BARAT;POLEWALI MANDAR;CAMPALAGIAN;LAGI-AGI;14;0;14;0;0;0;0;0;0;0;0;0;0;0;0;0;0;0;0;0
298;SULAWESI BARAT;POLEWALI MANDAR;LIMBORO;LIMBORO;13;19;-6;13;11;0;6;5;19;0;19;0;19;0;0;0;8;11;17;2
299;SULAWESI BARAT;POLEWALI MANDAR;LIMBORO;LEMBANG LEMBANG;15;12;3;7;4;0;2;2;12;0;12;0;8;4;0;0;3;9;6;6
300;SULAWESI BARAT;POLEWALI MANDAR;LIMBORO;TANDASURA;10;13;-3;8;5;0;5;0;12;1;13;0;8;1;4;0;5;8;12;1
301;SULAWESI BARAT;POLEWALI MANDAR;LIMBORO;SAMASUNDU;8;14;-6;13;11;0;11;0;14;0;14;0;14;0;0;0;0;14;0;14
302;SULAWESI BARAT;POLEWALI MANDAR;LIMBORO;NAPO;7;8;-1;5;4;0;4;0;8;0;8;0;8;0;0;0;0;8;8;0
303;SULAWESI BARAT;POLEWALI MANDAR;LIMBORO;TODANG TODANG;14;9;5;1;1;0;1;0;9;0;9;0;5;1;3;0;4;5;8;1
304;SULAWESI BARAT;POLEWALI MANDAR;LIMBORO;PENDULANGAN;9;3;6;3;1;0;1;0;3;0;3;0;0;1;2;0;2;1;3;0
305;SULAWESI BARAT;POLEWALI MANDAR;LIMBORO;RENGGEANG;8;19;-11;11;6;0;1;5;19;0;19;0;19;0;0;0;15;4;13;6
306;SULAWESI BARAT;POLEWALI MANDAR;LIMBORO;SALARRI;10;0;10;0;0;0;0;0;0;0;0;0;0;0;0;0;0;0;0;0
307;SULAWESI BARAT;POLEWALI MANDAR;LIMBORO;TANGAN BARU;9;1;8;0;0;0;0;0;1;0;1;0;0;1;0;0;0;1;0;1
308;SULAWESI BARAT;POLEWALI MANDAR;LIMBORO;PALECE;8;13;-5;8;6;0;6;0;12;1;13;0;13;0;0;0;4;9;10;3
309;SULAWESI BARAT;POLEWALI MANDAR;LUYO;BATUPANGA;23;5;18;5;0;0;0;0;5;0;5;0;5;0;0;0;1;4;5;0
310;SULAWESI BARAT;POLEWALI MANDAR;LUYO;MAMBU;22;0;22;0;0;0;0;0;0;0;0;0;0;0;0;0;0;0;0;0
311;SULAWESI BARAT;POLEWALI MANDAR;LUYO;TENGGELANG;26;6;20;5;4;0;4;0;6;0;6;0;0;6;0;0;6;0;6;0
312;SULAWESI BARAT;POLEWALI MANDAR;LUYO;BARU;58;6;52;5;2;0;2;0;6;0;6;0;5;1;0;0;2;4;5;1
313;SULAWESI BARAT;POLEWALI MANDAR;LUYO;PUSSUI;11;0;11;0;0;0;0;0;0;0;0;0;0;0;0;0;0;0;0;0
314;SULAWESI BARAT;POLEWALI MANDAR;LUYO;MAPILI BARAT;25;0;25;0;0;0;0;0;0;0;0;0;0;0;0;0;0;0;0;0
315;SULAWESI BARAT;POLEWALI MANDAR;LUYO;SAMBALI WALI;18;0;18;0;0;0;0;0;0;0;0;0;0;0;0;0;0;0;0;0
316;SULAWESI BARAT;POLEWALI MANDAR;LUYO;BATUPANGA DAALA;39;0;39;0;0;0;0;0;0;0;0;0;0;0;0;0;0;0;0;0
317;SULAWESI BARAT;POLEWALI MANDAR;LUYO;LUYO;18;14;4;3;2;0;2;0;14;0;14;0;14;0;0;0;3;11;11;3
318;SULAWESI BARAT;POLEWALI MANDAR;LUYO;PUSSUI BARAT;6;0;6;0;0;0;0;0;0;0;0;0;0;0;0;0;0;0;0;0
319;SULAWESI BARAT;POLEWALI MANDAR;LUYO;PUCCADI;19;0;19;0;0;0;0;0;0;0;0;0;0;0;0;0;0;0;0;0
320;SULAWESI BARAT;POLEWALI MANDAR;MAPILLI;MAPILI;11;10;1;5;5;0;5;0;10;0;10;0;6;3;1;0;5;5;7;3
321;SULAWESI BARAT;POLEWALI MANDAR;MAPILLI;UGIBARU;35;36;-1;21;13;2;6;9;36;0;36;0;27;3;6;0;13;23;12;24
322;SULAWESI BARAT;POLEWALI MANDAR;MAPILLI;RUMPA;22;0;22;0;0;0;0;0;0;0;0;0;0;0;0;0;0;0;0;0
323;SULAWESI BARAT;POLEWALI MANDAR;MAPILLI;KURMA;44;42;2;21;18;0;17;1;42;0;42;0;5;9;28;0;16;26;37;5
324;SULAWESI BARAT;POLEWALI MANDAR;MAPILLI;BUKU;34;7;27;1;0;0;0;0;7;0;7;0;2;0;5;0;2;5;4;3
325;SULAWESI BARAT;POLEWALI MANDAR;MAPILLI;BONNE BONNE;16;2;14;1;1;0;1;0;2;0;2;0;1;0;1;0;1;1;1;1
326;SULAWESI BARAT;POLEWALI MANDAR;MAPILLI;BEROANGIN;11;5;6;5;3;0;3;0;5;0;5;0;5;0;0;0;0;5;5;0
327;SULAWESI BARAT;POLEWALI MANDAR;MAPILLI;SEGERANG;7;8;-1;4;4;0;4;0;8;0;8;0;2;6;0;0;0;8;1;7
328;SULAWESI BARAT;POLEWALI MANDAR;MAPILLI;BONRA;38;31;7;14;5;0;1;4;29;2;27;4;4;1;26;0;4;27;30;1
329;SULAWESI BARAT;POLEWALI MANDAR;MAPILLI;SATTOKO;5;0;5;0;0;0;0;0;0;0;0;0;0;0;0;0;0;0;0;0
330;SULAWESI BARAT;POLEWALI MANDAR;MAPILLI;RAPPANG BARAT;27;7;20;4;0;0;0;0;6;1;6;1;4;2;1;0;4;3;0;7
331;SULAWESI BARAT;POLEWALI MANDAR;MAPILLI;LANDI KANUSUANG;20;0;20;0;0;0;0;0;0;0;0;0;0;0;0;0;0;0;0;0
332;SULAWESI BARAT;POLEWALI MANDAR;MATAKALI;MATAKALI;30;13;17;5;3;0;3;0;13;0;13;0;2;2;9;0;10;3;2;11
333;SULAWESI BARAT;POLEWALI MANDAR;MATAKALI;PETAMPANUA;25;0;25;0;0;0;0;0;0;0;0;0;0;0;0;0;0;0;0;0
334;SULAWESI BARAT;POLEWALI MANDAR;MATAKALI;BARUMBUNG;16;2;14;0;0;0;0;0;2;0;2;0;0;0;2;0;2;0;0;2
335;SULAWESI BARAT;POLEWALI MANDAR;MATAKALI;PASIANG;36;17;19;8;2;0;2;0;17;0;17;0;11;3;3;0;7;10;14;3
336;SULAWESI BARAT;POLEWALI MANDAR;MATAKALI;TONROLIMA;18;2;16;2;2;0;2;0;2;0;2;0;2;0;0;0;1;1;1;1
337;SULAWESI BARAT;POLEWALI MANDAR;MATAKALI;INDOMAKKOMBONG;21;0;21;0;0;0;0;0;0;0;0;0;0;0;0;0;0;0;0;0
338;SULAWESI BARAT;POLEWALI MANDAR;MATAKALI;BUNGA-BUNGA;4;0;4;0;0;0;0;0;0;0;0;0;0;0;0;0;0;0;0;0
339;SULAWESI BARAT;POLEWALI MANDAR;MATANGNGA;MATANGNGA;4;1;3;0;0;0;0;0;1;0;1;0;1;0;0;0;0;1;1;0
340;SULAWESI BARAT;POLEWALI MANDAR;MATANGNGA;LILLI;11;7;4;7;7;0;7;0;7;0;7;0;7;0;0;0;2;5;5;2
341;SULAWESI BARAT;POLEWALI MANDAR;MATANGNGA;RANGOAN;11;0;11;0;0;0;0;0;0;0;0;0;0;0;0;0;0;0;0;0
342;SULAWESI BARAT;POLEWALI MANDAR;MATANGNGA;TAPUA;10;0;10;0;0;0;0;0;0;0;0;0;0;0;0;0;0;0;0;0
343;SULAWESI BARAT;POLEWALI MANDAR;MATANGNGA;MAMBU TAPUA;5;3;2;3;0;0;0;0;3;0;3;0;1;1;1;0;0;3;3;0
344;SULAWESI BARAT;POLEWALI MANDAR;MATANGNGA;BA'BA TAPUA;8;2;6;0;0;0;0;0;2;0;2;0;0;0;2;0;0;2;0;2
345;SULAWESI BARAT;POLEWALI MANDAR;MATANGNGA;KATIMBANG;1;7;-6;7;3;0;3;0;7;0;7;0;6;0;1;0;4;3;7;0
346;SULAWESI BARAT;POLEWALI MANDAR;POLEWALI;POLEWALI;37;22;15;14;7;0;7;0;22;0;22;0;22;0;0;0;8;14;8;14
347;SULAWESI BARAT;POLEWALI MANDAR;POLEWALI;WATTANG;24;10;14;4;3;0;3;0;10;0;6;4;10;0;0;0;1;9;0;10
348;SULAWESI BARAT;POLEWALI MANDAR;POLEWALI;SULEWATANG;33;13;20;5;4;0;4;0;13;0;13;0;13;0;0;0;7;6;9;4
349;SULAWESI BARAT;POLEWALI MANDAR;POLEWALI;LANTORA;26;11;15;2;2;0;2;0;11;0;11;0;10;0;1;0;3;8;3;8
350;SULAWESI BARAT;POLEWALI MANDAR;POLEWALI;TAKATIDUNG;85;78;7;44;35;0;30;5;77;1;77;1;51;6;21;0;51;27;67;11
351;SULAWESI BARAT;POLEWALI MANDAR;POLEWALI;PEKKABATA;15;20;-5;13;6;1;5;2;20;0;20;0;12;0;7;1;4;16;0;20
352;SULAWESI BARAT;POLEWALI MANDAR;POLEWALI;MADATE;16;20;-4;13;6;0;6;0;20;0;20;0;20;0;0;0;1;19;7;13
353;SULAWESI BARAT;POLEWALI MANDAR;POLEWALI;MANDING;21;43;-22;29;15;0;12;3;43;0;43;0;35;1;7;0;15;28;16;27
354;SULAWESI BARAT;POLEWALI MANDAR;POLEWALI;DARMA;39;4;35;1;1;0;1;0;4;0;4;0;3;1;0;0;3;1;2;2
355;SULAWESI BARAT;POLEWALI MANDAR;TAPANGO;PELITAKAN;5;1;4;0;0;0;0;0;1;0;1;0;1;0;0;0;1;0;0;1
356;SULAWESI BARAT;POLEWALI MANDAR;TAPANGO;TAPANGO;12;0;12;0;0;0;0;0;0;0;0;0;0;0;0;0;0;0;0;0
357;SULAWESI BARAT;POLEWALI MANDAR;TAPANGO;RAPPANG;17;0;17;0;0;0;0;0;0;0;0;0;0;0;0;0;0;0;0;0
358;SULAWESI BARAT;POLEWALI MANDAR;TAPANGO;DAKKA;14;0;14;0;0;0;0;0;0;0;0;0;0;0;0;0;0;0;0;0
359;SULAWESI BARAT;POLEWALI MANDAR;TAPANGO;BATU;4;0;4;0;0;0;0;0;0;0;0;0;0;0;0;0;0;0;0;0
360;SULAWESI BARAT;POLEWALI MANDAR;TAPANGO;RISO;13;0;13;0;0;0;0;0;0;0;0;0;0;0;0;0;0;0;0;0
361;SULAWESI BARAT;POLEWALI MANDAR;TAPANGO;PALATTA;6;0;6;0;0;0;0;0;0;0;0;0;0;0;0;0;0;0;0;0
362;SULAWESI BARAT;POLEWALI MANDAR;TAPANGO;TAPANGO BARAT;14;1;13;0;0;0;0;0;1;0;1;0;1;0;0;0;1;0;0;1
363;SULAWESI BARAT;POLEWALI MANDAR;TAPANGO;KURRAK;2;0;2;0;0;0;0;0;0;0;0;0;0;0;0;0;0;0;0;0
364;SULAWESI BARAT;POLEWALI MANDAR;TAPANGO;BUSSU;16;0;16;0;0;0;0;0;0;0;0;0;0;0;0;0;0;0;0;0
365;SULAWESI BARAT;POLEWALI MANDAR;TAPANGO;TUTTULA;10;2;8;0;0;0;0;0;2;0;2;0;0;2;0;0;2;0;1;1
366;SULAWESI BARAT;POLEWALI MANDAR;TAPANGO;JAMBU MALEA;15;29;-14;15;11;0;11;0;29;0;29;0;27;2;0;0;29;0;22;7
367;SULAWESI BARAT;POLEWALI MANDAR;TAPANGO;KALIMBUA;13;4;9;1;0;0;0;0;4;0;4;0;4;0;0;0;1;3;1;3
368;SULAWESI BARAT;POLEWALI MANDAR;TAPANGO;BANATO REJO;14;0;14;0;0;0;0;0;0;0;0;0;0;0;0;0;0;0;0;0
369;SULAWESI BARAT;POLEWALI MANDAR;TINAMBUNG;TINAMBUNG;16;2;14;1;1;0;0;1;2;0;2;0;2;0;0;0;1;1;1;1
370;SULAWESI BARAT;POLEWALI MANDAR;TINAMBUNG;KARAMA;46;54;-8;34;19;0;19;0;48;6;46;8;12;1;41;0;1;53;48;6
371;SULAWESI BARAT;POLEWALI MANDAR;TINAMBUNG;TANGNGA TANGNGA;24;51;-27;37;23;2;15;10;46;5;46;5;10;0;41;0;25;26;42;9
372;SULAWESI BARAT;POLEWALI MANDAR;TINAMBUNG;LEKOPADIS;20;25;-5;13;11;0;5;6;25;0;23;2;25;0;0;0;1;24;20;5
373;SULAWESI BARAT;POLEWALI MANDAR;TINAMBUNG;GALUNG LOMBOK;17;16;1;11;9;0;9;0;16;0;16;0;13;0;3;0;16;0;9;7
374;SULAWESI BARAT;POLEWALI MANDAR;TINAMBUNG;TANDUNG;12;8;4;1;1;0;1;0;8;0;8;0;8;0;0;0;7;1;6;2
375;SULAWESI BARAT;POLEWALI MANDAR;TINAMBUNG;BATULAYA;8;1;7;1;1;0;1;0;1;0;1;0;1;0;0;0;1;0;1;0
376;SULAWESI BARAT;POLEWALI MANDAR;TINAMBUNG;SEPABATU;12;0;12;0;0;0;0;0;0;0;0;0;0;0;0;0;0;0;0;0
377;SULAWESI BARAT;POLEWALI MANDAR;TUTAR;TARAMANU;20;2;18;2;1;0;1;0;2;0;2;0;2;0;0;0;0;2;1;1
378;SULAWESI BARAT;POLEWALI MANDAR;TUTAR;AMBOPADANG;25;4;21;3;3;0;3;0;4;0;4;0;4;0;0;0;4;0;4;0
379;SULAWESI BARAT;POLEWALI MANDAR;TUTAR;TUBBI;7;0;7;0;0;0;0;0;0;0;0;0;0;0;0;0;0;0;0;0
380;SULAWESI BARAT;POLEWALI MANDAR;TUTAR;RATTE;12;0;12;0;0;0;0;0;0;0;0;0;0;0;0;0;0;0;0;0
381;SULAWESI BARAT;POLEWALI MANDAR;TUTAR;BESOANGIN;6;0;6;0;0;0;0;0;0;0;0;0;0;0;0;0;0;0;0;0
382;SULAWESI BARAT;POLEWALI MANDAR;TUTAR;PIRIANG TAPIKO;7;0;7;0;0;0;0;0;0;0;0;0;0;0;0;0;0;0;0;0
383;SULAWESI BARAT;POLEWALI MANDAR;TUTAR;PEBURRU;20;0;20;0;0;0;0;0;0;0;0;0;0;0;0;0;0;0;0;0
384;SULAWESI BARAT;POLEWALI MANDAR;TUTAR;TALOBA;12;0;12;0;0;0;0;0;0;0;0;0;0;0;0;0;0;0;0;0
385;SULAWESI BARAT;POLEWALI MANDAR;TUTAR;POLLEWANI;4;0;4;0;0;0;0;0;0;0;0;0;0;0;0;0;0;0;0;0
386;SULAWESI BARAT;POLEWALI MANDAR;TUTAR;ARABUA;22;0;22;0;0;0;0;0;0;0;0;0;0;0;0;0;0;0;0;0
387;SULAWESI BARAT;POLEWALI MANDAR;TUTAR;BESOANGIN UTARA;6;0;6;0;0;0;0;0;0;0;0;0;0;0;0;0;0;0;0;0
388;SULAWESI BARAT;POLEWALI MANDAR;TUTAR;PODA;2;0;2;0;0;0;0;0;0;0;0;0;0;0;0;0;0;0;0;0
389;SULAWESI BARAT;POLEWALI MANDAR;TUTAR;TARAMANU TUA;10;0;10;0;0;0;0;0;0;0;0;0;0;0;0;0;0;0;0;0
390;SULAWESI BARAT;POLEWALI MANDAR;WONOMULYO;SIDODADI;36;17;19;16;12;2;7;7;17;0;17;0;17;0;0;0;1;16;0;17
391;SULAWESI BARAT;POLEWALI MANDAR;WONOMULYO;SIDOREJO;35;14;21;10;6;1;6;1;14;0;14;0;14;0;0;0;14;0;14;0
392;SULAWESI BARAT;POLEWALI MANDAR;WONOMULYO;SUMBEREJO;48;49;-1;31;22;1;22;1;49;0;49;0;49;0;0;0;20;29;18;31
393;SULAWESI BARAT;POLEWALI MANDAR;WONOMULYO;BUMIAYU;14;25;-11;19;18;1;19;0;25;0;25;0;10;0;15;0;9;16;20;5
394;SULAWESI BARAT;POLEWALI MANDAR;WONOMULYO;KEBUNSARI;13;18;-5;11;4;0;3;1;18;0;18;0;15;3;0;0;14;4;9;9
395;SULAWESI BARAT;POLEWALI MANDAR;WONOMULYO;BANUA BARU;11;1;10;1;1;0;1;0;1;0;1;0;1;0;0;0;1;0;1;0
396;SULAWESI BARAT;POLEWALI MANDAR;WONOMULYO;NEPO;18;15;3;7;3;0;2;1;15;0;15;0;9;2;4;0;4;11;5;10
397;SULAWESI BARAT;POLEWALI MANDAR;WONOMULYO;SUGIHWARAS;14;31;-17;21;13;0;13;0;31;0;31;0;24;5;2;0;12;19;24;7
398;SULAWESI BARAT;POLEWALI MANDAR;WONOMULYO;CAMPURJO;15;0;15;0;0;0;0;0;0;0;0;0;0;0;0;0;0;0;0;0
399;SULAWESI BARAT;POLEWALI MANDAR;WONOMULYO;BUMIMULYO;18;3;15;0;0;0;0;0;3;0;3;0;0;0;3;0;2;1;0;3
400;SULAWESI BARAT;POLEWALI MANDAR;WONOMULYO;TUMPILING;19;19;0;10;8;0;7;1;19;0;19;0;13;4;2;0;9;10;8;11
401;SULAWESI BARAT;POLEWALI MANDAR;WONOMULYO;BAKKA-BAKKA;20;17;3;9;7;0;7;0;17;0;17;0;17;0;0;0;0;17;15;2
402;SULAWESI BARAT;POLEWALI MANDAR;WONOMULYO;ARJO SARI;9;0;9;0;0;0;0;0;0;0;0;0;0;0;0;0;0;0;0;0
403;SULAWESI BARAT;POLEWALI MANDAR;WONOMULYO;GALESON;24;18;6;12;6;1;7;0;18;0;18;0;10;4;4;0;4;14;8;10
404;SULAWESI BARAT;MAMASA;MAMASA;MAMASA;14;1;13;1;1;0;1;0;1;0;1;0;1;0;0;0;1;0;0;1
405;SULAWESI BARAT;MAMASA;MAMASA;RAMBUSARATU;5;0;5;0;0;0;0;0;0;0;0;0;0;0;0;0;0;0;0;0
406;SULAWESI BARAT;MAMASA;MAMASA;OSANGO;21;9;12;1;1;0;1;0;8;1;8;1;8;1;0;0;0;9;1;8
407;SULAWESI BARAT;MAMASA;MAMASA;LAMBANAN;11;0;11;0;0;0;0;0;0;0;0;0;0;0;0;0;0;0;0;0
408;SULAWESI BARAT;MAMASA;MAMASA;LEMBANA SALULO;0;0;0;0;0;0;0;0;0;0;0;0;0;0;0;0;0;0;0;0
409;SULAWESI BARAT;MAMASA;MAMASA;TAUPE;2;0;2;0;0;0;0;0;0;0;0;0;0;0;0;0;0;0;0;0
410;SULAWESI BARAT;MAMASA;MAMASA;BUNTU BUDA;10;0;10;0;0;0;0;0;0;0;0;0;0;0;0;0;0;0;0;0
411;SULAWESI BARAT;MAMASA;MAMASA;TONDOK BAKARU;6;5;1;0;0;0;0;0;3;2;3;2;2;0;3;0;1;4;4;1
412;SULAWESI BARAT;MAMASA;MAMASA;PEBASSIAN;5;0;5;0;0;0;0;0;0;0;0;0;0;0;0;0;0;0;0;0
413;SULAWESI BARAT;MAMASA;MAMASA;MAMBULILING;0;0;0;0;0;0;0;0;0;0;0;0;0;0;0;0;0;0;0;0
414;SULAWESI BARAT;MAMASA;MAMASA;BOMBONG LAMBE;6;0;6;0;0;0;0;0;0;0;0;0;0;0;0;0;0;0;0;0
415;SULAWESI BARAT;MAMASA;MAMASA;BUBUN BATU;1;0;1;0;0;0;0;0;0;0;0;0;0;0;0;0;0;0;0;0
416;SULAWESI BARAT;MAMASA;ARALLE;ARALLE;3;0;3;0;0;0;0;0;0;0;0;0;0;0;0;0;0;0;0;0
417;SULAWESI BARAT;MAMASA;ARALLE;RALLE ANAK;3;4;-1;3;0;0;0;0;4;0;4;0;1;1;2;0;4;0;2;2
418;SULAWESI BARAT;MAMASA;ARALLE;PANETEAN;4;6;-2;3;3;0;3;0;6;0;6;0;6;0;0;0;2;4;6;0
419;SULAWESI BARAT;MAMASA;ARALLE;UHAILANU;10;0;10;0;0;0;0;0;0;0;0;0;0;0;0;0;0;0;0;0
420;SULAWESI BARAT;MAMASA;ARALLE;ARALLE UTARA;2;10;-8;8;5;1;5;1;10;0;10;0;2;8;0;0;0;10;0;10
421;SULAWESI BARAT;MAMASA;ARALLE;UHAIDAHO;4;1;3;0;0;0;0;0;1;0;1;0;1;0;0;0;1;0;1;0
422;SULAWESI BARAT;MAMASA;ARALLE;BARURU;3;0;3;0;0;0;0;0;0;0;0;0;0;0;0;0;0;0;0;0
423;SULAWESI BARAT;MAMASA;ARALLE;RALLEANAK UTARA;7;6;1;1;1;0;1;0;6;0;6;0;1;4;0;1;1;5;2;4
424;SULAWESI BARAT;MAMASA;ARALLE;PAMOSEANG PANGGA;2;0;2;0;0;0;0;0;0;0;0;0;0;0;0;0;0;0;0;0
425;SULAWESI BARAT;MAMASA;ARALLE;KALABE;2;4;-2;3;0;0;0;0;4;0;4;0;0;4;0;0;0;4;3;1
426;SULAWESI BARAT;MAMASA;ARALLE;ARALLE SELATAN;3;0;3;0;0;0;0;0;0;0;0;0;0;0;0;0;0;0;0;0
427;SULAWESI BARAT;MAMASA;ARALLE;HAHANGAN;6;1;5;0;0;0;0;0;1;0;1;0;0;0;1;0;1;0;1;0
428;SULAWESI BARAT;MAMASA;BALLA;BALLA;8;5;3;1;1;0;1;0;5;0;5;0;5;0;0;0;0;5;0;5
429;SULAWESI BARAT;MAMASA;BALLA;BALLA BARAT;0;0;0;0;0;0;0;0;0;0;0;0;0;0;0;0;0;0;0;0
430;SULAWESI BARAT;MAMASA;BALLA;BALLA SATANETEAN;5;5;0;3;2;0;2;0;5;0;4;1;5;0;0;0;2;3;1;4
431;SULAWESI BARAT;MAMASA;BALLA;BALLA TUMUKA;6;5;1;1;0;0;0;0;5;0;5;0;1;0;4;0;5;0;5;0
432;SULAWESI BARAT;MAMASA;BALLA;SEPAKUAN;2;0;2;0;0;0;0;0;0;0;0;0;0;0;0;0;0;0;0;0
433;SULAWESI BARAT;MAMASA;BALLA;PIDARA;4;0;4;0;0;0;0;0;0;0;0;0;0;0;0;0;0;0;0;0
434;SULAWESI BARAT;MAMASA;BALLA;BAMBAPUANG;1;0;1;0;0;0;0;0;0;0;0;0;0;0;0;0;0;0;0;0
435;SULAWESI BARAT;MAMASA;BALLA;BALLA TIMUR;2;0;2;0;0;0;0;0;0;0;0;0;0;0;0;0;0;0;0;0
436;SULAWESI BARAT;MAMASA;BAMBANG;MOKALLANG;3;0;3;0;0;0;0;0;0;0;0;0;0;0;0;0;0;0;0;0
437;SULAWESI BARAT;MAMASA;BAMBANG;MASOSO;3;1;2;1;0;0;0;0;1;0;1;0;1;0;0;0;1;0;1;0
438;SULAWESI BARAT;MAMASA;BAMBANG;SALUASSING;13;0;13;0;0;0;0;0;0;0;0;0;0;0;0;0;0;0;0;0
439;SULAWESI BARAT;MAMASA;BAMBANG;SALUBULO;3;3;0;1;0;0;0;0;3;0;3;0;3;0;0;0;0;3;0;3
440;SULAWESI BARAT;MAMASA;BAMBANG;SALUKADI;7;9;-2;5;1;0;1;0;9;0;9;0;2;6;1;0;1;8;0;9
441;SULAWESI BARAT;MAMASA;BAMBANG;SALUKEPOPOK;5;6;-1;3;2;1;3;0;6;0;6;0;3;0;3;0;3;3;6;0
442;SULAWESI BARAT;MAMASA;BAMBANG;ULUMAMBI BARAT;1;0;1;0;0;0;0;0;0;0;0;0;0;0;0;0;0;0;0;0
443;SULAWESI BARAT;MAMASA;BAMBANG;LIMBADEBATA;1;3;-2;3;0;0;0;0;3;0;3;0;0;3;0;0;2;1;1;2
444;SULAWESI BARAT;MAMASA;BAMBANG;TANETE TOMBA;2;4;-2;4;0;0;0;0;4;0;4;0;3;1;0;0;3;1;1;3
445;SULAWESI BARAT;MAMASA;BAMBANG;BAMBANG;5;0;5;0;0;0;0;0;0;0;0;0;0;0;0;0;0;0;0;0
446;SULAWESI BARAT;MAMASA;BAMBANG;RANTELEMO;5;0;5;0;0;0;0;0;0;0;0;0;0;0;0;0;0;0;0;0
447;SULAWESI BARAT;MAMASA;BAMBANG;SALUDENGEN;1;1;0;1;0;0;0;0;1;0;1;0;0;1;0;0;0;1;0;1
448;SULAWESI BARAT;MAMASA;BAMBANG;ULUMAMBI;5;0;5;0;0;0;0;0;0;0;0;0;0;0;0;0;0;0;0;0
449;SULAWESI BARAT;MAMASA;BAMBANG;BAMBANG TIMUR;3;1;2;1;0;0;0;0;1;0;1;0;0;1;0;0;0;1;1;0
450;SULAWESI BARAT;MAMASA;BAMBANG;MINANGA;4;2;2;1;0;0;0;0;2;0;2;0;0;2;0;0;2;0;2;0
451;SULAWESI BARAT;MAMASA;BAMBANG;SIKAMASE;2;2;0;2;1;0;1;0;2;0;2;0;0;0;2;0;0;2;0;2
452;SULAWESI BARAT;MAMASA;BAMBANG;RANTETARIMA;0;0;0;0;0;0;0;0;0;0;0;0;0;0;0;0;0;0;0;0
453;SULAWESI BARAT;MAMASA;BAMBANG;SALURURU;0;0;0;0;0;0;0;0;0;0;0;0;0;0;0;0;0;0;0;0
;SULAWESI BARAT;MAMASA;BAMBANG;SALUTABANG;5;3;2;3;2;0;2;0;3;0;3;0;0;3;0;0;3;0;3;0
;SULAWESI BARAT;MAMASA;BAMBANG;BALATANA;3;4;-1;4;1;0;1;0;4;0;4;0;0;4;0;0;4;0;4;0
454;SULAWESI BARAT;MAMASA;BUNTUMALANGKA;BUNTUMALANGKA;5;11;-6;9;3;0;3;0;11;0;11;0;2;1;8;0;4;7;0;11
455;SULAWESI BARAT;MAMASA;BUNTUMALANGKA;RANTEBERAN;7;0;7;0;0;0;0;0;0;0;0;0;0;0;0;0;0;0;0;0
456;SULAWESI BARAT;MAMASA;BUNTUMALANGKA;KEBANGA;8;3;5;1;0;0;0;0;3;0;3;0;1;0;2;0;3;0;3;0
457;SULAWESI BARAT;MAMASA;BUNTUMALANGKA;SALURINDU;6;1;5;0;0;0;0;0;1;0;1;0;0;0;1;0;1;0;1;0
458;SULAWESI BARAT;MAMASA;BUNTUMALANGKA;TAORA;0;0;0;0;0;0;0;0;0;0;0;0;0;0;0;0;0;0;0;0
459;SULAWESI BARAT;MAMASA;BUNTUMALANGKA;KABAE;7;0;7;0;0;0;0;0;0;0;0;0;0;0;0;0;0;0;0;0
460;SULAWESI BARAT;MAMASA;BUNTUMALANGKA;SALUTAMBUN BARAT;8;7;1;1;1;0;1;0;7;0;7;0;6;1;0;0;1;6;2;5
461;SULAWESI BARAT;MAMASA;BUNTUMALANGKA;PENATANGAN;11;1;10;1;0;0;0;0;1;0;1;0;0;0;1;0;1;0;0;1
462;SULAWESI BARAT;MAMASA;BUNTUMALANGKA;SALUTAMBUN TIMUR;1;0;1;0;0;0;0;0;0;0;0;0;0;0;0;0;0;0;0;0
463;SULAWESI BARAT;MAMASA;BUNTUMALANGKA;SALUTAMBUN;0;0;0;0;0;0;0;0;0;0;0;0;0;0;0;0;0;0;0;0
464;SULAWESI BARAT;MAMASA;BUNTUMALANGKA;ARALLE TIMUR;9;0;9;0;0;0;0;0;0;0;0;0;0;0;0;0;0;0;0;0
465;SULAWESI BARAT;MAMASA;MAMBI;MAMBI;4;0;4;0;0;0;0;0;0;0;0;0;0;0;0;0;0;0;0;0
466;SULAWESI BARAT;MAMASA;MAMBI;TALIPUKKI;8;0;8;0;0;0;0;0;0;0;0;0;0;0;0;0;0;0;0;0
467;SULAWESI BARAT;MAMASA;MAMBI;RANTEBULAHAN;4;0;4;0;0;0;0;0;0;0;0;0;0;0;0;0;0;0;0;0
468;SULAWESI BARAT;MAMASA;MAMBI;SONDONGLAYU;4;0;4;0;0;0;0;0;0;0;0;0;0;0;0;0;0;0;0;0
469;SULAWESI BARAT;MAMASA;MAMBI;SALUBANUA;3;0;3;0;0;0;0;0;0;0;0;0;0;0;0;0;0;0;0;0
470;SULAWESI BARAT;MAMASA;MAMBI;TAPALINA;10;0;10;0;0;0;0;0;0;0;0;0;0;0;0;0;0;0;0;0
471;SULAWESI BARAT;MAMASA;MAMBI;SENDANA;5;0;5;0;0;0;0;0;0;0;0;0;0;0;0;0;0;0;0;0
472;SULAWESI BARAT;MAMASA;MAMBI;PAMOSEAN;2;0;2;0;0;0;0;0;0;0;0;0;0;0;0;0;0;0;0;0
473;SULAWESI BARAT;MAMASA;MAMBI;SELUMAKA;10;0;10;0;0;0;0;0;0;0;0;0;0;0;0;0;0;0;0;0
474;SULAWESI BARAT;MAMASA;MAMBI;BUJUNG MANURUNG;3;0;3;0;0;0;0;0;0;0;0;0;0;0;0;0;0;0;0;0
475;SULAWESI BARAT;MAMASA;MAMBI;SALU ALO;2;0;2;0;0;0;0;0;0;0;0;0;0;0;0;0;0;0;0;0
476;SULAWESI BARAT;MAMASA;MAMBI;INDOBANUA;4;0;4;0;0;0;0;0;0;0;0;0;0;0;0;0;0;0;0;0
477;SULAWESI BARAT;MAMASA;MAMBI;SALUDURIAN;5;0;5;0;0;0;0;0;0;0;0;0;0;0;0;0;0;0;0;0
478;SULAWESI BARAT;MAMASA;MEHALAAN;MEHALAAN;3;0;3;0;0;0;0;0;0;0;0;0;0;0;0;0;0;0;0;0
479;SULAWESI BARAT;MAMASA;MEHALAAN;BOTTENG;2;0;2;0;0;0;0;0;0;0;0;0;0;0;0;0;0;0;0;0
480;SULAWESI BARAT;MAMASA;MEHALAAN;SALUKONTA;4;0;4;0;0;0;0;0;0;0;0;0;0;0;0;0;0;0;0;0
481;SULAWESI BARAT;MAMASA;MEHALAAN;MESAKADA;4;0;4;0;0;0;0;0;0;0;0;0;0;0;0;0;0;0;0;0
482;SULAWESI BARAT;MAMASA;MEHALAAN;MEHALAAN BARAT;1;0;1;0;0;0;0;0;0;0;0;0;0;0;0;0;0;0;0;0
483;SULAWESI BARAT;MAMASA;MEHALAAN;SALUAHOK;8;0;8;0;0;0;0;0;0;0;0;0;0;0;0;0;0;0;0;0
484;SULAWESI BARAT;MAMASA;MEHALAAN;SALUBALO;1;0;1;0;0;0;0;0;0;0;0;0;0;0;0;0;0;0;0;0
485;SULAWESI BARAT;MAMASA;MEHALAAN;PASSEMBUK;0;0;0;0;0;0;0;0;0;0;0;0;0;0;0;0;0;0;0;0
486;SULAWESI BARAT;MAMASA;MEHALAAN;KONDO;0;0;0;0;0;0;0;0;0;0;0;0;0;0;0;0;0;0;0;0
487;SULAWESI BARAT;MAMASA;MEHALAAN;LEKO SUKAMAJU;0;0;0;0;0;0;0;0;0;0;0;0;0;0;0;0;0;0;0;0
488;SULAWESI BARAT;MAMASA;MEHALAAN;ULUMEA;1;0;1;0;0;0;0;0;0;0;0;0;0;0;0;0;0;0;0;0
489;SULAWESI BARAT;MAMASA;MESSAWA;MESSAWA;5;0;5;0;0;0;0;0;0;0;0;0;0;0;0;0;0;0;0;0
490;SULAWESI BARAT;MAMASA;MESSAWA;RIPPUNG;1;0;1;0;0;0;0;0;0;0;0;0;0;0;0;0;0;0;0;0
491;SULAWESI BARAT;MAMASA;MESSAWA;MAKUANG;4;0;4;0;0;0;0;0;0;0;0;0;0;0;0;0;0;0;0;0
492;SULAWESI BARAT;MAMASA;MESSAWA;SEPANG;0;0;0;0;0;0;0;0;0;0;0;0;0;0;0;0;0;0;0;0
493;SULAWESI BARAT;MAMASA;MESSAWA;MALIMBONG;3;0;3;0;0;0;0;0;0;0;0;0;0;0;0;0;0;0;0;0
494;SULAWESI BARAT;MAMASA;MESSAWA;MATANDE;0;0;0;0;0;0;0;0;0;0;0;0;0;0;0;0;0;0;0;0
495;SULAWESI BARAT;MAMASA;MESSAWA;SIPAI;0;0;0;0;0;0;0;0;0;0;0;0;0;0;0;0;0;0;0;0
496;SULAWESI BARAT;MAMASA;MESSAWA;PASMA MAMBU;4;0;4;0;0;0;0;0;0;0;0;0;0;0;0;0;0;0;0;0
497;SULAWESI BARAT;MAMASA;MESSAWA;TANETE BATU;0;0;0;0;0;0;0;0;0;0;0;0;0;0;0;0;0;0;0;0
498;SULAWESI BARAT;MAMASA;NOSU;NOSU;5;0;5;0;0;0;0;0;0;0;0;0;0;0;0;0;0;0;0;0
499;SULAWESI BARAT;MAMASA;NOSU;MINANGA;3;0;3;0;0;0;0;0;0;0;0;0;0;0;0;0;0;0;0;0
500;SULAWESI BARAT;MAMASA;NOSU;BATUPAPAN;2;0;2;0;0;0;0;0;0;0;0;0;0;0;0;0;0;0;0;0
501;SULAWESI BARAT;MAMASA;NOSU;MASEWWE;7;0;7;0;0;0;0;0;0;0;0;0;0;0;0;0;0;0;0;0
502;SULAWESI BARAT;MAMASA;NOSU;SIWI;2;0;2;0;0;0;0;0;0;0;0;0;0;0;0;0;0;0;0;0
503;SULAWESI BARAT;MAMASA;NOSU;MINANGA TIMUR;0;0;0;0;0;0;0;0;0;0;0;0;0;0;0;0;0;0;0;0
504;SULAWESI BARAT;MAMASA;NOSU;PARINDING;1;0;1;0;0;0;0;0;0;0;0;0;0;0;0;0;0;0;0;0
505;SULAWESI BARAT;MAMASA;PANA;PANA;6;0;6;0;0;0;0;0;0;0;0;0;0;0;0;0;0;0;0;0
506;SULAWESI BARAT;MAMASA;PANA;MANIPI;3;0;3;0;0;0;0;0;0;0;0;0;0;0;0;0;0;0;0;0
507;SULAWESI BARAT;MAMASA;PANA;MAMULLU;3;0;3;0;0;0;0;0;0;0;0;0;0;0;0;0;0;0;0;0
508;SULAWESI BARAT;MAMASA;PANA;SAPAN;0;0;0;0;0;0;0;0;0;0;0;0;0;0;0;0;0;0;0;0
509;SULAWESI BARAT;MAMASA;PANA;DATUBARINGAN;1;0;1;0;0;0;0;0;0;0;0;0;0;0;0;0;0;0;0;0
510;SULAWESI BARAT;MAMASA;PANA;PANURA;3;0;3;0;0;0;0;0;0;0;0;0;0;0;0;0;0;0;0;0
511;SULAWESI BARAT;MAMASA;PANA;TALLANG BULAWAN;2;0;2;0;0;0;0;0;0;0;0;0;0;0;0;0;0;0;0;0
512;SULAWESI BARAT;MAMASA;PANA;KARAKA;1;0;1;0;0;0;0;0;0;0;0;0;0;0;0;0;0;0;0;0
513;SULAWESI BARAT;MAMASA;PANA;ULUSALU;0;0;0;0;0;0;0;0;0;0;0;0;0;0;0;0;0;0;0;0
514;SULAWESI BARAT;MAMASA;PANA;WERI;0;0;0;0;0;0;0;0;0;0;0;0;0;0;0;0;0;0;0;0
515;SULAWESI BARAT;MAMASA;PANA;SALUTAMBUN;3;0;3;0;0;0;0;0;0;0;0;0;0;0;0;0;0;0;0;0
516;SULAWESI BARAT;MAMASA;PANA;SALOAN;1;0;1;0;0;0;0;0;0;0;0;0;0;0;0;0;0;0;0;0
517;SULAWESI BARAT;MAMASA;PANA;ULUSALU INDAH;0;0;0;0;0;0;0;0;0;0;0;0;0;0;0;0;0;0;0;0
518;SULAWESI BARAT;MAMASA;RANTEBULAHAN TIMUR;SALUMOKANAN;3;0;3;0;0;0;0;0;0;0;0;0;0;0;0;0;0;0;0;0
519;SULAWESI BARAT;MAMASA;RANTEBULAHAN TIMUR;SALUMOKANAN BARAT;1;0;1;0;0;0;0;0;0;0;0;0;0;0;0;0;0;0;0;0
520;SULAWESI BARAT;MAMASA;RANTEBULAHAN TIMUR;BUANGIN;3;0;3;0;0;0;0;0;0;0;0;0;0;0;0;0;0;0;0;0
521;SULAWESI BARAT;MAMASA;RANTEBULAHAN TIMUR;BAMBANG BUDA;5;0;5;0;0;0;0;0;0;0;0;0;0;0;0;0;0;0;0;0
522;SULAWESI BARAT;MAMASA;RANTEBULAHAN TIMUR;LEKO;0;0;0;0;0;0;0;0;0;0;0;0;0;0;0;0;0;0;0;0
523;SULAWESI BARAT;MAMASA;RANTEBULAHAN TIMUR;KIRAK;1;0;1;0;0;0;0;0;0;0;0;0;0;0;0;0;0;0;0;0
524;SULAWESI BARAT;MAMASA;RANTEBULAHAN TIMUR;SALUMOKANAN UTARA;0;0;0;0;0;0;0;0;0;0;0;0;0;0;0;0;0;0;0;0
525;SULAWESI BARAT;MAMASA;RANTEBULAHAN TIMUR;SAMPALE;0;0;0;0;0;0;0;0;0;0;0;0;0;0;0;0;0;0;0;0
526;SULAWESI BARAT;MAMASA;SESENAPADANG;OROBUA;10;0;10;0;0;0;0;0;0;0;0;0;0;0;0;0;0;0;0;0
527;SULAWESI BARAT;MAMASA;SESENAPADANG;PALADAN;5;0;5;0;0;0;0;0;0;0;0;0;0;0;0;0;0;0;0;0
528;SULAWESI BARAT;MAMASA;SESENAPADANG;OROBUA TIMUR;0;0;0;0;0;0;0;0;0;0;0;0;0;0;0;0;0;0;0;0
529;SULAWESI BARAT;MAMASA;SESENAPADANG;RANTE PUANG;3;0;3;0;0;0;0;0;0;0;0;0;0;0;0;0;0;0;0;0
530;SULAWESI BARAT;MAMASA;SESENAPADANG;SATENETEAN;2;0;2;0;0;0;0;0;0;0;0;0;0;0;0;0;0;0;0;0
531;SULAWESI BARAT;MAMASA;SESENAPADANG;LISUAN ADA;3;0;3;0;0;0;0;0;0;0;0;0;0;0;0;0;0;0;0;0
532;SULAWESI BARAT;MAMASA;SESENAPADANG;OROBUA SELATAN;3;0;3;0;0;0;0;0;0;0;0;0;0;0;0;0;0;0;0;0
533;SULAWESI BARAT;MAMASA;SESENAPADANG;MALANGKENA PADANG;5;0;5;0;0;0;0;0;0;0;0;0;0;0;0;0;0;0;0;0
534;SULAWESI BARAT;MAMASA;SESENAPADANG;MALIMBONG;2;0;2;0;0;0;0;0;0;0;0;0;0;0;0;0;0;0;0;0
535;SULAWESI BARAT;MAMASA;SESENAPADANG;MARAMPAN OROBUA;1;0;1;0;0;0;0;0;0;0;0;0;0;0;0;0;0;0;0;0
536;SULAWESI BARAT;MAMASA;SUMARORONG;SUMARORONG;9;0;9;0;0;0;0;0;0;0;0;0;0;0;0;0;0;0;0;0
537;SULAWESI BARAT;MAMASA;SUMARORONG;TABONE;2;0;2;0;0;0;0;0;0;0;0;0;0;0;0;0;0;0;0;0
538;SULAWESI BARAT;MAMASA;SUMARORONG;BATANG URU;3;0;3;0;0;0;0;0;0;0;0;0;0;0;0;0;0;0;0;0
539;SULAWESI BARAT;MAMASA;SUMARORONG;SASAKAN;8;0;8;0;0;0;0;0;0;0;0;0;0;0;0;0;0;0;0;0
540;SULAWESI BARAT;MAMASA;SUMARORONG;TADISI;3;0;3;0;0;0;0;0;0;0;0;0;0;0;0;0;0;0;0;0
541;SULAWESI BARAT;MAMASA;SUMARORONG;SIBANAWA;1;0;1;0;0;0;0;0;0;0;0;0;0;0;0;0;0;0;0;0
542;SULAWESI BARAT;MAMASA;SUMARORONG;BATANGNGURU TIMUR;2;0;2;0;0;0;0;0;0;0;0;0;0;0;0;0;0;0;0;0
543;SULAWESI BARAT;MAMASA;SUMARORONG;SALUBALO;4;0;4;0;0;0;0;0;0;0;0;0;0;0;0;0;0;0;0;0
544;SULAWESI BARAT;MAMASA;SUMARORONG;BANEA;3;0;3;0;0;0;0;0;0;0;0;0;0;0;0;0;0;0;0;0
545;SULAWESI BARAT;MAMASA;SUMARORONG;RANTE KAMASE;3;0;3;0;0;0;0;0;0;0;0;0;0;0;0;0;0;0;0;0
546;SULAWESI BARAT;MAMASA;TABANG;TABANG;1;0;1;0;0;0;0;0;0;0;0;0;0;0;0;0;0;0;0;0
547;SULAWESI BARAT;MAMASA;TABANG;TADOKALUA;5;1;4;0;0;0;0;0;1;0;1;0;0;1;0;0;0;1;1;0
548;SULAWESI BARAT;MAMASA;TABANG;TABANG BARAT;4;1;3;0;0;0;0;0;1;0;1;0;0;1;0;0;0;1;0;1
549;SULAWESI BARAT;MAMASA;TABANG;MASUPU;3;2;1;1;1;0;1;0;2;0;2;0;0;2;0;0;2;0;0;2
550;SULAWESI BARAT;MAMASA;TABANG;KALAMA;0;0;0;0;0;0;0;0;0;0;0;0;0;0;0;0;0;0;0;0
551;SULAWESI BARAT;MAMASA;TABANG;BAKADISURA;3;0;3;0;0;0;0;0;0;0;0;0;0;0;0;0;0;0;0;0
552;SULAWESI BARAT;MAMASA;TABANG;SALUKONA;18;6;12;3;3;0;3;0;6;0;6;0;0;0;6;0;6;0;6;0
553;SULAWESI BARAT;MAMASA;TABULAHAN;LAKAHANG;5;1;4;1;0;0;0;0;1;0;1;0;1;0;0;0;0;1;1;0
554;SULAWESI BARAT;MAMASA;TABULAHAN;PERIANGAN;0;0;0;0;0;0;0;0;0;0;0;0;0;0;0;0;0;0;0;0
555;SULAWESI BARAT;MAMASA;TABULAHAN;MALATIRO;3;0;3;0;0;0;0;0;0;0;0;0;0;0;0;0;0;0;0;0
556;SULAWESI BARAT;MAMASA;TABULAHAN;TABULAHAN;0;0;0;0;0;0;0;0;0;0;0;0;0;0;0;0;0;0;0;0
557;SULAWESI BARAT;MAMASA;TABULAHAN;SALULEANG;2;0;2;0;0;0;0;0;0;0;0;0;0;0;0;0;0;0;0;0
558;SULAWESI BARAT;MAMASA;TABULAHAN;TAMPAK KURRA;0;0;0;0;0;0;0;0;0;0;0;0;0;0;0;0;0;0;0;0
559;SULAWESI BARAT;MAMASA;TABULAHAN;GANDANG DEWATA;5;0;5;0;0;0;0;0;0;0;0;0;0;0;0;0;0;0;0;0
560;SULAWESI BARAT;MAMASA;TABULAHAN;BURANA;1;0;1;0;0;0;0;0;0;0;0;0;0;0;0;0;0;0;0;0
561;SULAWESI BARAT;MAMASA;TABULAHAN;SALUBAKKA;4;0;4;0;0;0;0;0;0;0;0;0;0;0;0;0;0;0;0;0
562;SULAWESI BARAT;MAMASA;TABULAHAN;PANGANDARAN;2;0;2;0;0;0;0;0;0;0;0;0;0;0;0;0;0;0;0;0
563;SULAWESI BARAT;MAMASA;TABULAHAN;TALOPAK;1;0;1;0;0;0;0;0;0;0;0;0;0;0;0;0;0;0;0;0
564;SULAWESI BARAT;MAMASA;TABULAHAN;PEU';0;0;0;0;0;0;0;0;0;0;0;0;0;0;0;0;0;0;0;0
565;SULAWESI BARAT;MAMASA;TABULAHAN;TIMORO;2;0;2;0;0;0;0;0;0;0;0;0;0;0;0;0;0;0;0;0
566;SULAWESI BARAT;MAMASA;TABULAHAN;LAKAHANG UTAMA;6;0;6;0;0;0;0;0;0;0;0;0;0;0;0;0;0;0;0;0
567;SULAWESI BARAT;MAMASA;TANDUK KALUA;MINAKE;1;0;1;0;0;0;0;0;0;0;0;0;0;0;0;0;0;0;0;0
568;SULAWESI BARAT;MAMASA;TANDUK KALUA;MALABO;0;0;0;0;0;0;0;0;0;0;0;0;0;0;0;0;0;0;0;0
569;SULAWESI BARAT;MAMASA;TANDUK KALUA;SINDAGAMANIK;8;5;3;4;3;0;3;0;5;0;5;0;0;5;0;0;5;0;0;5
570;SULAWESI BARAT;MAMASA;TANDUK KALUA;PARONDOBULAWAN;4;0;4;0;0;0;0;0;0;0;0;0;0;0;0;0;0;0;0;0
571;SULAWESI BARAT;MAMASA;TANDUK KALUA;TAMALANTIK;1;11;-10;10;9;0;6;3;11;0;11;0;2;9;0;0;0;11;1;10
572;SULAWESI BARAT;MAMASA;TANDUK KALUA;MANNABABA;4;0;4;0;0;0;0;0;0;0;0;0;0;0;0;0;0;0;0;0
573;SULAWESI BARAT;MAMASA;TANDUK KALUA;MESAKADA;2;1;1;1;0;0;0;0;1;0;1;0;1;0;0;0;1;0;0;1
574;SULAWESI BARAT;MAMASA;TANDUK KALUA;BALLABATU;5;0;5;0;0;0;0;0;0;0;0;0;0;0;0;0;0;0;0;0
575;SULAWESI BARAT;MAMASA;TANDUK KALUA;PAMBE;8;0;8;0;0;0;0;0;0;0;0;0;0;0;0;0;0;0;0;0
576;SULAWESI BARAT;MAMASA;TANDUK KALUA;SALURANO;3;0;3;0;0;0;0;0;0;0;0;0;0;0;0;0;0;0;0;0
577;SULAWESI BARAT;MAMASA;TANDUK KALUA;TALIMBUNG;1;0;1;0;0;0;0;0;0;0;0;0;0;0;0;0;0;0;0;0
578;SULAWESI BARAT;MAMASA;TANDUK KALUA;KANAN;0;0;0;0;0;0;0;0;0;0;0;0;0;0;0;0;0;0;0;0
579;SULAWESI BARAT;MAMASA;TAWALIAN;TAWALIAN;1;0;1;0;0;0;0;0;0;0;0;0;0;0;0;0;0;0;0;0
580;SULAWESI BARAT;MAMASA;TAWALIAN;TAWALIAN TIMUR;2;0;2;0;0;0;0;0;0;0;0;0;0;0;0;0;0;0;0;0
581;SULAWESI BARAT;MAMASA;TAWALIAN;KARIANGO;0;0;0;0;0;0;0;0;0;0;0;0;0;0;0;0;0;0;0;0
582;SULAWESI BARAT;MAMASA;TAWALIAN;RANTETANGNGA;5;3;2;1;1;0;1;0;3;0;3;0;0;0;3;0;0;3;0;3
583;SULAWESI BARAT;MAMUJU TENGAH;TOBADAK;MAHAHE;2;25;-23;18;2;0;2;0;25;0;25;0;25;0;0;0;0;25;2;23
584;SULAWESI BARAT;MAMUJU TENGAH;TOBADAK;SALOBAJA;14;28;-14;22;13;0;10;3;28;0;28;0;0;20;8;0;2;26;5;23
585;SULAWESI BARAT;MAMUJU TENGAH;TOBADAK;TOBADAK;67;3;64;1;1;0;1;0;3;0;3;0;2;1;0;0;1;2;1;2
586;SULAWESI BARAT;MAMUJU TENGAH;TOBADAK;PALONGAAN;21;26;-5;17;11;0;11;0;26;0;26;0;11;12;2;1;17;9;2;24
587;SULAWESI BARAT;MAMUJU TENGAH;TOBADAK;BATU PARIGI;23;13;10;10;9;0;9;0;13;0;13;0;0;12;0;1;0;13;0;13
588;SULAWESI BARAT;MAMUJU TENGAH;TOBADAK;BAMBADARU;7;24;-17;19;5;0;5;0;24;0;24;0;14;10;0;0;13;11;11;13
589;SULAWESI BARAT;MAMUJU TENGAH;TOBADAK;SEJATI;4;21;-17;20;12;0;9;3;21;0;21;0;5;15;1;0;1;20;4;17
590;SULAWESI BARAT;MAMUJU TENGAH;TOBADAK;SALOADAK;19;11;8;7;5;0;5;0;11;0;11;0;5;3;3;0;0;11;3;8
591;SULAWESI BARAT;MAMUJU TENGAH;PANGALE;POLO PANGALE;5;0;5;0;0;0;0;0;0;0;0;0;0;0;0;0;0;0;0;0
592;SULAWESI BARAT;MAMUJU TENGAH;PANGALE;PANGALE;8;2;6;0;0;0;0;0;2;0;2;0;2;0;0;0;2;0;1;1
593;SULAWESI BARAT;MAMUJU TENGAH;PANGALE;SARTANAMAJU;10;0;10;0;0;0;0;0;0;0;0;0;0;0;0;0;0;0;0;0
594;SULAWESI BARAT;MAMUJU TENGAH;PANGALE;POLO LERENG;17;10;7;1;1;0;1;0;10;0;10;0;10;0;0;0;2;8;4;6
595;SULAWESI BARAT;MAMUJU TENGAH;PANGALE;KUO;23;0;23;0;0;0;0;0;0;0;0;0;0;0;0;0;0;0;0;0
596;SULAWESI BARAT;MAMUJU TENGAH;PANGALE;POLO CAMBA;5;0;5;0;0;0;0;0;0;0;0;0;0;0;0;0;0;0;0;0
597;SULAWESI BARAT;MAMUJU TENGAH;PANGALE;LAMBA-LAMBA;18;12;6;7;5;0;5;0;12;0;12;0;10;0;2;0;7;5;5;7
598;SULAWESI BARAT;MAMUJU TENGAH;PANGALE;KOMBILING;20;0;20;0;0;0;0;0;0;0;0;0;0;0;0;0;0;0;0;0
599;SULAWESI BARAT;MAMUJU TENGAH;PANGALE;LEMO-LEMO;5;1;4;1;1;0;1;0;1;0;1;0;1;0;0;0;1;0;0;1
600;SULAWESI BARAT;MAMUJU TENGAH;BUDONG-BUDONG;BABANA;35;5;30;4;3;0;3;0;5;0;5;0;5;0;0;0;4;1;0;5
601;SULAWESI BARAT;MAMUJU TENGAH;BUDONG-BUDONG;LUMU;26;0;26;0;0;0;0;0;0;0;0;0;0;0;0;0;0;0;0;0
602;SULAWESI BARAT;MAMUJU TENGAH;BUDONG-BUDONG;PONTANAKAYANG;29;0;29;0;0;0;0;0;0;0;0;0;0;0;0;0;0;0;0;0
603;SULAWESI BARAT;MAMUJU TENGAH;BUDONG-BUDONG;SALOGATTA;27;8;19;3;1;0;1;0;8;0;8;0;7;1;0;0;0;8;0;8
604;SULAWESI BARAT;MAMUJU TENGAH;BUDONG-BUDONG;KIRE;5;8;-3;8;6;0;6;0;8;0;8;0;8;0;0;0;0;8;3;5
605;SULAWESI BARAT;MAMUJU TENGAH;BUDONG-BUDONG;TINALI;19;11;8;5;4;0;4;0;11;0;11;0;11;0;0;0;11;0;1;10
606;SULAWESI BARAT;MAMUJU TENGAH;BUDONG-BUDONG;SALUMANURUNG;8;13;-5;9;3;0;3;0;13;0;13;0;13;0;0;0;13;0;0;13
607;SULAWESI BARAT;MAMUJU TENGAH;BUDONG-BUDONG;PASAPA;3;0;3;0;0;0;0;0;0;0;0;0;0;0;0;0;0;0;0;0
608;SULAWESI BARAT;MAMUJU TENGAH;BUDONG-BUDONG;BOJO;18;0;18;0;0;0;0;0;0;0;0;0;0;0;0;0;0;0;0;0
609;SULAWESI BARAT;MAMUJU TENGAH;BUDONG-BUDONG;BARAKKANG;13;1;12;0;0;0;0;0;1;0;1;0;1;0;0;0;0;1;1;0
610;SULAWESI BARAT;MAMUJU TENGAH;BUDONG-BUDONG;LEMBAH HADA;3;0;3;0;0;0;0;0;0;0;0;0;0;0;0;0;0;0;0;0
611;SULAWESI BARAT;MAMUJU TENGAH;TOPOYO;BUDONG-BUDONG;12;14;-2;9;8;0;8;0;14;0;14;0;0;14;0;0;3;11;3;11
612;SULAWESI BARAT;MAMUJU TENGAH;TOPOYO;TOPOYO;28;1;27;1;0;0;0;0;1;0;0;1;1;0;0;0;0;1;1;0
613;SULAWESI BARAT;MAMUJU TENGAH;TOPOYO;TUMBU;11;22;-11;20;11;0;11;0;22;0;22;0;2;6;14;0;9;13;14;8
614;SULAWESI BARAT;MAMUJU TENGAH;TOPOYO;KABUBU;23;19;4;9;5;0;5;0;19;0;19;0;1;0;18;0;2;17;1;18
615;SULAWESI BARAT;MAMUJU TENGAH;TOPOYO;WAEPUTEH;13;3;10;1;1;0;1;0;3;0;3;0;3;0;0;0;1;2;1;2
616;SULAWESI BARAT;MAMUJU TENGAH;TOPOYO;TANGKOU;7;0;7;0;0;0;0;0;0;0;0;0;0;0;0;0;0;0;0;0
617;SULAWESI BARAT;MAMUJU TENGAH;TOPOYO;TABOLANG;24;9;15;5;3;0;3;0;9;0;9;0;0;0;9;0;6;3;9;0
618;SULAWESI BARAT;MAMUJU TENGAH;TOPOYO;PARAILI;10;1;9;0;0;0;0;0;1;0;1;0;1;0;0;0;1;0;0;1
619;SULAWESI BARAT;MAMUJU TENGAH;TOPOYO;SALUPANGKANG;9;4;5;4;4;0;4;0;4;0;4;0;4;0;0;0;1;3;1;3
620;SULAWESI BARAT;MAMUJU TENGAH;TOPOYO;SALUPANGKANG IV;4;0;4;0;0;0;0;0;0;0;0;0;0;0;0;0;0;0;0;0
621;SULAWESI BARAT;MAMUJU TENGAH;TOPOYO;TAPPILINA;7;5;2;5;5;0;5;0;5;0;5;0;5;0;0;0;0;5;0;5
622;SULAWESI BARAT;MAMUJU TENGAH;TOPOYO;BAMBAMANURUNG;9;3;6;2;2;0;2;0;3;0;3;0;1;0;2;0;3;0;1;2
623;SULAWESI BARAT;MAMUJU TENGAH;TOPOYO;SALULEKBO;2;0;2;0;0;0;0;0;0;0;0;0;0;0;0;0;0;0;0;0
624;SULAWESI BARAT;MAMUJU TENGAH;TOPOYO;PANGALLOANG;14;1;13;0;0;0;0;0;1;0;1;0;0;0;1;0;0;1;0;1
625;SULAWESI BARAT;MAMUJU TENGAH;TOPOYO;SINABATTA;7;6;1;3;1;0;0;1;6;0;6;0;6;0;0;0;6;0;3;3
626;SULAWESI BARAT;MAMUJU TENGAH;KAROSSA;KAROSSA;33;1;32;1;1;0;1;0;1;0;1;0;1;0;0;0;1;0;0;1
627;SULAWESI BARAT;MAMUJU TENGAH;KAROSSA;TASOKKO;40;1;39;1;1;0;0;1;1;0;1;0;1;0;0;0;0;1;0;1
628;SULAWESI BARAT;MAMUJU TENGAH;KAROSSA;LARA;10;0;10;0;0;0;0;0;0;0;0;0;0;0;0;0;0;0;0;0
629;SULAWESI BARAT;MAMUJU TENGAH;KAROSSA;KADAILA;19;0;19;0;0;0;0;0;0;0;0;0;0;0;0;0;0;0;0;0
630;SULAWESI BARAT;MAMUJU TENGAH;KAROSSA;KAYU CALLA;6;0;6;0;0;0;0;0;0;0;0;0;0;0;0;0;0;0;0;0
631;SULAWESI BARAT;MAMUJU TENGAH;KAROSSA;LEMBAH HOPO;4;17;-13;12;5;0;5;0;17;0;17;0;17;0;0;0;7;10;0;17
632;SULAWESI BARAT;MAMUJU TENGAH;KAROSSA;BENGGAULU;11;0;11;0;0;0;0;0;0;0;0;0;0;0;0;0;0;0;0;0
633;SULAWESI BARAT;MAMUJU TENGAH;KAROSSA;SUKA MAJU;11;0;11;0;0;0;0;0;0;0;0;0;0;0;0;0;0;0;0;0
634;SULAWESI BARAT;MAMUJU TENGAH;KAROSSA;KAMBUNONG;36;2;34;1;1;0;1;0;2;0;2;0;2;0;0;0;1;1;0;2
635;SULAWESI BARAT;MAMUJU TENGAH;KAROSSA;SALUBIRO;16;0;16;0;0;0;0;0;0;0;0;0;0;0;0;0;0;0;0;0
636;SULAWESI BARAT;MAMUJU TENGAH;KAROSSA;SANJANGO;7;0;7;0;0;0;0;0;0;0;0;0;0;0;0;0;0;0;0;0
