NO;PROVINSI;KABUPATEN;KECAMATAN;KELURAHAN;PA;SUNTIK;PIL;KONDOM;IMPLAN;IUD;VASEKTOMI;TUBEKTOMI;MAL;KB MODERN;KB TRADISIONAL;BULAN
0;SULAWESI BARAT;PASANGKAYU;BAMBAIRA;BAMBAIRA;275;81;50;7;113;9;0;12;0;272;3;JANUARI
1;SULAWESI BARAT;PASANGKAYU;BAMBAIRA;KASOLOANG;172;64;23;0;64;11;0;10;0;172;0;JANUARI
2;SULAWESI BARAT;PASANGKAYU;BAMBAIRA;TAMPAURE;246;110;51;2;59;6;0;12;0;240;6;JANUARI
3;SULAWESI BARAT;PASANGKAYU;BAMBAIRA;KALUKU NANGKA;284;135;63;2;66;5;0;13;0;284;0;JANUARI
4;SULAWESI BARAT;PASANGKAYU;BULU TABA;LILIMORI;281;111;30;7;81;33;0;19;0;281;0;JANUARI
5;SULAWESI BARAT;PASANGKAYU;BULU TABA;KARAVE;256;98;47;23;60;9;0;8;0;245;11;JANUARI
6;SULAWESI BARAT;PASANGKAYU;BULU TABA;BUKIT HARAPAN;142;59;35;0;35;9;1;3;0;142;0;JANUARI
7;SULAWESI BARAT;PASANGKAYU;BULU TABA;KASTABUANA;162;91;29;1;25;7;0;8;0;161;1;JANUARI
8;SULAWESI BARAT;PASANGKAYU;BULU TABA;SUMBER SARI;31;22;5;0;3;1;0;0;0;31;0;JANUARI
9;SULAWESI BARAT;PASANGKAYU;BULU TABA;LELEJAE;162;72;25;2;41;11;0;9;1;161;1;JANUARI
10;SULAWESI BARAT;PASANGKAYU;BULU TABA;OMPI;105;47;32;4;18;3;0;1;0;105;0;JANUARI
11;SULAWESI BARAT;PASANGKAYU;DAPURANG;DAPURANG;432;245;66;4;78;23;1;6;0;423;9;JANUARI
12;SULAWESI BARAT;PASANGKAYU;DAPURANG;BENGGAULU;302;130;80;0;71;7;0;14;0;302;0;JANUARI
13;SULAWESI BARAT;PASANGKAYU;DAPURANG;TIRTABUANA;148;86;15;2;38;2;0;5;0;148;0;JANUARI
14;SULAWESI BARAT;PASANGKAYU;DAPURANG;BULU BONGGU;261;73;53;3;117;6;0;4;0;256;5;JANUARI
15;SULAWESI BARAT;PASANGKAYU;DAPURANG;SARASA;191;103;57;1;20;6;0;4;0;191;0;JANUARI
16;SULAWESI BARAT;MAMUJU TENGAH;PANGALE;POLO PANGALE;262;65;63;12;115;3;0;3;0;261;1;JANUARI
17;SULAWESI BARAT;MAMUJU TENGAH;PANGALE;PANGALE;221;59;88;14;44;5;2;9;0;221;0;JANUARI
18;SULAWESI BARAT;MAMUJU TENGAH;PANGALE;SARTANAMAJU;91;27;22;12;19;7;0;4;0;91;0;JANUARI
19;SULAWESI BARAT;MAMUJU TENGAH;PANGALE;POLO LERENG;226;71;49;4;91;4;0;4;0;223;3;JANUARI
20;SULAWESI BARAT;MAMUJU TENGAH;PANGALE;KUO;409;209;52;2;124;11;0;8;3;409;0;JANUARI
21;SULAWESI BARAT;MAMUJU TENGAH;PANGALE;POLO CAMBA;145;49;44;10;37;1;0;1;3;145;0;JANUARI
22;SULAWESI BARAT;MAMUJU TENGAH;PANGALE;LAMBA-LAMBA;126;46;33;2;42;1;0;2;0;126;0;JANUARI
23;SULAWESI BARAT;MAMUJU TENGAH;PANGALE;KOMBILING;247;77;58;6;91;3;0;9;0;244;3;JANUARI
24;SULAWESI BARAT;MAMUJU TENGAH;PANGALE;LEMO-LEMO;129;50;38;1;37;2;1;0;0;129;0;JANUARI
25;SULAWESI BARAT;MAMUJU TENGAH;BUDONG-BUDONG;BABANA;587;283;93;10;164;20;2;14;0;586;1;JANUARI
26;SULAWESI BARAT;MAMUJU TENGAH;BUDONG-BUDONG;LUMU;238;104;28;0;94;3;0;7;0;236;2;JANUARI
27;SULAWESI BARAT;MAMUJU TENGAH;BUDONG-BUDONG;PONTANAKAYANG;347;214;26;11;85;5;0;0;1;342;5;JANUARI
28;SULAWESI BARAT;MAMUJU TENGAH;BUDONG-BUDONG;SALOGATTA;533;188;89;14;206;11;0;7;0;515;18;JANUARI
29;SULAWESI BARAT;MAMUJU TENGAH;BUDONG-BUDONG;KIRE;192;64;38;2;85;1;0;2;0;192;0;JANUARI
30;SULAWESI BARAT;MAMUJU TENGAH;BUDONG-BUDONG;TINALI;246;116;44;0;76;3;0;7;0;246;0;JANUARI
31;SULAWESI BARAT;MAMUJU TENGAH;BUDONG-BUDONG;SALUMANURUNG;153;74;42;3;26;2;0;6;0;153;0;JANUARI
32;SULAWESI BARAT;MAMUJU TENGAH;BUDONG-BUDONG;PASAPA;183;84;57;1;28;0;0;8;0;178;5;JANUARI
33;SULAWESI BARAT;MAMUJU TENGAH;BUDONG-BUDONG;BOJO;254;111;62;0;72;6;0;3;0;254;0;JANUARI
34;SULAWESI BARAT;MAMUJU TENGAH;BUDONG-BUDONG;BARAKKANG;112;54;18;4;34;1;0;1;0;112;0;JANUARI
35;SULAWESI BARAT;MAMUJU TENGAH;BUDONG-BUDONG;LEMBAH HADA;65;29;10;0;23;1;0;2;0;65;0;JANUARI
36;SULAWESI BARAT;MAMASA;TAWALIAN;TAWALIAN;247;122;37;0;71;8;0;7;0;245;2;JANUARI
37;SULAWESI BARAT;MAMASA;TAWALIAN;TAWALIAN TIMUR;168;69;48;2;44;1;0;1;0;165;3;JANUARI
38;SULAWESI BARAT;MAMASA;TAWALIAN;KARIANGO;209;80;52;0;77;0;0;0;0;209;0;JANUARI
39;SULAWESI BARAT;MAMASA;TAWALIAN;RANTETANGNGA;138;27;35;5;63;4;0;3;0;137;1;JANUARI
40;SULAWESI BARAT;PASANGKAYU;DURIPOKU;TAMMARUNANG;224;87;47;15;57;6;0;12;0;224;0;JANUARI
41;SULAWESI BARAT;PASANGKAYU;DURIPOKU;SAPTANAJAYA;202;109;40;1;38;9;0;5;0;202;0;JANUARI
42;SULAWESI BARAT;PASANGKAYU;DURIPOKU;TARANGGI;98;17;23;6;43;7;0;2;0;98;0;JANUARI
43;SULAWESI BARAT;PASANGKAYU;DURIPOKU;SIPAKAINGA;76;38;23;1;11;2;0;1;0;76;0;JANUARI
44;SULAWESI BARAT;MAMUJU TENGAH;TOBADAK;MAHAHE;335;136;75;13;88;11;0;10;1;334;1;JANUARI
45;SULAWESI BARAT;MAMUJU TENGAH;TOBADAK;SALOBAJA;377;212;51;12;86;7;0;9;0;377;0;JANUARI
46;SULAWESI BARAT;MAMUJU TENGAH;TOBADAK;TOBADAK;1332;578;284;21;322;35;3;26;1;1270;62;JANUARI
47;SULAWESI BARAT;MAMUJU TENGAH;TOBADAK;PALONGAAN;284;106;85;4;73;2;0;13;0;283;1;JANUARI
48;SULAWESI BARAT;MAMUJU TENGAH;TOBADAK;BATU PARIGI;716;166;228;6;260;24;1;21;0;706;10;JANUARI
49;SULAWESI BARAT;MAMUJU TENGAH;TOBADAK;BAMBADARU;194;64;55;9;58;1;1;6;0;194;0;JANUARI
50;SULAWESI BARAT;MAMUJU TENGAH;TOBADAK;SEJATI;153;89;26;4;27;2;0;5;0;153;0;JANUARI
51;SULAWESI BARAT;MAMUJU TENGAH;TOBADAK;SALOADAK;257;118;10;1;107;11;0;7;0;254;3;JANUARI
52;SULAWESI BARAT;PASANGKAYU;LARIANG;PARABU;139;29;24;9;38;22;0;9;0;131;8;JANUARI
53;SULAWESI BARAT;PASANGKAYU;LARIANG;KENANGAN;53;14;6;2;17;7;0;5;0;51;2;JANUARI
54;SULAWESI BARAT;PASANGKAYU;LARIANG;BAJAWALI;131;28;26;1;53;11;0;12;0;131;0;JANUARI
55;SULAWESI BARAT;PASANGKAYU;LARIANG;SINGGANI;191;73;61;1;36;9;0;7;0;187;4;JANUARI
56;SULAWESI BARAT;PASANGKAYU;LARIANG;KULU;110;37;33;0;29;9;0;1;0;109;1;JANUARI
57;SULAWESI BARAT;PASANGKAYU;LARIANG;BATU MATORU;93;32;19;0;24;8;0;10;0;93;0;JANUARI
58;SULAWESI BARAT;PASANGKAYU;LARIANG;BAMBAKORO;160;53;41;2;45;11;0;8;0;160;0;JANUARI
59;SULAWESI BARAT;MAMASA;TABULAHAN;LAKAHANG;276;95;153;2;16;2;1;7;0;276;0;JANUARI
60;SULAWESI BARAT;MAMASA;TABULAHAN;PERIANGAN;68;18;49;0;1;0;0;0;0;68;0;JANUARI
61;SULAWESI BARAT;MAMASA;TABULAHAN;MALATIRO;142;63;70;0;2;1;0;2;0;138;4;JANUARI
62;SULAWESI BARAT;MAMASA;TABULAHAN;TABULAHAN;60;21;35;0;1;1;0;2;0;60;0;JANUARI
63;SULAWESI BARAT;MAMASA;TABULAHAN;SALULEANG;35;9;25;0;1;0;0;0;0;35;0;JANUARI
64;SULAWESI BARAT;MAMASA;TABULAHAN;TAMPAK KURRA;177;52;120;0;4;0;1;0;0;177;0;JANUARI
65;SULAWESI BARAT;MAMASA;TABULAHAN;GANDANG DEWATA;34;12;20;0;2;0;0;0;0;34;0;JANUARI
66;SULAWESI BARAT;MAMASA;TABULAHAN;BURANA;98;25;67;0;4;0;1;1;0;98;0;JANUARI
67;SULAWESI BARAT;MAMASA;TABULAHAN;SALUBAKKA;100;62;37;0;0;0;0;1;0;100;0;JANUARI
68;SULAWESI BARAT;MAMASA;TABULAHAN;PANGANDARAN;139;40;95;0;4;0;0;0;0;139;0;JANUARI
69;SULAWESI BARAT;MAMASA;TABULAHAN;TALOPAK;53;14;32;0;7;0;0;0;0;53;0;JANUARI
70;SULAWESI BARAT;MAMASA;TABULAHAN;PEU';53;19;34;0;0;0;0;0;0;53;0;JANUARI
71;SULAWESI BARAT;MAMASA;TABULAHAN;TIMORO;42;11;23;0;5;1;0;2;0;42;0;JANUARI
72;SULAWESI BARAT;MAMASA;TABULAHAN;LAKAHANG UTAMA;76;36;35;0;1;0;0;3;0;75;1;JANUARI
73;SULAWESI BARAT;MAMASA;TANDUK KALUA;MINAKE;77;22;6;1;44;2;0;2;0;77;0;JANUARI
74;SULAWESI BARAT;MAMASA;TANDUK KALUA;MALABO;52;24;12;0;7;6;0;3;0;52;0;JANUARI
75;SULAWESI BARAT;MAMASA;TANDUK KALUA;SINDAGAMANIK;142;79;18;1;42;1;0;1;0;142;0;JANUARI
76;SULAWESI BARAT;MAMASA;TANDUK KALUA;PARONDOBULAWAN;107;72;11;1;20;1;0;2;0;107;0;JANUARI
77;SULAWESI BARAT;MAMASA;TANDUK KALUA;TAMALANTIK;156;58;57;0;31;5;0;2;1;154;2;JANUARI
78;SULAWESI BARAT;MAMASA;TANDUK KALUA;MANNABABA;68;26;1;0;41;0;0;0;0;68;0;JANUARI
79;SULAWESI BARAT;MAMASA;TANDUK KALUA;MESAKADA;123;54;26;0;43;0;0;0;0;123;0;JANUARI
80;SULAWESI BARAT;MAMASA;TANDUK KALUA;BALLABATU;152;21;15;0;112;3;0;1;0;152;0;JANUARI
81;SULAWESI BARAT;MAMASA;TANDUK KALUA;PAMBE;87;24;17;1;42;2;1;0;0;87;0;JANUARI
82;SULAWESI BARAT;MAMASA;TANDUK KALUA;SALURANO;73;29;14;0;28;1;0;1;0;73;0;JANUARI
83;SULAWESI BARAT;MAMASA;TANDUK KALUA;TALIMBUNG;93;43;44;0;5;0;0;1;0;93;0;JANUARI
84;SULAWESI BARAT;MAMASA;TANDUK KALUA;KANAN;120;44;27;0;37;9;0;1;0;118;2;JANUARI
85;SULAWESI BARAT;MAMASA;RANTEBULAHAN TIMUR;SALUMOKANAN;95;41;18;0;29;6;0;1;0;95;0;JANUARI
86;SULAWESI BARAT;MAMASA;RANTEBULAHAN TIMUR;SALUMOKANAN BARAT;109;44;25;0;37;0;0;0;1;107;2;JANUARI
87;SULAWESI BARAT;MAMASA;RANTEBULAHAN TIMUR;BUANGIN;94;63;17;0;13;0;0;0;0;93;1;JANUARI
88;SULAWESI BARAT;MAMASA;RANTEBULAHAN TIMUR;BAMBANG BUDA;121;35;63;0;21;1;0;1;0;121;0;JANUARI
89;SULAWESI BARAT;MAMASA;RANTEBULAHAN TIMUR;LEKO;22;5;12;0;5;0;0;0;0;22;0;JANUARI
90;SULAWESI BARAT;MAMASA;RANTEBULAHAN TIMUR;KIRAK;73;45;22;0;6;0;0;0;0;73;0;JANUARI
91;SULAWESI BARAT;MAMASA;RANTEBULAHAN TIMUR;SALUMOKANAN UTARA;110;66;7;0;35;1;0;1;0;110;0;JANUARI
92;SULAWESI BARAT;MAMASA;RANTEBULAHAN TIMUR;SAMPALE;55;15;15;0;25;0;0;0;0;55;0;JANUARI
93;SULAWESI BARAT;PASANGKAYU;PEDONGGA;MALEI;224;107;66;1;35;13;0;2;0;224;0;JANUARI
94;SULAWESI BARAT;PASANGKAYU;PEDONGGA;PEDANDA;192;53;51;3;73;5;0;6;0;191;1;JANUARI
95;SULAWESI BARAT;PASANGKAYU;PEDONGGA;BATU OGE;150;61;30;1;50;7;0;1;0;150;0;JANUARI
96;SULAWESI BARAT;PASANGKAYU;PEDONGGA;MARTASARI;567;225;62;6;239;23;0;10;0;565;2;JANUARI
97;SULAWESI BARAT;PASANGKAYU;PASANGKAYU;PASANGKAYU;1526;645;403;30;147;226;24;46;0;1521;5;JANUARI
98;SULAWESI BARAT;PASANGKAYU;PASANGKAYU;MARTAJAYA;187;66;36;2;42;27;0;14;0;187;0;JANUARI
99;SULAWESI BARAT;PASANGKAYU;PASANGKAYU;PAKAVA;395;219;107;4;59;4;0;2;0;395;0;JANUARI
100;SULAWESI BARAT;PASANGKAYU;PASANGKAYU;KARYA BERSAMA;324;168;44;4;79;19;0;10;0;324;0;JANUARI
101;SULAWESI BARAT;PASANGKAYU;PASANGKAYU;AKO;427;202;79;6;76;39;0;14;0;416;11;JANUARI
102;SULAWESI BARAT;PASANGKAYU;PASANGKAYU;GUNUNG SARI;576;332;82;4;106;20;0;24;0;568;8;JANUARI
103;SULAWESI BARAT;MAMASA;TABANG;TABANG;75;28;12;2;6;26;0;1;0;75;0;JANUARI
104;SULAWESI BARAT;MAMASA;TABANG;TADOKALUA;96;34;28;1;24;1;0;3;0;91;5;JANUARI
105;SULAWESI BARAT;MAMASA;TABANG;TABANG BARAT;157;69;44;1;40;2;0;0;1;157;0;JANUARI
106;SULAWESI BARAT;MAMASA;TABANG;MASUPU;79;8;65;1;4;0;0;0;1;79;0;JANUARI
107;SULAWESI BARAT;MAMASA;TABANG;KALAMA;71;10;25;0;21;3;0;1;0;60;11;JANUARI
108;SULAWESI BARAT;MAMASA;TABANG;BAKADISURA;88;19;55;0;12;1;0;1;0;88;0;JANUARI
109;SULAWESI BARAT;MAMASA;TABANG;SALUKONA;97;45;45;0;7;0;0;0;0;97;0;JANUARI
110;SULAWESI BARAT;MAMASA;SUMARORONG;SUMARORONG;148;51;42;5;31;6;0;11;0;146;2;JANUARI
111;SULAWESI BARAT;MAMASA;SUMARORONG;TABONE;92;21;36;0;34;0;0;1;0;92;0;JANUARI
112;SULAWESI BARAT;MAMASA;SUMARORONG;BATANG URU;93;38;39;0;13;2;0;1;0;93;0;JANUARI
113;SULAWESI BARAT;MAMASA;SUMARORONG;SASAKAN;157;53;83;1;12;7;0;0;0;156;1;JANUARI
114;SULAWESI BARAT;MAMASA;SUMARORONG;TADISI;51;13;33;0;5;0;0;0;0;51;0;JANUARI
115;SULAWESI BARAT;MAMASA;SUMARORONG;SIBANAWA;93;28;46;0;18;0;0;1;0;93;0;JANUARI
116;SULAWESI BARAT;MAMASA;SUMARORONG;BATANGNGURU TIMUR;101;26;68;1;6;0;0;0;0;101;0;JANUARI
117;SULAWESI BARAT;MAMASA;SUMARORONG;SALUBALO;120;60;39;0;19;0;0;2;0;120;0;JANUARI
118;SULAWESI BARAT;MAMASA;SUMARORONG;BANEA;65;27;26;0;9;1;0;2;0;65;0;JANUARI
119;SULAWESI BARAT;MAMASA;SUMARORONG;RANTE KAMASE;163;83;25;3;38;5;0;8;0;162;1;JANUARI
120;SULAWESI BARAT;MAMASA;SESENAPADANG;OROBUA;207;39;22;2;113;20;0;4;3;203;4;JANUARI
121;SULAWESI BARAT;MAMASA;SESENAPADANG;PALADAN;65;12;6;0;43;1;0;0;0;62;3;JANUARI
122;SULAWESI BARAT;MAMASA;SESENAPADANG;OROBUA TIMUR;43;18;7;0;15;1;0;2;0;43;0;JANUARI
123;SULAWESI BARAT;MAMASA;SESENAPADANG;RANTE PUANG;100;24;23;0;47;2;0;1;0;97;3;JANUARI
124;SULAWESI BARAT;MAMASA;SESENAPADANG;SATENETEAN;49;7;25;0;15;1;0;1;0;49;0;JANUARI
125;SULAWESI BARAT;MAMASA;SESENAPADANG;LISUAN ADA;70;34;13;0;23;0;0;0;0;70;0;JANUARI
126;SULAWESI BARAT;MAMASA;SESENAPADANG;OROBUA SELATAN;68;18;12;0;19;19;0;0;0;68;0;JANUARI
127;SULAWESI BARAT;MAMASA;SESENAPADANG;MALANGKENA PADANG;73;18;6;0;48;0;0;0;1;73;0;JANUARI
128;SULAWESI BARAT;MAMASA;SESENAPADANG;MALIMBONG;27;6;3;0;17;0;0;1;0;27;0;JANUARI
129;SULAWESI BARAT;MAMASA;SESENAPADANG;MARAMPAN OROBUA;40;17;3;0;10;9;0;0;0;39;1;JANUARI
130;SULAWESI BARAT;PASANGKAYU;SARJO;SARJO;275;93;40;17;65;12;0;45;1;273;2;JANUARI
131;SULAWESI BARAT;PASANGKAYU;SARJO;MAPONU;126;39;31;0;39;10;0;4;2;125;1;JANUARI
132;SULAWESI BARAT;PASANGKAYU;SARJO;LETAWA;206;79;16;12;69;11;1;18;0;206;0;JANUARI
133;SULAWESI BARAT;PASANGKAYU;SARJO;SARUDE;220;62;33;5;82;11;0;25;0;218;2;JANUARI
134;SULAWESI BARAT;PASANGKAYU;SARUDU;SARUDU;390;223;62;1;75;13;1;13;0;388;2;JANUARI
135;SULAWESI BARAT;PASANGKAYU;SARUDU;BULU MARIO;307;99;49;13;97;31;0;18;0;307;0;JANUARI
136;SULAWESI BARAT;PASANGKAYU;SARUDU;KUMASARI;261;128;43;5;67;10;0;6;1;260;1;JANUARI
137;SULAWESI BARAT;PASANGKAYU;SARUDU;PATIKA;69;23;18;1;12;3;0;5;0;62;7;JANUARI
138;SULAWESI BARAT;PASANGKAYU;SARUDU;DODA;293;139;67;4;75;5;0;3;0;293;0;JANUARI
139;SULAWESI BARAT;MAMASA;NOSU;NOSU;84;7;34;4;24;8;0;5;0;82;2;JANUARI
140;SULAWESI BARAT;MAMASA;NOSU;MINANGA;25;4;12;1;8;0;0;0;0;25;0;JANUARI
141;SULAWESI BARAT;MAMASA;NOSU;BATUPAPAN;54;19;18;1;15;1;0;0;0;54;0;JANUARI
142;SULAWESI BARAT;MAMASA;NOSU;MASEWWE;30;11;4;0;15;0;0;0;0;30;0;JANUARI
143;SULAWESI BARAT;MAMASA;NOSU;SIWI;24;13;3;1;5;1;0;1;0;24;0;JANUARI
144;SULAWESI BARAT;MAMASA;NOSU;MINANGA TIMUR;12;3;3;0;6;0;0;0;0;12;0;JANUARI
145;SULAWESI BARAT;MAMASA;NOSU;PARINDING;24;2;16;0;6;0;0;0;0;24;0;JANUARI
146;SULAWESI BARAT;MAMASA;PANA;PANA;59;13;38;2;5;1;0;0;0;59;0;JANUARI
147;SULAWESI BARAT;MAMASA;PANA;MANIPI;122;62;47;3;7;1;0;1;0;121;1;JANUARI
148;SULAWESI BARAT;MAMASA;PANA;MAMULLU;63;13;38;0;10;1;0;1;0;63;0;JANUARI
149;SULAWESI BARAT;MAMASA;PANA;SAPAN;55;18;12;0;25;0;0;0;0;55;0;JANUARI
150;SULAWESI BARAT;MAMASA;PANA;DATUBARINGAN;79;27;39;1;11;0;0;1;0;79;0;JANUARI
151;SULAWESI BARAT;MAMASA;PANA;PANURA;62;13;44;0;5;0;0;0;0;62;0;JANUARI
152;SULAWESI BARAT;MAMASA;PANA;TALLANG BULAWAN;72;21;39;4;7;0;0;1;0;72;0;JANUARI
153;SULAWESI BARAT;MAMASA;PANA;KARAKA;56;23;26;0;6;0;0;1;0;56;0;JANUARI
154;SULAWESI BARAT;MAMASA;PANA;ULUSALU;49;4;44;0;0;1;0;0;0;49;0;JANUARI
155;SULAWESI BARAT;MAMASA;PANA;WERI;51;7;36;2;4;1;0;1;0;51;0;JANUARI
156;SULAWESI BARAT;MAMASA;PANA;SALUTAMBUN;45;1;44;0;0;0;0;0;0;45;0;JANUARI
157;SULAWESI BARAT;MAMASA;PANA;SALOAN;98;29;57;0;11;0;0;0;0;97;1;JANUARI
158;SULAWESI BARAT;MAMASA;PANA;ULUSALU INDAH;52;34;18;0;0;0;0;0;0;52;0;JANUARI
159;SULAWESI BARAT;MAMASA;MEHALAAN;MEHALAAN;56;21;17;1;15;0;0;2;0;56;0;JANUARI
160;SULAWESI BARAT;MAMASA;MEHALAAN;BOTTENG;64;27;12;0;23;0;1;1;0;64;0;JANUARI
161;SULAWESI BARAT;MAMASA;MEHALAAN;SALUKONTA;55;22;15;3;14;0;0;1;0;55;0;JANUARI
162;SULAWESI BARAT;MAMASA;MEHALAAN;MESAKADA;62;17;24;1;19;0;0;1;0;62;0;JANUARI
163;SULAWESI BARAT;MAMASA;MEHALAAN;MEHALAAN BARAT;92;36;22;0;32;0;0;2;0;92;0;JANUARI
164;SULAWESI BARAT;MAMASA;MEHALAAN;SALUAHOK;72;18;27;0;23;0;0;4;0;72;0;JANUARI
165;SULAWESI BARAT;MAMASA;MEHALAAN;SALUBALO;46;22;16;0;8;0;0;0;0;46;0;JANUARI
166;SULAWESI BARAT;MAMASA;MEHALAAN;PASSEMBUK;40;20;10;0;10;0;0;0;0;40;0;JANUARI
167;SULAWESI BARAT;MAMASA;MEHALAAN;KONDO;37;17;9;0;10;0;0;1;0;37;0;JANUARI
168;SULAWESI BARAT;MAMASA;MEHALAAN;LEKO SUKAMAJU;31;12;10;0;8;0;0;1;0;31;0;JANUARI
169;SULAWESI BARAT;MAMASA;MEHALAAN;ULUMEA;27;13;3;0;11;0;0;0;0;27;0;JANUARI
170;SULAWESI BARAT;MAMASA;MAMASA;MAMASA;370;61;44;2;184;61;0;18;0;370;0;JANUARI
171;SULAWESI BARAT;MAMASA;MAMASA;RAMBUSARATU;259;92;81;14;54;12;0;6;0;259;0;JANUARI
172;SULAWESI BARAT;MAMASA;MAMASA;OSANGO;480;88;69;13;194;97;0;14;1;476;4;JANUARI
173;SULAWESI BARAT;MAMASA;MAMASA;LAMBANAN;225;69;54;9;78;6;0;9;0;225;0;JANUARI
174;SULAWESI BARAT;MAMASA;MAMASA;LEMBANA SALULO;89;17;14;2;46;4;0;6;0;89;0;JANUARI
175;SULAWESI BARAT;MAMASA;MAMASA;TAUPE;235;55;27;8;141;1;1;2;0;235;0;JANUARI
176;SULAWESI BARAT;MAMASA;MAMASA;BUNTU BUDA;300;78;28;6;106;29;0;6;2;255;45;JANUARI
177;SULAWESI BARAT;MAMASA;MAMASA;TONDOK BAKARU;270;91;84;16;61;10;0;7;0;269;1;JANUARI
178;SULAWESI BARAT;MAMASA;MAMASA;PEBASSIAN;93;20;26;0;42;3;0;2;0;93;0;JANUARI
179;SULAWESI BARAT;MAMASA;MAMASA;MAMBULILING;119;54;20;1;39;3;0;2;0;119;0;JANUARI
180;SULAWESI BARAT;MAMASA;MAMASA;BOMBONG LAMBE;148;42;21;2;69;13;0;1;0;148;0;JANUARI
181;SULAWESI BARAT;MAMASA;MAMASA;BUBUN BATU;129;25;6;6;79;2;0;2;0;120;9;JANUARI
182;SULAWESI BARAT;MAMUJU;KALUKKU;SINYONYOI;444;236;126;11;46;4;0;10;0;433;11;JANUARI
183;SULAWESI BARAT;MAMUJU;KALUKKU;BEBANGA;755;454;199;4;66;5;2;22;0;752;3;JANUARI
184;SULAWESI BARAT;MAMUJU;KALUKKU;KALUKKU;672;227;175;8;187;23;1;29;0;650;22;JANUARI
185;SULAWESI BARAT;MAMUJU;KALUKKU;SINYONYOI SELATAN;258;122;71;5;33;3;0;19;0;253;5;JANUARI
186;SULAWESI BARAT;MAMUJU;KALUKKU;SONDOANG;270;120;77;1;65;1;0;4;1;269;1;JANUARI
187;SULAWESI BARAT;MAMUJU;KALUKKU;BERU-BERU;552;308;94;2;133;3;0;11;1;552;0;JANUARI
188;SULAWESI BARAT;MAMUJU;KALUKKU;BELANG BELANG;377;178;108;2;75;2;0;12;0;377;0;JANUARI
189;SULAWESI BARAT;MAMUJU;KALUKKU;KABULOANG;369;148;132;3;75;1;1;6;1;367;2;JANUARI
190;SULAWESI BARAT;MAMUJU;KALUKKU;KEANG;232;68;130;1;26;1;0;4;0;230;2;JANUARI
191;SULAWESI BARAT;MAMUJU;KALUKKU;POKKANG;189;78;33;2;64;3;1;8;0;189;0;JANUARI
192;SULAWESI BARAT;MAMUJU;KALUKKU;GULILING;165;49;81;0;33;0;0;1;0;164;1;JANUARI
193;SULAWESI BARAT;MAMUJU;KALUKKU;UHAIMATE;125;83;35;0;7;0;0;0;0;125;0;JANUARI
194;SULAWESI BARAT;MAMUJU;KALUKKU;KALUKKU BARAT;480;287;64;1;122;2;0;4;0;480;0;JANUARI
195;SULAWESI BARAT;MAMUJU;KALUKKU;PAMMULUKANG;227;115;73;9;17;0;0;11;1;226;1;JANUARI
196;SULAWESI BARAT;MAMASA;BALLA;BALLA;164;19;27;1;92;11;0;12;1;163;1;JANUARI
197;SULAWESI BARAT;MAMASA;BALLA;BALLA BARAT;89;45;10;0;33;0;0;1;0;89;0;JANUARI
198;SULAWESI BARAT;MAMASA;BALLA;BALLA SATANETEAN;149;58;13;4;62;9;0;3;0;149;0;JANUARI
199;SULAWESI BARAT;MAMASA;BALLA;BALLA TUMUKA;111;38;27;1;43;1;0;1;0;111;0;JANUARI
200;SULAWESI BARAT;MAMASA;BALLA;SEPAKUAN;157;56;14;0;84;1;0;2;0;157;0;JANUARI
201;SULAWESI BARAT;MAMASA;BALLA;PIDARA;61;21;10;0;29;1;0;0;0;61;0;JANUARI
202;SULAWESI BARAT;MAMASA;BALLA;BAMBAPUANG;63;27;16;0;20;0;0;0;0;63;0;JANUARI
203;SULAWESI BARAT;MAMASA;BALLA;BALLA TIMUR;37;7;2;0;24;1;0;3;0;37;0;JANUARI
204;SULAWESI BARAT;MAMASA;BAMBANG;MOKALLANG;43;18;21;0;3;0;0;1;0;43;0;JANUARI
205;SULAWESI BARAT;MAMASA;BAMBANG;MASOSO;45;18;14;0;13;0;0;0;0;45;0;JANUARI
206;SULAWESI BARAT;MAMASA;BAMBANG;SALUASSING;124;91;20;4;8;0;0;1;0;124;0;JANUARI
207;SULAWESI BARAT;MAMASA;BAMBANG;SALUBULO;63;26;19;0;13;1;0;0;0;59;4;JANUARI
208;SULAWESI BARAT;MAMASA;BAMBANG;SALUKADI;78;33;37;0;8;0;0;0;0;78;0;JANUARI
209;SULAWESI BARAT;MAMASA;BAMBANG;SALUKEPOPOK;114;54;21;9;28;1;0;0;0;113;1;JANUARI
210;SULAWESI BARAT;MAMASA;BAMBANG;ULUMAMBI BARAT;61;28;33;0;0;0;0;0;0;61;0;JANUARI
211;SULAWESI BARAT;MAMASA;BAMBANG;LIMBADEBATA;106;35;12;0;55;1;0;3;0;106;0;JANUARI
212;SULAWESI BARAT;MAMASA;BAMBANG;TANETE TOMBA;56;26;27;0;3;0;0;0;0;56;0;JANUARI
213;SULAWESI BARAT;MAMASA;BAMBANG;BAMBANG;134;86;18;0;23;3;0;3;0;133;1;JANUARI
214;SULAWESI BARAT;MAMASA;BAMBANG;RANTELEMO;51;14;20;0;15;2;0;0;0;51;0;JANUARI
215;SULAWESI BARAT;MAMASA;BAMBANG;SALUDENGEN;36;10;20;0;2;1;0;0;0;33;3;JANUARI
216;SULAWESI BARAT;MAMASA;BAMBANG;ULUMAMBI;62;10;44;1;0;0;0;0;0;55;7;JANUARI
217;SULAWESI BARAT;MAMASA;BAMBANG;BAMBANG TIMUR;63;38;21;0;2;1;0;1;0;63;0;JANUARI
218;SULAWESI BARAT;MAMASA;BAMBANG;MINANGA;135;52;40;0;37;1;0;4;0;134;1;JANUARI
219;SULAWESI BARAT;MAMASA;BAMBANG;SIKAMASE;57;20;36;0;1;0;0;0;0;57;0;JANUARI
220;SULAWESI BARAT;MAMASA;BAMBANG;RANTETARIMA;30;3;27;0;0;0;0;0;0;30;0;JANUARI
221;SULAWESI BARAT;MAMASA;BAMBANG;SALURURU;31;4;1;3;22;0;0;1;0;31;0;JANUARI
222;SULAWESI BARAT;MAMASA;BAMBANG;SALUTABANG;34;18;10;1;2;2;0;1;0;34;0;JANUARI
223;SULAWESI BARAT;MAMASA;BAMBANG;BALATANA;53;37;16;0;0;0;0;0;0;53;0;JANUARI
224;SULAWESI BARAT;MAMUJU;TAPALANG;GALUNG;256;59;103;5;40;24;0;19;2;252;4;JANUARI
225;SULAWESI BARAT;MAMUJU;TAPALANG;KASAMBANG;219;77;66;1;58;4;0;10;2;218;1;JANUARI
226;SULAWESI BARAT;MAMUJU;TAPALANG;DAYANGINNA;122;35;35;11;25;6;0;7;0;119;3;JANUARI
227;SULAWESI BARAT;MAMUJU;TAPALANG;OROBATU;94;33;29;13;7;6;0;6;0;94;0;JANUARI
228;SULAWESI BARAT;MAMUJU;TAPALANG;TAKANDEANG;195;66;39;2;65;16;1;5;1;195;0;JANUARI
229;SULAWESI BARAT;MAMUJU;TAPALANG;BELA;49;33;8;0;8;0;0;0;0;49;0;JANUARI
230;SULAWESI BARAT;MAMUJU;TAPALANG;TAAN;251;94;85;2;56;4;0;9;0;250;1;JANUARI
231;SULAWESI BARAT;MAMUJU;TAPALANG;TAMPALANG;170;74;25;1;54;4;0;11;1;170;0;JANUARI
232;SULAWESI BARAT;MAMUJU;TAPALANG;RANTEDODA;64;33;10;6;9;0;0;6;0;64;0;JANUARI
233;SULAWESI BARAT;MAMUJU;TAPALANG;KOPEANG;69;41;19;0;9;0;0;0;0;69;0;JANUARI
234;SULAWESI BARAT;MAMASA;MAMBI;MAMBI;81;46;22;2;10;1;0;0;0;81;0;JANUARI
235;SULAWESI BARAT;MAMASA;MAMBI;TALIPUKKI;120;89;13;4;9;2;0;2;0;119;1;JANUARI
236;SULAWESI BARAT;MAMASA;MAMBI;RANTEBULAHAN;59;17;31;0;8;1;0;1;0;58;1;JANUARI
237;SULAWESI BARAT;MAMASA;MAMBI;SONDONGLAYU;36;17;5;2;7;0;0;5;0;36;0;JANUARI
238;SULAWESI BARAT;MAMASA;MAMBI;SALUBANUA;36;14;20;0;1;0;0;0;0;35;1;JANUARI
239;SULAWESI BARAT;MAMASA;MAMBI;TAPALINA;116;78;31;6;0;0;0;0;0;115;1;JANUARI
240;SULAWESI BARAT;MAMASA;MAMBI;SENDANA;154;63;75;2;14;0;0;0;0;154;0;JANUARI
241;SULAWESI BARAT;MAMASA;MAMBI;PAMOSEAN;51;42;6;3;0;0;0;0;0;51;0;JANUARI
242;SULAWESI BARAT;MAMASA;MAMBI;SELUMAKA;125;30;95;0;0;0;0;0;0;125;0;JANUARI
243;SULAWESI BARAT;MAMASA;MAMBI;BUJUNG MANURUNG;45;24;18;0;3;0;0;0;0;45;0;JANUARI
244;SULAWESI BARAT;MAMASA;MAMBI;SALU ALO;79;25;48;0;6;0;0;0;0;79;0;JANUARI
245;SULAWESI BARAT;MAMASA;MAMBI;INDOBANUA;29;12;10;0;1;6;0;0;0;29;0;JANUARI
246;SULAWESI BARAT;MAMASA;MAMBI;SALUDURIAN;86;26;49;0;9;1;0;1;0;86;0;JANUARI
247;SULAWESI BARAT;MAMUJU;MAMUJU;BINANGA;770;445;158;15;67;53;1;17;4;760;10;JANUARI
248;SULAWESI BARAT;MAMUJU;MAMUJU;MAMUNYU;625;322;170;40;46;28;1;14;0;621;4;JANUARI
249;SULAWESI BARAT;MAMUJU;MAMUJU;KAREMA;851;442;122;39;94;61;2;30;0;790;61;JANUARI
250;SULAWESI BARAT;MAMUJU;MAMUJU;RIMUKU;703;308;160;35;50;72;2;29;1;657;46;JANUARI
251;SULAWESI BARAT;MAMUJU;MAMUJU;BAMBU;389;232;72;14;51;5;0;15;0;389;0;JANUARI
252;SULAWESI BARAT;MAMUJU;MAMUJU;KARAMPUANG;459;349;52;1;29;11;0;14;0;456;3;JANUARI
253;SULAWESI BARAT;MAMUJU;MAMUJU;TADUI;492;166;214;1;56;6;0;28;3;474;18;JANUARI
254;SULAWESI BARAT;MAMUJU;MAMUJU;BATU PANNU;184;131;33;0;14;3;0;3;0;184;0;JANUARI
255;SULAWESI BARAT;MAMASA;BUNTUMALANGKA;BUNTUMALANGKA;130;28;67;1;25;4;0;4;0;129;1;JANUARI
256;SULAWESI BARAT;MAMASA;BUNTUMALANGKA;RANTEBERAN;117;66;43;0;7;0;0;1;0;117;0;JANUARI
257;SULAWESI BARAT;MAMASA;BUNTUMALANGKA;KEBANGA;55;9;33;0;13;0;0;0;0;55;0;JANUARI
258;SULAWESI BARAT;MAMASA;BUNTUMALANGKA;SALURINDU;55;23;22;1;7;0;0;2;0;55;0;JANUARI
259;SULAWESI BARAT;MAMASA;BUNTUMALANGKA;TAORA;55;17;35;1;1;0;0;1;0;55;0;JANUARI
260;SULAWESI BARAT;MAMASA;BUNTUMALANGKA;KABAE;77;11;61;0;4;0;0;1;0;77;0;JANUARI
261;SULAWESI BARAT;MAMASA;BUNTUMALANGKA;SALUTAMBUN BARAT;51;29;21;0;1;0;0;0;0;51;0;JANUARI
262;SULAWESI BARAT;MAMASA;BUNTUMALANGKA;PENATANGAN;121;41;48;0;22;3;1;1;1;117;4;JANUARI
263;SULAWESI BARAT;MAMASA;BUNTUMALANGKA;SALUTAMBUN TIMUR;48;15;31;0;1;0;0;1;0;48;0;JANUARI
264;SULAWESI BARAT;MAMASA;BUNTUMALANGKA;SALUTAMBUN;39;9;23;0;3;2;0;2;0;39;0;JANUARI
265;SULAWESI BARAT;MAMASA;BUNTUMALANGKA;ARALLE TIMUR;95;27;57;0;3;0;0;1;0;88;7;JANUARI
266;SULAWESI BARAT;PASANGKAYU;TIKKE RAYA;TIKKE;323;94;63;5;101;39;0;12;0;314;9;JANUARI
267;SULAWESI BARAT;PASANGKAYU;TIKKE RAYA;MAKMUR JAYA;486;188;124;4;123;25;0;18;1;483;3;JANUARI
268;SULAWESI BARAT;PASANGKAYU;TIKKE RAYA;LARIANG;474;182;88;8;161;20;0;12;0;471;3;JANUARI
269;SULAWESI BARAT;PASANGKAYU;TIKKE RAYA;PAJALELE;417;168;97;1;104;27;1;16;1;415;2;JANUARI
270;SULAWESI BARAT;PASANGKAYU;TIKKE RAYA;JENGENG RAYA;267;102;55;10;71;22;0;7;0;267;0;JANUARI
271;SULAWESI BARAT;MAMASA;MESSAWA;MESSAWA;35;8;19;0;6;0;0;2;0;35;0;JANUARI
272;SULAWESI BARAT;MAMASA;MESSAWA;RIPPUNG;136;70;51;0;15;0;0;0;0;136;0;JANUARI
273;SULAWESI BARAT;MAMASA;MESSAWA;MAKUANG;106;57;33;0;16;0;0;0;0;106;0;JANUARI
274;SULAWESI BARAT;MAMASA;MESSAWA;SEPANG;73;46;25;0;2;0;0;0;0;73;0;JANUARI
275;SULAWESI BARAT;MAMASA;MESSAWA;MALIMBONG;56;13;40;0;3;0;0;0;0;56;0;JANUARI
276;SULAWESI BARAT;MAMASA;MESSAWA;MATANDE;85;18;55;6;5;1;0;0;0;85;0;JANUARI
277;SULAWESI BARAT;MAMASA;MESSAWA;SIPAI;78;34;34;0;10;0;0;0;0;78;0;JANUARI
278;SULAWESI BARAT;MAMASA;MESSAWA;PASMA MAMBU;48;16;22;0;10;0;0;0;0;48;0;JANUARI
279;SULAWESI BARAT;MAMASA;MESSAWA;TANETE BATU;54;27;23;0;3;0;0;1;0;54;0;JANUARI
280;SULAWESI BARAT;MAMASA;ARALLE;ARALLE;111;40;60;2;6;1;0;2;0;111;0;JANUARI
281;SULAWESI BARAT;MAMASA;ARALLE;RALLE ANAK;37;8;21;0;6;0;0;2;0;37;0;JANUARI
282;SULAWESI BARAT;MAMASA;ARALLE;PANETEAN;73;57;16;0;0;0;0;0;0;73;0;JANUARI
283;SULAWESI BARAT;MAMASA;ARALLE;UHAILANU;73;25;28;0;11;3;0;5;0;72;1;JANUARI
284;SULAWESI BARAT;MAMASA;ARALLE;ARALLE UTARA;69;29;39;0;1;0;0;0;0;69;0;JANUARI
285;SULAWESI BARAT;MAMASA;ARALLE;UHAIDAHO;52;12;33;3;4;0;0;0;0;52;0;JANUARI
286;SULAWESI BARAT;MAMASA;ARALLE;BARURU;91;64;25;0;1;0;0;0;1;91;0;JANUARI
287;SULAWESI BARAT;MAMASA;ARALLE;RALLEANAK UTARA;41;20;16;0;4;0;0;1;0;41;0;JANUARI
288;SULAWESI BARAT;MAMASA;ARALLE;PAMOSEANG PANGGA;36;11;21;3;1;0;0;0;0;36;0;JANUARI
289;SULAWESI BARAT;MAMASA;ARALLE;KALABE;64;23;39;0;2;0;0;0;0;64;0;JANUARI
290;SULAWESI BARAT;MAMASA;ARALLE;ARALLE SELATAN;29;10;17;0;1;0;0;1;0;29;0;JANUARI
291;SULAWESI BARAT;MAMASA;ARALLE;HAHANGAN;35;16;13;0;6;0;0;0;0;35;0;JANUARI
292;SULAWESI BARAT;MAMUJU;BONEHAU;BONEHAU;164;51;77;4;23;1;0;2;0;158;6;JANUARI
293;SULAWESI BARAT;MAMUJU;BONEHAU;SALUTIWO;86;30;34;1;21;0;0;0;0;86;0;JANUARI
294;SULAWESI BARAT;MAMUJU;BONEHAU;BUTTUADA;213;12;173;3;20;1;0;2;0;211;2;JANUARI
295;SULAWESI BARAT;MAMUJU;BONEHAU;TAMALEA;45;6;29;0;9;0;0;1;0;45;0;JANUARI
296;SULAWESI BARAT;MAMUJU;BONEHAU;LUMIKA;134;48;55;2;28;1;0;0;0;134;0;JANUARI
297;SULAWESI BARAT;MAMUJU;BONEHAU;MAPPU;72;15;42;1;13;0;0;1;0;72;0;JANUARI
298;SULAWESI BARAT;MAMUJU;BONEHAU;BANUADA;101;11;83;4;2;0;0;1;0;101;0;JANUARI
299;SULAWESI BARAT;MAMUJU;BONEHAU;HINUA;103;26;31;7;33;1;0;3;0;101;2;JANUARI
300;SULAWESI BARAT;MAMUJU;BONEHAU;KINATANG;114;22;89;1;0;0;0;2;0;114;0;JANUARI
301;SULAWESI BARAT;MAMUJU;KALUMPANG;KALUMPANG;52;26;14;0;6;0;0;2;0;48;4;JANUARI
302;SULAWESI BARAT;MAMUJU;KALUMPANG;KARATAUN;176;111;27;0;35;0;0;1;0;174;2;JANUARI
303;SULAWESI BARAT;MAMUJU;KALUMPANG;KARAMA;122;52;48;0;21;0;0;1;0;122;0;JANUARI
304;SULAWESI BARAT;MAMUJU;KALUMPANG;SIRAUN;104;61;23;0;18;0;0;0;1;103;1;JANUARI
305;SULAWESI BARAT;MAMUJU;KALUMPANG;TUMOGA;76;35;13;0;20;0;0;0;0;68;8;JANUARI
306;SULAWESI BARAT;MAMUJU;KALUMPANG;SALUMAKKI;99;68;19;0;10;0;0;0;0;97;2;JANUARI
307;SULAWESI BARAT;MAMUJU;KALUMPANG;POLIO;62;30;24;0;7;0;0;0;1;62;0;JANUARI
308;SULAWESI BARAT;MAMUJU;KALUMPANG;LIMBONG;92;26;15;0;49;1;0;1;0;92;0;JANUARI
309;SULAWESI BARAT;MAMUJU;KALUMPANG;SANDAPANG;93;27;4;0;61;0;0;0;0;92;1;JANUARI
310;SULAWESI BARAT;MAMUJU;KALUMPANG;KONDO BULO;88;54;25;0;7;0;0;1;0;87;1;JANUARI
311;SULAWESI BARAT;MAMUJU;KALUMPANG;MAKKALIKI;69;34;18;0;17;0;0;0;0;69;0;JANUARI
312;SULAWESI BARAT;MAMUJU;KALUMPANG;BATU MAKKADA;83;37;38;0;7;0;0;0;0;82;1;JANUARI
313;SULAWESI BARAT;MAMUJU;KALUMPANG;LASA';117;74;26;0;13;0;0;0;1;114;3;JANUARI
314;SULAWESI BARAT;POLEWALI MANDAR;TUTAR;TARAMANU;196;87;34;5;46;1;13;10;0;196;0;JANUARI
315;SULAWESI BARAT;POLEWALI MANDAR;TUTAR;AMBOPADANG;268;106;51;1;107;2;0;1;0;268;0;JANUARI
316;SULAWESI BARAT;POLEWALI MANDAR;TUTAR;TUBBI;132;39;71;4;8;2;0;8;0;132;0;JANUARI
317;SULAWESI BARAT;POLEWALI MANDAR;TUTAR;RATTE;178;52;73;3;47;1;1;0;1;178;0;JANUARI
318;SULAWESI BARAT;POLEWALI MANDAR;TUTAR;BESOANGIN;123;70;8;2;43;0;0;0;0;123;0;JANUARI
319;SULAWESI BARAT;POLEWALI MANDAR;TUTAR;PIRIANG TAPIKO;108;35;47;0;25;0;0;1;0;108;0;JANUARI
320;SULAWESI BARAT;POLEWALI MANDAR;TUTAR;PEBURRU;182;92;52;3;28;2;0;5;0;182;0;JANUARI
321;SULAWESI BARAT;POLEWALI MANDAR;TUTAR;TALOBA;96;40;36;0;16;0;0;3;0;95;1;JANUARI
322;SULAWESI BARAT;POLEWALI MANDAR;TUTAR;POLLEWANI;271;141;92;5;30;0;0;3;0;271;0;JANUARI
323;SULAWESI BARAT;POLEWALI MANDAR;TUTAR;ARABUA;141;76;33;0;14;0;16;2;0;141;0;JANUARI
324;SULAWESI BARAT;POLEWALI MANDAR;TUTAR;BESOANGIN UTARA;104;53;14;4;33;0;0;0;0;104;0;JANUARI
325;SULAWESI BARAT;POLEWALI MANDAR;TUTAR;PODA;123;54;48;4;13;0;1;3;0;123;0;JANUARI
326;SULAWESI BARAT;POLEWALI MANDAR;TUTAR;TARAMANU TUA;165;35;49;2;71;1;0;4;0;162;3;JANUARI
327;SULAWESI BARAT;POLEWALI MANDAR;WONOMULYO;SIDODADI;391;198;87;3;57;29;0;14;1;389;2;JANUARI
328;SULAWESI BARAT;POLEWALI MANDAR;WONOMULYO;SIDOREJO;344;180;76;12;41;13;0;19;0;341;3;JANUARI
329;SULAWESI BARAT;POLEWALI MANDAR;WONOMULYO;SUMBEREJO;564;275;97;30;105;41;0;8;1;557;7;JANUARI
330;SULAWESI BARAT;POLEWALI MANDAR;WONOMULYO;BUMIAYU;405;177;70;9;50;52;1;19;0;378;27;JANUARI
331;SULAWESI BARAT;POLEWALI MANDAR;WONOMULYO;KEBUNSARI;300;115;56;11;44;46;1;11;0;284;16;JANUARI
332;SULAWESI BARAT;POLEWALI MANDAR;WONOMULYO;BANUA BARU;197;111;30;7;21;14;0;7;0;190;7;JANUARI
333;SULAWESI BARAT;POLEWALI MANDAR;WONOMULYO;NEPO;268;155;51;5;40;9;1;5;0;266;2;JANUARI
334;SULAWESI BARAT;POLEWALI MANDAR;WONOMULYO;SUGIHWARAS;574;273;144;23;79;32;0;11;0;562;12;JANUARI
335;SULAWESI BARAT;POLEWALI MANDAR;WONOMULYO;CAMPURJO;234;112;42;6;37;19;0;17;0;233;1;JANUARI
336;SULAWESI BARAT;POLEWALI MANDAR;WONOMULYO;BUMIMULYO;223;112;53;1;39;13;0;3;0;221;2;JANUARI
337;SULAWESI BARAT;POLEWALI MANDAR;WONOMULYO;TUMPILING;246;128;54;6;36;2;0;9;0;235;11;JANUARI
338;SULAWESI BARAT;POLEWALI MANDAR;WONOMULYO;BAKKA-BAKKA;196;110;40;5;30;3;0;5;0;193;3;JANUARI
339;SULAWESI BARAT;POLEWALI MANDAR;WONOMULYO;ARJO SARI;278;148;85;8;11;14;0;6;0;272;6;JANUARI
340;SULAWESI BARAT;POLEWALI MANDAR;WONOMULYO;GALESON;305;199;43;6;37;8;0;7;0;300;5;JANUARI
341;SULAWESI BARAT;POLEWALI MANDAR;TAPANGO;PELITAKAN;167;94;27;1;13;2;0;13;0;150;17;JANUARI
342;SULAWESI BARAT;POLEWALI MANDAR;TAPANGO;TAPANGO;218;122;42;3;40;5;0;6;0;218;0;JANUARI
343;SULAWESI BARAT;POLEWALI MANDAR;TAPANGO;RAPPANG;234;127;55;1;42;2;0;6;0;233;1;JANUARI
344;SULAWESI BARAT;POLEWALI MANDAR;TAPANGO;DAKKA;192;88;57;1;36;2;0;5;0;189;3;JANUARI
345;SULAWESI BARAT;POLEWALI MANDAR;TAPANGO;BATU;139;74;28;8;21;1;0;6;0;138;1;JANUARI
346;SULAWESI BARAT;POLEWALI MANDAR;TAPANGO;RISO;181;100;13;1;56;4;0;5;0;179;2;JANUARI
347;SULAWESI BARAT;POLEWALI MANDAR;TAPANGO;PALATTA;167;64;52;1;37;1;0;1;1;157;10;JANUARI
348;SULAWESI BARAT;POLEWALI MANDAR;TAPANGO;TAPANGO BARAT;153;83;38;2;18;3;0;9;0;153;0;JANUARI
349;SULAWESI BARAT;POLEWALI MANDAR;TAPANGO;KURRAK;81;44;33;0;2;1;0;1;0;81;0;JANUARI
350;SULAWESI BARAT;POLEWALI MANDAR;TAPANGO;BUSSU;155;97;36;4;13;2;0;3;0;155;0;JANUARI
351;SULAWESI BARAT;POLEWALI MANDAR;TAPANGO;TUTTULA;114;76;15;2;15;1;0;1;0;110;4;JANUARI
352;SULAWESI BARAT;POLEWALI MANDAR;TAPANGO;JAMBU MALEA;205;83;76;6;30;0;0;10;0;205;0;JANUARI
353;SULAWESI BARAT;POLEWALI MANDAR;TAPANGO;KALIMBUA;203;132;39;1;24;2;0;5;0;203;0;JANUARI
354;SULAWESI BARAT;POLEWALI MANDAR;TAPANGO;BANATO REJO;342;210;84;0;33;6;0;4;0;337;5;JANUARI
355;SULAWESI BARAT;MAMUJU;KEP. BALA BALAKANG;BALA BALAKANG;120;62;46;2;9;0;0;0;0;119;1;JANUARI
356;SULAWESI BARAT;MAMUJU;KEP. BALA BALAKANG;BALA-BALAKANG TIMUR;98;24;71;2;0;0;1;0;0;98;0;JANUARI
357;SULAWESI BARAT;POLEWALI MANDAR;TINAMBUNG;TINAMBUNG;140;40;35;6;26;6;0;27;0;140;0;JANUARI
358;SULAWESI BARAT;POLEWALI MANDAR;TINAMBUNG;KARAMA;467;334;50;23;43;2;0;15;0;467;0;JANUARI
359;SULAWESI BARAT;POLEWALI MANDAR;TINAMBUNG;TANGNGA TANGNGA;207;143;39;2;14;1;0;8;0;207;0;JANUARI
360;SULAWESI BARAT;POLEWALI MANDAR;TINAMBUNG;LEKOPADIS;94;36;19;5;27;1;0;5;0;93;1;JANUARI
361;SULAWESI BARAT;POLEWALI MANDAR;TINAMBUNG;GALUNG LOMBOK;143;58;23;7;38;2;0;15;0;143;0;JANUARI
362;SULAWESI BARAT;POLEWALI MANDAR;TINAMBUNG;TANDUNG;130;59;26;9;18;4;0;13;0;129;1;JANUARI
363;SULAWESI BARAT;POLEWALI MANDAR;TINAMBUNG;BATULAYA;113;43;23;16;18;5;0;8;0;113;0;JANUARI
364;SULAWESI BARAT;POLEWALI MANDAR;TINAMBUNG;SEPABATU;100;34;25;10;16;2;0;13;0;100;0;JANUARI
365;SULAWESI BARAT;MAMUJU;SAMPAGA;BUNDE;521;249;138;3;125;1;0;5;0;521;0;JANUARI
366;SULAWESI BARAT;MAMUJU;SAMPAGA;KALONDING;455;186;186;5;70;4;0;3;0;454;1;JANUARI
367;SULAWESI BARAT;MAMUJU;SAMPAGA;TARAILU;263;118;81;1;52;5;0;6;0;263;0;JANUARI
368;SULAWESI BARAT;MAMUJU;SAMPAGA;SAMPAGA;190;93;63;5;24;2;0;2;1;190;0;JANUARI
369;SULAWESI BARAT;MAMUJU;SAMPAGA;TANAMBUAH;73;23;27;1;20;0;0;2;0;73;0;JANUARI
370;SULAWESI BARAT;MAMUJU;SAMPAGA;SALUBARANA;79;39;21;1;15;0;0;3;0;79;0;JANUARI
371;SULAWESI BARAT;MAMUJU;SAMPAGA;LOSSO;128;55;21;1;50;0;0;0;0;127;1;JANUARI
372;SULAWESI BARAT;POLEWALI MANDAR;MATANGNGA;MATANGNGA;82;43;9;3;23;1;0;3;0;82;0;JANUARI
373;SULAWESI BARAT;POLEWALI MANDAR;MATANGNGA;LILLI;108;42;14;1;50;0;0;1;0;108;0;JANUARI
374;SULAWESI BARAT;POLEWALI MANDAR;MATANGNGA;RANGOAN;78;28;27;0;22;0;0;0;0;77;1;JANUARI
375;SULAWESI BARAT;POLEWALI MANDAR;MATANGNGA;TAPUA;166;70;30;9;56;0;0;1;0;166;0;JANUARI
376;SULAWESI BARAT;POLEWALI MANDAR;MATANGNGA;MAMBU TAPUA;96;33;12;1;47;0;0;3;0;96;0;JANUARI
377;SULAWESI BARAT;POLEWALI MANDAR;MATANGNGA;BA'BA TAPUA;74;27;9;3;35;0;0;0;0;74;0;JANUARI
378;SULAWESI BARAT;POLEWALI MANDAR;MATANGNGA;KATIMBANG;88;37;25;1;23;1;0;0;0;87;1;JANUARI
379;SULAWESI BARAT;POLEWALI MANDAR;POLEWALI;POLEWALI;532;157;162;45;81;32;0;44;0;521;11;JANUARI
380;SULAWESI BARAT;POLEWALI MANDAR;POLEWALI;WATTANG;217;65;71;15;31;18;0;17;0;217;0;JANUARI
381;SULAWESI BARAT;POLEWALI MANDAR;POLEWALI;SULEWATANG;403;102;207;3;72;7;0;12;0;403;0;JANUARI
382;SULAWESI BARAT;POLEWALI MANDAR;POLEWALI;LANTORA;432;115;181;22;52;35;0;27;0;432;0;JANUARI
383;SULAWESI BARAT;POLEWALI MANDAR;POLEWALI;TAKATIDUNG;546;263;122;28;73;20;0;22;0;528;18;JANUARI
384;SULAWESI BARAT;POLEWALI MANDAR;POLEWALI;PEKKABATA;349;156;65;36;48;28;0;15;0;348;1;JANUARI
385;SULAWESI BARAT;POLEWALI MANDAR;POLEWALI;MADATE;589;214;169;69;85;20;0;32;0;589;0;JANUARI
386;SULAWESI BARAT;POLEWALI MANDAR;POLEWALI;MANDING;474;158;148;17;95;21;0;34;0;473;1;JANUARI
387;SULAWESI BARAT;POLEWALI MANDAR;POLEWALI;DARMA;541;205;159;17;111;16;0;33;0;541;0;JANUARI
388;SULAWESI BARAT;MAJENE;SENDANA;MOSSO;327;156;79;4;58;17;1;10;1;326;1;JANUARI
389;SULAWESI BARAT;MAJENE;SENDANA;MOSSO DHUA;101;36;22;8;10;11;2;5;0;94;7;JANUARI
390;SULAWESI BARAT;MAJENE;SENDANA;TOTOLISI SENDANA;122;42;39;5;18;8;1;7;0;120;2;JANUARI
391;SULAWESI BARAT;MAJENE;SENDANA;TALLUBANUA;132;47;30;9;10;18;1;7;0;122;10;JANUARI
392;SULAWESI BARAT;MAJENE;SENDANA;LALATEDZONG;100;32;18;7;19;17;0;5;1;99;1;JANUARI
393;SULAWESI BARAT;MAJENE;SENDANA;BINANGA;72;33;13;7;10;6;1;2;0;72;0;JANUARI
394;SULAWESI BARAT;MAJENE;SENDANA;PUTTADA;77;43;22;0;9;1;1;1;0;77;0;JANUARI
395;SULAWESI BARAT;MAJENE;SENDANA;PAMINGGALAN;48;36;12;0;0;0;0;0;0;48;0;JANUARI
396;SULAWESI BARAT;MAJENE;SENDANA;LEPPANGANG;64;33;19;0;7;1;0;4;0;64;0;JANUARI
397;SULAWESI BARAT;MAJENE;SENDANA;PUNDAU;66;6;26;6;21;5;0;2;0;66;0;JANUARI
398;SULAWESI BARAT;MAJENE;SENDANA;SENDANA;80;39;25;1;0;7;1;7;0;80;0;JANUARI
399;SULAWESI BARAT;MAJENE;SENDANA;BANUA SENDANA;100;65;6;3;1;20;0;5;0;100;0;JANUARI
400;SULAWESI BARAT;MAJENE;SENDANA;TALLUBANUA UTARA;166;76;51;3;5;27;0;4;0;166;0;JANUARI
401;SULAWESI BARAT;MAJENE;SENDANA;LIMBORO RAMBU-RAMBU;99;23;34;3;33;4;0;0;0;97;2;JANUARI
402;SULAWESI BARAT;MAJENE;SENDANA;LIMBUA;95;36;21;2;20;13;0;3;0;95;0;JANUARI
403;SULAWESI BARAT;MAJENE;SENDANA;BUKIT SAMANG;124;39;25;9;22;19;4;6;0;124;0;JANUARI
404;SULAWESI BARAT;MAJENE;PAMBOANG;LALAMPANUA;156;29;29;30;46;10;0;10;1;155;1;JANUARI
405;SULAWESI BARAT;MAJENE;PAMBOANG;SIRINDU;143;29;21;2;67;10;0;14;0;143;0;JANUARI
406;SULAWESI BARAT;MAJENE;PAMBOANG;ADOLANG;100;22;5;1;63;4;0;5;0;100;0;JANUARI
407;SULAWESI BARAT;MAJENE;PAMBOANG;BABABULO;188;98;24;9;47;5;1;4;0;188;0;JANUARI
408;SULAWESI BARAT;MAJENE;PAMBOANG;BONDE;254;152;61;3;12;10;0;14;0;252;2;JANUARI
409;SULAWESI BARAT;MAJENE;PAMBOANG;BETTENG;106;60;16;2;26;1;0;1;0;106;0;JANUARI
410;SULAWESI BARAT;MAJENE;PAMBOANG;SIMBANG;59;14;14;5;21;3;0;2;0;59;0;JANUARI
411;SULAWESI BARAT;MAJENE;PAMBOANG;BONDE UTARA;361;233;42;4;39;11;2;15;0;346;15;JANUARI
412;SULAWESI BARAT;MAJENE;PAMBOANG;BABABULO UTARA;115;51;28;12;14;3;0;7;0;115;0;JANUARI
413;SULAWESI BARAT;MAJENE;PAMBOANG;BUTTU PAMBOANG;107;49;21;3;23;6;0;5;0;107;0;JANUARI
414;SULAWESI BARAT;MAJENE;PAMBOANG;BANUA ADOLANG;112;35;38;0;30;6;0;3;0;112;0;JANUARI
415;SULAWESI BARAT;MAJENE;PAMBOANG;ADOLANG DHUA;96;39;6;2;41;0;1;5;0;94;2;JANUARI
416;SULAWESI BARAT;MAJENE;PAMBOANG;TINAMBUNG;174;39;41;17;48;6;0;23;0;174;0;JANUARI
417;SULAWESI BARAT;MAJENE;PAMBOANG;PESULOANG;113;39;15;14;32;1;3;9;0;113;0;JANUARI
418;SULAWESI BARAT;MAJENE;PAMBOANG;BALOMBONG;117;36;16;3;52;7;0;3;0;117;0;JANUARI
419;SULAWESI BARAT;MAJENE;BANGGAE TIMUR;BAURUNG;504;219;73;34;156;11;1;8;1;503;1;JANUARI
420;SULAWESI BARAT;MAJENE;BANGGAE TIMUR;BARUGA;192;51;26;40;39;14;0;8;0;178;14;JANUARI
421;SULAWESI BARAT;MAJENE;BANGGAE TIMUR;BARUGA DHUA;174;62;34;38;36;2;0;1;0;173;1;JANUARI
422;SULAWESI BARAT;MAJENE;BANGGAE TIMUR;LABUANG;281;59;58;33;99;17;2;13;0;281;0;JANUARI
423;SULAWESI BARAT;MAJENE;BANGGAE TIMUR;TANDE;131;29;39;21;29;4;0;4;0;126;5;JANUARI
424;SULAWESI BARAT;MAJENE;BANGGAE TIMUR;LEMBANG;692;289;151;115;102;24;0;11;0;692;0;JANUARI
425;SULAWESI BARAT;MAJENE;BANGGAE TIMUR;LABUANG UTARA;315;90;81;20;62;35;1;24;0;313;2;JANUARI
426;SULAWESI BARAT;MAJENE;BANGGAE TIMUR;TANDE TIMUR;114;49;9;5;31;9;0;11;0;114;0;JANUARI
427;SULAWESI BARAT;MAJENE;BANGGAE TIMUR;BUTTU BARUGA;89;25;19;4;39;0;0;1;0;88;1;JANUARI
428;SULAWESI BARAT;MAJENE;ULUMANDA;KABIRAAN;145;95;24;0;23;1;0;2;0;145;0;JANUARI
429;SULAWESI BARAT;MAJENE;ULUMANDA;SAMBABO;96;52;19;2;21;0;0;0;0;94;2;JANUARI
430;SULAWESI BARAT;MAJENE;ULUMANDA;TANDEALLO;124;63;42;4;7;2;0;5;0;123;1;JANUARI
431;SULAWESI BARAT;MAJENE;ULUMANDA;ULUMANDA;157;53;80;3;8;5;1;7;0;157;0;JANUARI
432;SULAWESI BARAT;MAJENE;ULUMANDA;SALUTAMBUNG;117;90;15;1;9;0;0;2;0;117;0;JANUARI
433;SULAWESI BARAT;MAJENE;ULUMANDA;POPENGA;75;59;16;0;0;0;0;0;0;75;0;JANUARI
434;SULAWESI BARAT;MAJENE;ULUMANDA;SULAI;127;55;48;5;15;0;0;3;0;126;1;JANUARI
435;SULAWESI BARAT;MAJENE;ULUMANDA;PANGGALO;104;53;36;3;8;2;0;0;0;102;2;JANUARI
436;SULAWESI BARAT;MAJENE;TUBO SENDANA;ONANG;340;108;61;21;114;8;15;10;0;337;3;JANUARI
437;SULAWESI BARAT;MAJENE;TUBO SENDANA;TUBO;93;19;14;36;8;11;1;4;0;93;0;JANUARI
438;SULAWESI BARAT;MAJENE;TUBO SENDANA;ONANG UTARA;98;23;24;1;33;11;4;2;0;98;0;JANUARI
439;SULAWESI BARAT;MAJENE;TUBO SENDANA;TUBO SELATAN;94;38;17;1;22;10;2;4;0;94;0;JANUARI
440;SULAWESI BARAT;MAJENE;TUBO SENDANA;BONDE BONDE;96;21;14;11;24;15;6;5;0;96;0;JANUARI
441;SULAWESI BARAT;MAJENE;TUBO SENDANA;TUBO TENGAH;101;22;31;5;15;18;1;9;0;101;0;JANUARI
442;SULAWESI BARAT;MAJENE;TUBO SENDANA;TUBO POANG;94;42;28;9;10;1;0;4;0;94;0;JANUARI
443;SULAWESI BARAT;POLEWALI MANDAR;BINUANG;AMASSANGAN;301;144;56;1;66;2;0;32;0;301;0;JANUARI
444;SULAWESI BARAT;POLEWALI MANDAR;BINUANG;TONYAMAN;528;211;180;4;96;13;0;10;1;515;13;JANUARI
445;SULAWESI BARAT;POLEWALI MANDAR;BINUANG;KUAJANG;369;177;62;10;106;4;1;9;0;369;0;JANUARI
446;SULAWESI BARAT;POLEWALI MANDAR;BINUANG;PAKU;185;86;41;14;31;0;1;11;1;185;0;JANUARI
447;SULAWESI BARAT;POLEWALI MANDAR;BINUANG;MIRRING;246;124;44;13;44;1;0;17;0;243;3;JANUARI
448;SULAWESI BARAT;POLEWALI MANDAR;BINUANG;BATETANGNGA;677;391;142;11;80;7;0;15;2;648;29;JANUARI
449;SULAWESI BARAT;POLEWALI MANDAR;BINUANG;MAMMI;258;85;73;8;81;3;0;7;0;257;1;JANUARI
450;SULAWESI BARAT;POLEWALI MANDAR;BINUANG;KALEOK;158;55;70;3;26;0;0;4;0;158;0;JANUARI
451;SULAWESI BARAT;POLEWALI MANDAR;BINUANG;AMOLA;164;86;32;5;38;0;1;2;0;164;0;JANUARI
452;SULAWESI BARAT;POLEWALI MANDAR;BINUANG;REA;291;117;87;13;48;1;2;17;0;285;6;JANUARI
453;SULAWESI BARAT;MAJENE;BANGGAE;BANGGAE;360;97;136;19;61;32;1;14;0;360;0;JANUARI
454;SULAWESI BARAT;MAJENE;BANGGAE;BARU;509;151;123;7;190;11;0;27;0;509;0;JANUARI
455;SULAWESI BARAT;MAJENE;BANGGAE;PANGALI ALI;877;291;266;14;212;57;2;32;0;874;3;JANUARI
456;SULAWESI BARAT;MAJENE;BANGGAE;TOTOLI;437;143;110;15;138;12;1;18;0;437;0;JANUARI
457;SULAWESI BARAT;MAJENE;BANGGAE;RANGAS;915;356;345;18;146;33;1;14;2;915;0;JANUARI
458;SULAWESI BARAT;MAJENE;BANGGAE;GALUNG;245;52;18;25;80;29;0;38;0;242;3;JANUARI
459;SULAWESI BARAT;MAJENE;BANGGAE;PALIPI SOREANG;255;112;48;20;53;11;0;11;0;255;0;JANUARI
460;SULAWESI BARAT;MAJENE;BANGGAE;PAMBOBORANG;251;49;82;14;78;5;0;22;0;250;1;JANUARI
461;SULAWESI BARAT;POLEWALI MANDAR;ALLU;PETOOSANG;78;25;19;7;13;3;0;9;0;76;2;JANUARI
462;SULAWESI BARAT;POLEWALI MANDAR;ALLU;MOMBI;135;59;29;4;32;0;4;6;0;134;1;JANUARI
463;SULAWESI BARAT;POLEWALI MANDAR;ALLU;KALUMAMMANG;90;27;40;0;17;0;0;6;0;90;0;JANUARI
464;SULAWESI BARAT;POLEWALI MANDAR;ALLU;PAO-PAO;199;84;58;1;55;0;0;1;0;199;0;JANUARI
465;SULAWESI BARAT;POLEWALI MANDAR;ALLU;PUPPU URING;207;80;83;2;23;0;1;1;1;191;16;JANUARI
466;SULAWESI BARAT;POLEWALI MANDAR;ALLU;SARAGIAN;117;64;15;6;23;0;0;8;0;116;1;JANUARI
467;SULAWESI BARAT;POLEWALI MANDAR;ALLU;SAYOANG;53;27;18;0;5;1;0;2;0;53;0;JANUARI
468;SULAWESI BARAT;POLEWALI MANDAR;ALLU;ALU;123;49;42;9;20;1;0;2;0;123;0;JANUARI
469;SULAWESI BARAT;MAJENE;MALUNDA;MALUNDA;139;47;39;14;21;11;3;4;0;139;0;JANUARI
470;SULAWESI BARAT;MAJENE;MALUNDA;LAMUNGANG BATU;137;47;50;2;21;5;0;11;0;136;1;JANUARI
471;SULAWESI BARAT;MAJENE;MALUNDA;BAMBANGAN;163;89;45;1;25;2;0;1;0;163;0;JANUARI
472;SULAWESI BARAT;MAJENE;MALUNDA;LOMBANG;102;49;28;2;20;1;0;2;0;102;0;JANUARI
473;SULAWESI BARAT;MAJENE;MALUNDA;LOMBONG;228;68;103;7;25;5;0;19;0;227;1;JANUARI
474;SULAWESI BARAT;MAJENE;MALUNDA;MEKKATTA;200;100;25;6;55;2;0;6;0;194;6;JANUARI
475;SULAWESI BARAT;MAJENE;MALUNDA;MALIAYA;167;78;33;8;40;2;0;6;0;167;0;JANUARI
476;SULAWESI BARAT;MAJENE;MALUNDA;LOMBANG TIMUR;159;100;53;1;5;0;0;0;0;159;0;JANUARI
477;SULAWESI BARAT;MAJENE;MALUNDA;SALUTAHONGAN;94;56;26;0;9;1;0;1;0;93;1;JANUARI
478;SULAWESI BARAT;MAJENE;MALUNDA;LOMBONG TIMUR;96;19;28;7;4;19;0;19;0;96;0;JANUARI
479;SULAWESI BARAT;MAJENE;MALUNDA;MEKKATTA SELATAN;129;47;29;5;34;6;0;6;2;129;0;JANUARI
480;SULAWESI BARAT;MAJENE;MALUNDA;KAYUANGIN;188;86;44;15;15;11;0;13;0;184;4;JANUARI
481;SULAWESI BARAT;POLEWALI MANDAR;ANREAPI;ANREAPI;178;38;55;9;49;10;0;14;1;176;2;JANUARI
482;SULAWESI BARAT;POLEWALI MANDAR;ANREAPI;DUAMPANUA;394;118;148;20;81;5;0;17;0;389;5;JANUARI
483;SULAWESI BARAT;POLEWALI MANDAR;ANREAPI;KELAPA DUA;271;71;124;4;53;3;2;13;0;270;1;JANUARI
484;SULAWESI BARAT;POLEWALI MANDAR;ANREAPI;PAPPANDANGAN;261;101;74;7;64;2;3;8;0;259;2;JANUARI
485;SULAWESI BARAT;POLEWALI MANDAR;ANREAPI;KUNYI;245;40;114;3;65;2;0;11;2;237;8;JANUARI
486;SULAWESI BARAT;POLEWALI MANDAR;BALANIPA;BALANIPA;232;104;46;24;39;8;0;11;0;232;0;JANUARI
487;SULAWESI BARAT;POLEWALI MANDAR;BALANIPA;TAMMAJARRA;194;126;18;30;13;4;0;3;0;194;0;JANUARI
488;SULAWESI BARAT;POLEWALI MANDAR;BALANIPA;TAMANGGALLE;103;54;17;0;29;1;0;1;1;103;0;JANUARI
489;SULAWESI BARAT;POLEWALI MANDAR;BALANIPA;MOSSO;83;57;16;7;3;0;0;0;0;83;0;JANUARI
490;SULAWESI BARAT;POLEWALI MANDAR;BALANIPA;GALUNG TULUK;207;102;50;22;21;1;0;11;0;207;0;JANUARI
491;SULAWESI BARAT;POLEWALI MANDAR;BALANIPA;SABANG SUBIK;251;130;65;21;26;2;0;7;0;251;0;JANUARI
492;SULAWESI BARAT;POLEWALI MANDAR;BALANIPA;PAMBUSUANG;421;256;64;12;26;10;0;24;1;393;28;JANUARI
493;SULAWESI BARAT;POLEWALI MANDAR;BALANIPA;BALA;324;253;23;3;19;4;0;19;0;321;3;JANUARI
494;SULAWESI BARAT;POLEWALI MANDAR;BALANIPA;LAMBANAN;24;7;7;8;2;0;0;0;0;24;0;JANUARI
495;SULAWESI BARAT;POLEWALI MANDAR;BALANIPA;LEGO;105;67;25;0;5;0;0;8;0;105;0;JANUARI
496;SULAWESI BARAT;POLEWALI MANDAR;BALANIPA;PALLIS;29;13;7;1;5;1;0;2;0;29;0;JANUARI
497;SULAWESI BARAT;POLEWALI MANDAR;CAMPALAGIAN;PAPPANG;148;83;14;9;7;7;0;13;1;134;14;JANUARI
498;SULAWESI BARAT;POLEWALI MANDAR;CAMPALAGIAN;LALIKO;175;112;35;2;6;3;0;17;0;175;0;JANUARI
499;SULAWESI BARAT;POLEWALI MANDAR;CAMPALAGIAN;BONDE;178;103;36;5;12;10;0;12;0;178;0;JANUARI
500;SULAWESI BARAT;POLEWALI MANDAR;CAMPALAGIAN;KATUMBANGAN LEMO;148;89;25;14;14;4;0;2;0;148;0;JANUARI
501;SULAWESI BARAT;POLEWALI MANDAR;CAMPALAGIAN;PANYAMPA;198;131;42;2;7;3;0;10;2;197;1;JANUARI
502;SULAWESI BARAT;POLEWALI MANDAR;CAMPALAGIAN;SURUANG;159;86;42;10;8;1;0;7;0;154;5;JANUARI
503;SULAWESI BARAT;POLEWALI MANDAR;CAMPALAGIAN;LAMPOKO;228;145;55;11;9;2;0;6;0;228;0;JANUARI
504;SULAWESI BARAT;POLEWALI MANDAR;CAMPALAGIAN;KATUMBANGAN;285;125;39;4;64;39;0;14;0;285;0;JANUARI
505;SULAWESI BARAT;POLEWALI MANDAR;CAMPALAGIAN;LAPEO;124;69;16;7;17;3;0;11;0;123;1;JANUARI
506;SULAWESI BARAT;POLEWALI MANDAR;CAMPALAGIAN;PARAPPE;221;135;44;2;34;3;0;1;0;219;2;JANUARI
507;SULAWESI BARAT;POLEWALI MANDAR;CAMPALAGIAN;ONGKO;117;44;21;13;31;5;0;3;0;117;0;JANUARI
508;SULAWESI BARAT;POLEWALI MANDAR;CAMPALAGIAN;KENJE;149;105;10;7;18;3;0;6;0;149;0;JANUARI
509;SULAWESI BARAT;POLEWALI MANDAR;CAMPALAGIAN;SUMARRANG;429;237;121;4;62;5;0;0;0;429;0;JANUARI
510;SULAWESI BARAT;POLEWALI MANDAR;CAMPALAGIAN;BOTTO;257;128;61;0;55;3;0;8;0;255;2;JANUARI
511;SULAWESI BARAT;POLEWALI MANDAR;CAMPALAGIAN;GATTUNGAN;176;59;23;24;45;16;0;8;0;175;1;JANUARI
512;SULAWESI BARAT;POLEWALI MANDAR;CAMPALAGIAN;PADANG TIMUR;125;59;19;3;37;2;0;5;0;125;0;JANUARI
513;SULAWESI BARAT;POLEWALI MANDAR;CAMPALAGIAN;PADANG;63;36;7;3;12;0;0;0;0;58;5;JANUARI
514;SULAWESI BARAT;POLEWALI MANDAR;CAMPALAGIAN;LAGI-AGI;237;177;28;6;18;2;0;6;0;237;0;JANUARI
515;SULAWESI BARAT;POLEWALI MANDAR;BULO;BULO;107;21;11;4;69;2;0;0;0;107;0;JANUARI
516;SULAWESI BARAT;POLEWALI MANDAR;BULO;PULLIWA;307;105;48;3;135;3;0;12;0;306;1;JANUARI
517;SULAWESI BARAT;POLEWALI MANDAR;BULO;PATAMBANUA;145;32;99;0;11;0;0;1;0;143;2;JANUARI
518;SULAWESI BARAT;POLEWALI MANDAR;BULO;KAROMBANG;138;79;23;0;33;2;0;1;0;138;0;JANUARI
519;SULAWESI BARAT;POLEWALI MANDAR;BULO;DAALA TIMUR;125;43;64;2;15;0;0;1;0;125;0;JANUARI
520;SULAWESI BARAT;POLEWALI MANDAR;BULO;LENGGO;61;17;37;2;3;1;0;1;0;61;0;JANUARI
521;SULAWESI BARAT;POLEWALI MANDAR;BULO;SABURA;69;27;30;0;12;0;0;0;0;69;0;JANUARI
522;SULAWESI BARAT;POLEWALI MANDAR;BULO;SEPPORRAKI;105;24;26;0;53;0;0;2;0;105;0;JANUARI
523;SULAWESI BARAT;POLEWALI MANDAR;BULO;IHING;104;21;24;1;53;1;0;1;0;101;3;JANUARI
524;SULAWESI BARAT;POLEWALI MANDAR;LUYO;BATUPANGA;231;111;39;4;63;2;1;7;0;227;4;JANUARI
525;SULAWESI BARAT;POLEWALI MANDAR;LUYO;MAMBU;211;106;28;2;50;3;1;13;2;205;6;JANUARI
526;SULAWESI BARAT;POLEWALI MANDAR;LUYO;TENGGELANG;289;145;59;17;48;0;1;8;0;278;11;JANUARI
527;SULAWESI BARAT;POLEWALI MANDAR;LUYO;BARU;305;90;91;41;45;7;0;20;0;294;11;JANUARI
528;SULAWESI BARAT;POLEWALI MANDAR;LUYO;PUSSUI;177;97;30;2;40;0;1;5;1;176;1;JANUARI
529;SULAWESI BARAT;POLEWALI MANDAR;LUYO;MAPILI BARAT;199;119;38;11;21;0;0;10;0;199;0;JANUARI
530;SULAWESI BARAT;POLEWALI MANDAR;LUYO;SAMBALI WALI;260;154;40;14;38;1;0;2;0;249;11;JANUARI
531;SULAWESI BARAT;POLEWALI MANDAR;LUYO;BATUPANGA DAALA;316;150;48;3;108;0;1;5;0;315;1;JANUARI
532;SULAWESI BARAT;POLEWALI MANDAR;LUYO;LUYO;206;125;20;0;43;2;3;12;0;205;1;JANUARI
533;SULAWESI BARAT;POLEWALI MANDAR;LUYO;PUSSUI BARAT;106;50;11;3;24;13;1;3;0;105;1;JANUARI
534;SULAWESI BARAT;POLEWALI MANDAR;LUYO;PUCCADI;208;152;20;0;29;2;0;5;0;208;0;JANUARI
535;SULAWESI BARAT;MAMUJU;TAPALANG BARAT;DUNGKAIT;246;105;94;5;34;3;1;2;0;244;2;JANUARI
536;SULAWESI BARAT;MAMUJU;TAPALANG BARAT;LEBANI;114;40;49;0;8;0;0;5;2;104;10;JANUARI
537;SULAWESI BARAT;MAMUJU;TAPALANG BARAT;LABUANG RANO;223;114;82;0;10;4;0;2;0;212;11;JANUARI
538;SULAWESI BARAT;MAMUJU;TAPALANG BARAT;PASABU;166;49;69;7;15;8;0;12;2;162;4;JANUARI
539;SULAWESI BARAT;MAMUJU;TAPALANG BARAT;TANETE PAO;43;31;10;0;1;0;0;0;0;42;1;JANUARI
540;SULAWESI BARAT;MAMUJU;TAPALANG BARAT;PANGASAAN;59;24;23;2;7;2;0;0;0;58;1;JANUARI
541;SULAWESI BARAT;MAMUJU;TAPALANG BARAT;AHU;172;92;60;2;8;0;0;2;0;164;8;JANUARI
542;SULAWESI BARAT;MAMUJU;TOMMO;TOMMO;352;133;83;0;122;5;0;9;0;352;0;JANUARI
543;SULAWESI BARAT;MAMUJU;TOMMO;CAMPALOGA;304;88;133;9;62;8;0;0;0;300;4;JANUARI
544;SULAWESI BARAT;MAMUJU;TOMMO;BUANA SAKTI;215;81;49;1;83;1;0;0;0;215;0;JANUARI
545;SULAWESI BARAT;MAMUJU;TOMMO;TAMEMONGGA;237;81;117;0;35;1;0;3;0;237;0;JANUARI
546;SULAWESI BARAT;MAMUJU;TOMMO;TAMEJARRA;188;70;41;4;55;6;1;11;0;188;0;JANUARI
547;SULAWESI BARAT;MAMUJU;TOMMO;RANTEMARIO;164;65;68;3;17;6;0;5;0;164;0;JANUARI
548;SULAWESI BARAT;MAMUJU;TOMMO;MALINO;76;39;19;9;5;1;0;2;0;75;1;JANUARI
549;SULAWESI BARAT;MAMUJU;TOMMO;KAKULLASANG;368;154;147;7;48;1;0;6;0;363;5;JANUARI
550;SULAWESI BARAT;MAMUJU;TOMMO;LELING;135;40;66;0;28;0;0;1;0;135;0;JANUARI
551;SULAWESI BARAT;MAMUJU;TOMMO;KALEPU;101;57;37;1;4;1;0;1;0;101;0;JANUARI
552;SULAWESI BARAT;MAMUJU;TOMMO;SANDANA;137;53;52;1;18;2;0;10;1;137;0;JANUARI
553;SULAWESI BARAT;MAMUJU;TOMMO;LELING BARAT;222;71;92;3;46;6;0;3;0;221;1;JANUARI
554;SULAWESI BARAT;MAMUJU;TOMMO;LELING UTARA;199;82;91;0;26;0;0;0;0;199;0;JANUARI
555;SULAWESI BARAT;MAMUJU;TOMMO;SALUDENGEN;134;70;56;1;7;0;0;0;0;134;0;JANUARI
556;SULAWESI BARAT;POLEWALI MANDAR;LIMBORO;LIMBORO;127;39;30;15;22;3;0;9;0;118;9;JANUARI
557;SULAWESI BARAT;POLEWALI MANDAR;LIMBORO;LEMBANG LEMBANG;231;91;55;32;35;5;0;13;0;231;0;JANUARI
558;SULAWESI BARAT;POLEWALI MANDAR;LIMBORO;TANDASURA;147;75;18;12;28;2;0;10;0;145;2;JANUARI
559;SULAWESI BARAT;POLEWALI MANDAR;LIMBORO;SAMASUNDU;149;48;54;11;24;6;0;6;0;149;0;JANUARI
560;SULAWESI BARAT;POLEWALI MANDAR;LIMBORO;NAPO;159;87;26;3;34;0;0;9;0;159;0;JANUARI
561;SULAWESI BARAT;POLEWALI MANDAR;LIMBORO;TODANG TODANG;40;17;15;5;3;0;0;0;0;40;0;JANUARI
562;SULAWESI BARAT;POLEWALI MANDAR;LIMBORO;PENDULANGAN;58;34;19;0;3;0;0;2;0;58;0;JANUARI
563;SULAWESI BARAT;POLEWALI MANDAR;LIMBORO;RENGGEANG;112;36;35;7;30;0;0;4;0;112;0;JANUARI
564;SULAWESI BARAT;POLEWALI MANDAR;LIMBORO;SALARRI;61;24;17;7;11;1;0;1;0;61;0;JANUARI
565;SULAWESI BARAT;POLEWALI MANDAR;LIMBORO;TANGAN BARU;81;29;12;2;33;0;0;5;0;81;0;JANUARI
566;SULAWESI BARAT;POLEWALI MANDAR;LIMBORO;PALECE;123;28;44;29;15;3;0;4;0;123;0;JANUARI
567;SULAWESI BARAT;MAMUJU;SIMBORO;SIMBORO;1535;620;177;68;161;246;1;61;5;1339;196;JANUARI
568;SULAWESI BARAT;MAMUJU;SIMBORO;RANGAS;583;186;163;22;121;18;3;10;0;523;60;JANUARI
569;SULAWESI BARAT;MAMUJU;SIMBORO;BOTTENG;183;111;35;1;20;3;0;12;0;182;1;JANUARI
570;SULAWESI BARAT;MAMUJU;SIMBORO;SALETTO;291;135;79;4;44;7;1;21;0;291;0;JANUARI
571;SULAWESI BARAT;MAMUJU;SIMBORO;SUMARE;228;102;87;2;26;10;0;1;0;228;0;JANUARI
572;SULAWESI BARAT;MAMUJU;SIMBORO;BOTTENG UTARA;353;144;84;1;101;4;1;0;0;335;18;JANUARI
573;SULAWESI BARAT;MAMUJU;SIMBORO;TAPANDULLU;44;27;0;0;13;0;2;2;0;44;0;JANUARI
574;SULAWESI BARAT;MAMUJU;SIMBORO;PATI'DI;185;103;42;3;33;1;0;3;0;185;0;JANUARI
575;SULAWESI BARAT;MAMUJU;PAPALANG;TOABO;652;284;150;4;201;8;0;3;1;651;1;JANUARI
576;SULAWESI BARAT;MAMUJU;PAPALANG;PAPALANG;662;321;151;4;139;2;0;4;0;621;41;JANUARI
577;SULAWESI BARAT;MAMUJU;PAPALANG;BONDA;312;176;87;1;45;0;0;2;0;311;1;JANUARI
578;SULAWESI BARAT;MAMUJU;PAPALANG;TOPORE;195;106;40;7;33;1;0;2;0;189;6;JANUARI
579;SULAWESI BARAT;MAMUJU;PAPALANG;SALUKAYU;255;130;89;0;29;2;0;5;0;255;0;JANUARI
580;SULAWESI BARAT;MAMUJU;PAPALANG;SUKADAMAI;113;61;35;1;12;0;0;4;0;113;0;JANUARI
581;SULAWESI BARAT;MAMUJU;PAPALANG;BODA-BODA;166;93;48;1;22;0;0;1;0;165;1;JANUARI
582;SULAWESI BARAT;MAMUJU;PAPALANG;SISANGO;107;27;69;0;6;3;0;1;0;106;1;JANUARI
583;SULAWESI BARAT;MAMUJU;PAPALANG;BATU AMPA;151;45;79;8;18;0;0;1;0;151;0;JANUARI
584;SULAWESI BARAT;POLEWALI MANDAR;MATAKALI;MATAKALI;330;153;83;16;52;13;0;13;0;330;0;JANUARI
585;SULAWESI BARAT;POLEWALI MANDAR;MATAKALI;PETAMPANUA;280;126;92;3;35;17;2;5;0;280;0;JANUARI
586;SULAWESI BARAT;POLEWALI MANDAR;MATAKALI;BARUMBUNG;217;85;73;7;41;8;0;3;0;217;0;JANUARI
587;SULAWESI BARAT;POLEWALI MANDAR;MATAKALI;PASIANG;422;159;79;15;138;8;0;19;0;418;4;JANUARI
588;SULAWESI BARAT;POLEWALI MANDAR;MATAKALI;TONROLIMA;238;122;51;2;37;5;0;11;2;230;8;JANUARI
589;SULAWESI BARAT;POLEWALI MANDAR;MATAKALI;INDOMAKKOMBONG;390;190;108;1;67;5;0;10;2;383;7;JANUARI
590;SULAWESI BARAT;POLEWALI MANDAR;MATAKALI;BUNGA-BUNGA;131;55;48;7;17;0;0;4;0;131;0;JANUARI
591;SULAWESI BARAT;POLEWALI MANDAR;MAPILLI;MAPILI;118;48;9;6;37;4;0;14;0;118;0;JANUARI
592;SULAWESI BARAT;POLEWALI MANDAR;MAPILLI;UGIBARU;178;65;18;14;33;8;0;24;0;162;16;JANUARI
593;SULAWESI BARAT;POLEWALI MANDAR;MAPILLI;RUMPA;158;82;18;2;47;5;0;4;0;158;0;JANUARI
594;SULAWESI BARAT;POLEWALI MANDAR;MAPILLI;KURMA;312;177;50;0;69;1;0;15;0;312;0;JANUARI
595;SULAWESI BARAT;POLEWALI MANDAR;MAPILLI;BUKU;237;169;32;4;24;2;0;2;0;233;4;JANUARI
596;SULAWESI BARAT;POLEWALI MANDAR;MAPILLI;BONNE BONNE;133;47;19;12;39;9;0;7;0;133;0;JANUARI
597;SULAWESI BARAT;POLEWALI MANDAR;MAPILLI;BEROANGIN;216;69;28;1;95;4;0;14;1;212;4;JANUARI
598;SULAWESI BARAT;POLEWALI MANDAR;MAPILLI;SEGERANG;168;99;36;3;23;1;0;6;0;168;0;JANUARI
599;SULAWESI BARAT;POLEWALI MANDAR;MAPILLI;BONRA;193;93;53;2;30;3;0;12;0;193;0;JANUARI
600;SULAWESI BARAT;POLEWALI MANDAR;MAPILLI;SATTOKO;75;20;7;0;43;0;0;5;0;75;0;JANUARI
601;SULAWESI BARAT;POLEWALI MANDAR;MAPILLI;RAPPANG BARAT;327;102;118;5;72;4;0;25;0;326;1;JANUARI
602;SULAWESI BARAT;POLEWALI MANDAR;MAPILLI;LANDI KANUSUANG;322;126;36;1;141;0;0;18;0;322;0;JANUARI
603;SULAWESI BARAT;MAJENE;TAMMERODO SENDANA;SEPPONG;146;73;51;6;6;5;0;5;0;146;0;JANUARI
604;SULAWESI BARAT;MAJENE;TAMMERODO SENDANA;TAMMERODO;139;66;28;1;13;19;3;6;0;136;3;JANUARI
605;SULAWESI BARAT;MAJENE;TAMMERODO SENDANA;ULIDANG;176;98;31;3;20;8;2;14;0;176;0;JANUARI
606;SULAWESI BARAT;MAJENE;TAMMERODO SENDANA;TALLAMBALAO;204;119;54;3;5;4;1;18;0;204;0;JANUARI
607;SULAWESI BARAT;MAJENE;TAMMERODO SENDANA;TAMMERODO UTARA;182;88;41;7;11;25;0;9;1;182;0;JANUARI
608;SULAWESI BARAT;MAJENE;TAMMERODO SENDANA;MANYAMBA;168;106;32;1;19;5;0;4;0;167;1;JANUARI
609;SULAWESI BARAT;MAJENE;TAMMERODO SENDANA;AWO;130;78;16;0;6;9;6;11;0;126;4;JANUARI
610;SULAWESI BARAT;PASANGKAYU;BAMBALAMOTU;BAMBALAMOTU;397;194;70;4;79;24;0;24;0;395;2;JANUARI
611;SULAWESI BARAT;PASANGKAYU;BAMBALAMOTU;POLEWALI;441;161;141;4;89;31;0;15;0;441;0;JANUARI
612;SULAWESI BARAT;PASANGKAYU;BAMBALAMOTU;RANDOMAYANG;439;149;63;3;159;18;0;35;0;427;12;JANUARI
613;SULAWESI BARAT;PASANGKAYU;BAMBALAMOTU;PANGIANG;186;94;50;2;21;14;0;5;0;186;0;JANUARI
614;SULAWESI BARAT;PASANGKAYU;BAMBALAMOTU;KALOLA;466;118;115;0;204;16;0;13;0;466;0;JANUARI
615;SULAWESI BARAT;PASANGKAYU;BAMBALAMOTU;WULAI;265;59;77;0;106;5;0;17;0;264;1;JANUARI
616;SULAWESI BARAT;PASANGKAYU;BARAS;BARAS;273;95;32;2;91;39;0;13;1;273;0;JANUARI
617;SULAWESI BARAT;PASANGKAYU;BARAS;BALANTI;365;193;74;2;75;10;0;8;0;362;3;JANUARI
618;SULAWESI BARAT;PASANGKAYU;BARAS;MOTU;573;215;134;11;118;61;0;31;0;570;3;JANUARI
619;SULAWESI BARAT;PASANGKAYU;BARAS;BULU PARIGI;177;76;14;2;80;4;0;1;0;177;0;JANUARI
620;SULAWESI BARAT;PASANGKAYU;BARAS;TOWONI;179;43;50;2;72;5;0;7;0;179;0;JANUARI
621;SULAWESI BARAT;PASANGKAYU;BARAS;KASANO;305;192;32;0;70;9;0;2;0;305;0;JANUARI
622;SULAWESI BARAT;MAMUJU TENGAH;TOPOYO;BUDONG-BUDONG;256;109;71;5;44;6;0;11;0;246;10;JANUARI
623;SULAWESI BARAT;MAMUJU TENGAH;TOPOYO;TOPOYO;936;317;231;13;176;58;0;24;0;819;117;JANUARI
624;SULAWESI BARAT;MAMUJU TENGAH;TOPOYO;TUMBU;342;161;69;4;80;18;0;10;0;342;0;JANUARI
625;SULAWESI BARAT;MAMUJU TENGAH;TOPOYO;KABUBU;271;87;44;15;106;13;1;4;0;270;1;JANUARI
626;SULAWESI BARAT;MAMUJU TENGAH;TOPOYO;WAEPUTEH;270;141;26;11;78;6;0;4;0;266;4;JANUARI
627;SULAWESI BARAT;MAMUJU TENGAH;TOPOYO;TANGKOU;140;78;21;1;31;4;0;3;2;140;0;JANUARI
628;SULAWESI BARAT;MAMUJU TENGAH;TOPOYO;TABOLANG;445;157;99;18;101;6;1;9;1;392;53;JANUARI
629;SULAWESI BARAT;MAMUJU TENGAH;TOPOYO;PARAILI;193;102;38;2;32;15;2;2;0;193;0;JANUARI
630;SULAWESI BARAT;MAMUJU TENGAH;TOPOYO;SALUPANGKANG;479;145;63;9;250;8;0;2;1;478;1;JANUARI
631;SULAWESI BARAT;MAMUJU TENGAH;TOPOYO;SALUPANGKANG IV;62;41;2;0;17;0;0;1;0;61;1;JANUARI
632;SULAWESI BARAT;MAMUJU TENGAH;TOPOYO;TAPPILINA;150;44;34;11;41;13;0;7;0;150;0;JANUARI
633;SULAWESI BARAT;MAMUJU TENGAH;TOPOYO;BAMBAMANURUNG;152;67;10;4;66;4;0;0;1;152;0;JANUARI
634;SULAWESI BARAT;MAMUJU TENGAH;TOPOYO;SALULEKBO;390;166;86;5;129;2;0;1;0;389;1;JANUARI
635;SULAWESI BARAT;MAMUJU TENGAH;TOPOYO;PANGALLOANG;248;79;48;2;110;6;0;2;0;247;1;JANUARI
636;SULAWESI BARAT;MAMUJU TENGAH;TOPOYO;SINABATTA;120;60;37;2;12;5;0;0;0;116;4;JANUARI
637;SULAWESI BARAT;MAMUJU TENGAH;KAROSSA;KAROSSA;609;302;111;5;161;13;1;15;1;609;0;JANUARI
638;SULAWESI BARAT;MAMUJU TENGAH;KAROSSA;TASOKKO;420;165;109;8;108;7;2;21;0;420;0;JANUARI
639;SULAWESI BARAT;MAMUJU TENGAH;KAROSSA;LARA;118;34;11;0;65;4;1;3;0;118;0;JANUARI
640;SULAWESI BARAT;MAMUJU TENGAH;KAROSSA;KADAILA;157;52;27;3;72;2;0;1;0;157;0;JANUARI
641;SULAWESI BARAT;MAMUJU TENGAH;KAROSSA;KAYU CALLA;78;31;15;3;28;1;0;0;0;78;0;JANUARI
642;SULAWESI BARAT;MAMUJU TENGAH;KAROSSA;LEMBAH HOPO;125;29;13;11;64;1;0;7;0;125;0;JANUARI
643;SULAWESI BARAT;MAMUJU TENGAH;KAROSSA;BENGGAULU;260;124;58;0;62;8;0;6;0;258;2;JANUARI
644;SULAWESI BARAT;MAMUJU TENGAH;KAROSSA;SUKA MAJU;115;46;35;2;27;1;0;1;0;112;3;JANUARI
645;SULAWESI BARAT;MAMUJU TENGAH;KAROSSA;KAMBUNONG;277;147;72;0;40;6;0;11;0;276;1;JANUARI
646;SULAWESI BARAT;MAMUJU TENGAH;KAROSSA;SALUBIRO;159;85;29;1;34;0;0;10;0;159;0;JANUARI
647;SULAWESI BARAT;MAMUJU TENGAH;KAROSSA;SANJANGO;145;44;36;1;56;1;4;3;0;145;0;JANUARI
648;SULAWESI BARAT;MAMUJU;KEP. BALA BALAKANG;BALA BALAKANG;123;63;47;3;9;0;0;0;0;122;1;FEBRUARI
649;SULAWESI BARAT;MAMUJU;KEP. BALA BALAKANG;BALA-BALAKANG TIMUR;98;24;71;2;0;0;1;0;0;98;0;FEBRUARI
650;SULAWESI BARAT;POLEWALI MANDAR;TINAMBUNG;TINAMBUNG;140;40;35;6;26;6;0;27;0;140;0;FEBRUARI
651;SULAWESI BARAT;POLEWALI MANDAR;TINAMBUNG;KARAMA;467;334;50;23;43;2;0;15;0;467;0;FEBRUARI
652;SULAWESI BARAT;POLEWALI MANDAR;TINAMBUNG;TANGNGA TANGNGA;207;144;38;2;14;1;0;8;0;207;0;FEBRUARI
653;SULAWESI BARAT;POLEWALI MANDAR;TINAMBUNG;LEKOPADIS;94;36;19;5;27;1;0;5;0;93;1;FEBRUARI
654;SULAWESI BARAT;POLEWALI MANDAR;TINAMBUNG;GALUNG LOMBOK;144;59;23;7;38;2;0;15;0;144;0;FEBRUARI
655;SULAWESI BARAT;POLEWALI MANDAR;TINAMBUNG;TANDUNG;130;59;26;9;18;4;0;13;0;129;1;FEBRUARI
656;SULAWESI BARAT;POLEWALI MANDAR;TINAMBUNG;BATULAYA;113;43;23;16;18;5;0;8;0;113;0;FEBRUARI
657;SULAWESI BARAT;POLEWALI MANDAR;TINAMBUNG;SEPABATU;100;34;25;10;16;2;0;13;0;100;0;FEBRUARI
658;SULAWESI BARAT;POLEWALI MANDAR;TAPANGO;PELITAKAN;167;94;27;1;13;2;0;13;0;150;17;FEBRUARI
659;SULAWESI BARAT;POLEWALI MANDAR;TAPANGO;TAPANGO;218;122;42;3;40;5;0;6;0;218;0;FEBRUARI
660;SULAWESI BARAT;POLEWALI MANDAR;TAPANGO;RAPPANG;234;127;55;1;42;2;0;6;0;233;1;FEBRUARI
661;SULAWESI BARAT;POLEWALI MANDAR;TAPANGO;DAKKA;191;87;57;1;36;2;0;5;0;188;3;FEBRUARI
662;SULAWESI BARAT;POLEWALI MANDAR;TAPANGO;BATU;139;74;28;8;21;1;0;6;0;138;1;FEBRUARI
663;SULAWESI BARAT;POLEWALI MANDAR;TAPANGO;RISO;182;100;13;1;57;4;0;5;0;180;2;FEBRUARI
664;SULAWESI BARAT;POLEWALI MANDAR;TAPANGO;PALATTA;167;64;52;1;37;1;0;1;1;157;10;FEBRUARI
665;SULAWESI BARAT;POLEWALI MANDAR;TAPANGO;TAPANGO BARAT;153;83;38;2;18;3;0;9;0;153;0;FEBRUARI
666;SULAWESI BARAT;POLEWALI MANDAR;TAPANGO;KURRAK;80;43;33;0;2;1;0;1;0;80;0;FEBRUARI
667;SULAWESI BARAT;POLEWALI MANDAR;TAPANGO;BUSSU;155;97;36;4;13;2;0;3;0;155;0;FEBRUARI
668;SULAWESI BARAT;POLEWALI MANDAR;TAPANGO;TUTTULA;114;76;15;2;15;1;0;1;0;110;4;FEBRUARI
669;SULAWESI BARAT;POLEWALI MANDAR;TAPANGO;JAMBU MALEA;204;83;75;6;30;0;0;10;0;204;0;FEBRUARI
670;SULAWESI BARAT;POLEWALI MANDAR;TAPANGO;KALIMBUA;203;131;40;1;24;2;0;5;0;203;0;FEBRUARI
671;SULAWESI BARAT;POLEWALI MANDAR;TAPANGO;BANATO REJO;342;210;84;0;33;6;0;4;0;337;5;FEBRUARI
672;SULAWESI BARAT;POLEWALI MANDAR;POLEWALI;POLEWALI;533;157;162;45;82;32;0;44;0;522;11;FEBRUARI
673;SULAWESI BARAT;POLEWALI MANDAR;POLEWALI;WATTANG;218;65;71;15;32;18;0;17;0;218;0;FEBRUARI
674;SULAWESI BARAT;POLEWALI MANDAR;POLEWALI;SULEWATANG;401;100;205;3;74;7;0;12;0;401;0;FEBRUARI
675;SULAWESI BARAT;POLEWALI MANDAR;POLEWALI;LANTORA;434;115;181;22;52;36;0;28;0;434;0;FEBRUARI
676;SULAWESI BARAT;POLEWALI MANDAR;POLEWALI;TAKATIDUNG;550;263;121;29;77;20;0;22;0;532;18;FEBRUARI
677;SULAWESI BARAT;POLEWALI MANDAR;POLEWALI;PEKKABATA;348;155;65;36;48;28;0;15;0;347;1;FEBRUARI
678;SULAWESI BARAT;POLEWALI MANDAR;POLEWALI;MADATE;590;214;168;69;87;20;0;32;0;590;0;FEBRUARI
679;SULAWESI BARAT;POLEWALI MANDAR;POLEWALI;MANDING;476;158;149;17;96;21;0;34;0;475;1;FEBRUARI
680;SULAWESI BARAT;POLEWALI MANDAR;POLEWALI;DARMA;543;203;160;19;112;16;0;33;0;543;0;FEBRUARI
681;SULAWESI BARAT;POLEWALI MANDAR;MATANGNGA;MATANGNGA;82;43;9;3;23;1;0;3;0;82;0;FEBRUARI
682;SULAWESI BARAT;POLEWALI MANDAR;MATANGNGA;LILLI;108;39;15;1;52;0;0;1;0;108;0;FEBRUARI
683;SULAWESI BARAT;POLEWALI MANDAR;MATANGNGA;RANGOAN;79;28;28;1;21;0;0;0;0;78;1;FEBRUARI
684;SULAWESI BARAT;POLEWALI MANDAR;MATANGNGA;TAPUA;166;70;30;9;56;0;0;1;0;166;0;FEBRUARI
685;SULAWESI BARAT;POLEWALI MANDAR;MATANGNGA;MAMBU TAPUA;97;33;12;1;48;0;0;3;0;97;0;FEBRUARI
686;SULAWESI BARAT;POLEWALI MANDAR;MATANGNGA;BA'BA TAPUA;74;27;9;3;35;0;0;0;0;74;0;FEBRUARI
687;SULAWESI BARAT;POLEWALI MANDAR;MATANGNGA;KATIMBANG;88;37;25;1;23;1;0;0;0;87;1;FEBRUARI
688;SULAWESI BARAT;MAMUJU;SAMPAGA;BUNDE;516;252;130;3;125;1;0;5;0;516;0;FEBRUARI
689;SULAWESI BARAT;MAMUJU;SAMPAGA;KALONDING;455;186;185;6;70;4;0;3;0;454;1;FEBRUARI
690;SULAWESI BARAT;MAMUJU;SAMPAGA;TARAILU;265;118;81;1;53;5;0;7;0;265;0;FEBRUARI
691;SULAWESI BARAT;MAMUJU;SAMPAGA;SAMPAGA;188;89;64;5;25;2;0;2;1;188;0;FEBRUARI
692;SULAWESI BARAT;MAMUJU;SAMPAGA;TANAMBUAH;73;26;24;1;20;0;0;2;0;73;0;FEBRUARI
693;SULAWESI BARAT;MAMUJU;SAMPAGA;SALUBARANA;79;39;21;1;15;0;0;3;0;79;0;FEBRUARI
694;SULAWESI BARAT;MAMUJU;SAMPAGA;LOSSO;127;54;22;1;49;0;0;0;0;126;1;FEBRUARI
695;SULAWESI BARAT;MAMASA;BUNTUMALANGKA;BUNTUMALANGKA;130;28;67;1;25;4;0;4;0;129;1;FEBRUARI
696;SULAWESI BARAT;MAMASA;BUNTUMALANGKA;RANTEBERAN;117;66;43;0;7;0;0;1;0;117;0;FEBRUARI
697;SULAWESI BARAT;MAMASA;BUNTUMALANGKA;KEBANGA;55;9;33;0;13;0;0;0;0;55;0;FEBRUARI
698;SULAWESI BARAT;MAMASA;BUNTUMALANGKA;SALURINDU;55;23;22;1;7;0;0;2;0;55;0;FEBRUARI
699;SULAWESI BARAT;MAMASA;BUNTUMALANGKA;TAORA;55;17;35;1;1;0;0;1;0;55;0;FEBRUARI
700;SULAWESI BARAT;MAMASA;BUNTUMALANGKA;KABAE;77;11;61;0;4;0;0;1;0;77;0;FEBRUARI
701;SULAWESI BARAT;MAMASA;BUNTUMALANGKA;SALUTAMBUN BARAT;51;29;21;0;1;0;0;0;0;51;0;FEBRUARI
702;SULAWESI BARAT;MAMASA;BUNTUMALANGKA;PENATANGAN;121;41;48;0;22;3;1;1;1;117;4;FEBRUARI
703;SULAWESI BARAT;MAMASA;BUNTUMALANGKA;SALUTAMBUN TIMUR;48;15;31;0;1;0;0;1;0;48;0;FEBRUARI
704;SULAWESI BARAT;MAMASA;BUNTUMALANGKA;SALUTAMBUN;38;9;22;0;3;2;0;2;0;38;0;FEBRUARI
705;SULAWESI BARAT;MAMASA;BUNTUMALANGKA;ARALLE TIMUR;95;27;57;0;3;0;0;1;0;88;7;FEBRUARI
706;SULAWESI BARAT;MAMASA;MAMBI;MAMBI;81;46;22;2;10;1;0;0;0;81;0;FEBRUARI
707;SULAWESI BARAT;MAMASA;MAMBI;TALIPUKKI;120;89;13;4;9;2;0;2;0;119;1;FEBRUARI
708;SULAWESI BARAT;MAMASA;MAMBI;RANTEBULAHAN;59;17;31;0;8;1;0;1;0;58;1;FEBRUARI
709;SULAWESI BARAT;MAMASA;MAMBI;SONDONGLAYU;36;17;5;2;7;0;0;5;0;36;0;FEBRUARI
710;SULAWESI BARAT;MAMASA;MAMBI;SALUBANUA;36;14;20;0;1;0;0;0;0;35;1;FEBRUARI
711;SULAWESI BARAT;MAMASA;MAMBI;TAPALINA;116;78;31;6;0;0;0;0;0;115;1;FEBRUARI
712;SULAWESI BARAT;MAMASA;MAMBI;SENDANA;156;63;76;3;14;0;0;0;0;156;0;FEBRUARI
713;SULAWESI BARAT;MAMASA;MAMBI;PAMOSEAN;51;42;6;3;0;0;0;0;0;51;0;FEBRUARI
714;SULAWESI BARAT;MAMASA;MAMBI;SELUMAKA;125;30;95;0;0;0;0;0;0;125;0;FEBRUARI
715;SULAWESI BARAT;MAMASA;MAMBI;BUJUNG MANURUNG;45;24;18;0;3;0;0;0;0;45;0;FEBRUARI
716;SULAWESI BARAT;MAMASA;MAMBI;SALU ALO;79;25;48;0;6;0;0;0;0;79;0;FEBRUARI
717;SULAWESI BARAT;MAMASA;MAMBI;INDOBANUA;29;12;10;0;1;6;0;0;0;29;0;FEBRUARI
718;SULAWESI BARAT;MAMASA;MAMBI;SALUDURIAN;86;26;49;0;9;1;0;1;0;86;0;FEBRUARI
719;SULAWESI BARAT;PASANGKAYU;TIKKE RAYA;TIKKE;325;94;63;5;102;40;0;12;0;316;9;FEBRUARI
720;SULAWESI BARAT;PASANGKAYU;TIKKE RAYA;MAKMUR JAYA;487;187;125;4;122;26;0;19;1;484;3;FEBRUARI
721;SULAWESI BARAT;PASANGKAYU;TIKKE RAYA;LARIANG;475;180;91;7;162;20;0;12;0;472;3;FEBRUARI
722;SULAWESI BARAT;PASANGKAYU;TIKKE RAYA;PAJALELE;417;168;98;1;103;27;1;16;1;415;2;FEBRUARI
723;SULAWESI BARAT;PASANGKAYU;TIKKE RAYA;JENGENG RAYA;266;99;56;10;73;21;0;7;0;266;0;FEBRUARI
724;SULAWESI BARAT;MAMASA;MESSAWA;MESSAWA;35;8;19;0;6;0;0;2;0;35;0;FEBRUARI
725;SULAWESI BARAT;MAMASA;MESSAWA;RIPPUNG;135;69;51;0;15;0;0;0;0;135;0;FEBRUARI
726;SULAWESI BARAT;MAMASA;MESSAWA;MAKUANG;106;57;33;0;16;0;0;0;0;106;0;FEBRUARI
727;SULAWESI BARAT;MAMASA;MESSAWA;SEPANG;73;46;25;0;2;0;0;0;0;73;0;FEBRUARI
728;SULAWESI BARAT;MAMASA;MESSAWA;MALIMBONG;56;13;40;0;3;0;0;0;0;56;0;FEBRUARI
729;SULAWESI BARAT;MAMASA;MESSAWA;MATANDE;85;18;55;6;5;1;0;0;0;85;0;FEBRUARI
730;SULAWESI BARAT;MAMASA;MESSAWA;SIPAI;78;34;34;0;10;0;0;0;0;78;0;FEBRUARI
731;SULAWESI BARAT;MAMASA;MESSAWA;PASMA MAMBU;48;16;22;0;10;0;0;0;0;48;0;FEBRUARI
732;SULAWESI BARAT;MAMASA;MESSAWA;TANETE BATU;55;28;23;0;3;0;0;1;0;55;0;FEBRUARI
733;SULAWESI BARAT;MAMASA;MEHALAAN;MEHALAAN;56;21;16;1;16;0;0;2;0;56;0;FEBRUARI
734;SULAWESI BARAT;MAMASA;MEHALAAN;BOTTENG;65;28;12;0;23;0;1;1;0;65;0;FEBRUARI
735;SULAWESI BARAT;MAMASA;MEHALAAN;SALUKONTA;54;22;14;3;14;0;0;1;0;54;0;FEBRUARI
736;SULAWESI BARAT;MAMASA;MEHALAAN;MESAKADA;62;17;24;1;19;0;0;1;0;62;0;FEBRUARI
737;SULAWESI BARAT;MAMASA;MEHALAAN;MEHALAAN BARAT;92;36;22;0;32;0;0;2;0;92;0;FEBRUARI
738;SULAWESI BARAT;MAMASA;MEHALAAN;SALUAHOK;72;18;27;0;23;0;0;4;0;72;0;FEBRUARI
739;SULAWESI BARAT;MAMASA;MEHALAAN;SALUBALO;46;22;16;0;8;0;0;0;0;46;0;FEBRUARI
740;SULAWESI BARAT;MAMASA;MEHALAAN;PASSEMBUK;40;20;10;0;10;0;0;0;0;40;0;FEBRUARI
741;SULAWESI BARAT;MAMASA;MEHALAAN;KONDO;37;17;9;0;10;0;0;1;0;37;0;FEBRUARI
742;SULAWESI BARAT;MAMASA;MEHALAAN;LEKO SUKAMAJU;31;12;10;0;8;0;0;1;0;31;0;FEBRUARI
743;SULAWESI BARAT;MAMASA;MEHALAAN;ULUMEA;27;13;3;0;11;0;0;0;0;27;0;FEBRUARI
744;SULAWESI BARAT;MAMASA;MAMASA;MAMASA;369;61;44;2;182;61;0;19;0;369;0;FEBRUARI
745;SULAWESI BARAT;MAMASA;MAMASA;RAMBUSARATU;259;92;82;14;53;12;0;6;0;259;0;FEBRUARI
746;SULAWESI BARAT;MAMASA;MAMASA;OSANGO;481;90;75;13;191;93;0;14;1;477;4;FEBRUARI
747;SULAWESI BARAT;MAMASA;MAMASA;LAMBANAN;224;68;54;9;78;6;0;9;0;224;0;FEBRUARI
748;SULAWESI BARAT;MAMASA;MAMASA;LEMBANA SALULO;89;17;14;2;46;4;0;6;0;89;0;FEBRUARI
749;SULAWESI BARAT;MAMASA;MAMASA;TAUPE;236;55;27;9;141;1;1;2;0;236;0;FEBRUARI
750;SULAWESI BARAT;MAMASA;MAMASA;BUNTU BUDA;299;78;28;7;106;29;0;5;2;255;44;FEBRUARI
751;SULAWESI BARAT;MAMASA;MAMASA;TONDOK BAKARU;270;91;84;16;61;10;0;7;0;269;1;FEBRUARI
752;SULAWESI BARAT;MAMASA;MAMASA;PEBASSIAN;93;20;26;0;42;3;0;2;0;93;0;FEBRUARI
753;SULAWESI BARAT;MAMASA;MAMASA;MAMBULILING;118;57;19;1;37;3;0;1;0;118;0;FEBRUARI
754;SULAWESI BARAT;MAMASA;MAMASA;BOMBONG LAMBE;148;42;21;2;68;14;0;1;0;148;0;FEBRUARI
755;SULAWESI BARAT;MAMASA;MAMASA;BUBUN BATU;129;26;7;6;77;2;0;2;0;120;9;FEBRUARI
756;SULAWESI BARAT;MAMUJU;TAPALANG;GALUNG;255;57;104;5;40;24;0;19;2;251;4;FEBRUARI
757;SULAWESI BARAT;MAMUJU;TAPALANG;KASAMBANG;219;77;66;1;58;4;0;10;2;218;1;FEBRUARI
758;SULAWESI BARAT;MAMUJU;TAPALANG;DAYANGINNA;123;35;37;10;25;6;0;7;0;120;3;FEBRUARI
759;SULAWESI BARAT;MAMUJU;TAPALANG;OROBATU;94;33;29;13;7;6;0;6;0;94;0;FEBRUARI
760;SULAWESI BARAT;MAMUJU;TAPALANG;TAKANDEANG;198;69;38;2;66;16;1;5;1;198;0;FEBRUARI
761;SULAWESI BARAT;MAMUJU;TAPALANG;BELA;49;33;8;0;8;0;0;0;0;49;0;FEBRUARI
762;SULAWESI BARAT;MAMUJU;TAPALANG;TAAN;251;94;85;2;56;4;0;9;0;250;1;FEBRUARI
763;SULAWESI BARAT;MAMUJU;TAPALANG;TAMPALANG;170;74;25;1;54;4;0;11;1;170;0;FEBRUARI
764;SULAWESI BARAT;MAMUJU;TAPALANG;RANTEDODA;66;33;10;6;11;0;0;6;0;66;0;FEBRUARI
765;SULAWESI BARAT;MAMUJU;TAPALANG;KOPEANG;71;41;22;0;8;0;0;0;0;71;0;FEBRUARI
766;SULAWESI BARAT;MAMUJU;MAMUJU;BINANGA;781;455;159;16;69;52;1;16;4;772;9;FEBRUARI
767;SULAWESI BARAT;MAMUJU;MAMUJU;MAMUNYU;628;323;171;40;47;28;1;14;0;624;4;FEBRUARI
768;SULAWESI BARAT;MAMUJU;MAMUJU;KAREMA;859;448;123;39;95;61;2;30;0;798;61;FEBRUARI
769;SULAWESI BARAT;MAMUJU;MAMUJU;RIMUKU;708;309;160;36;51;73;2;30;1;662;46;FEBRUARI
770;SULAWESI BARAT;MAMUJU;MAMUJU;BAMBU;398;235;78;14;51;5;0;15;0;398;0;FEBRUARI
771;SULAWESI BARAT;MAMUJU;MAMUJU;KARAMPUANG;468;351;60;1;28;11;0;14;0;465;3;FEBRUARI
772;SULAWESI BARAT;MAMUJU;MAMUJU;TADUI;494;167;215;1;56;6;0;28;3;476;18;FEBRUARI
773;SULAWESI BARAT;MAMUJU;MAMUJU;BATU PANNU;188;134;34;0;14;3;0;3;0;188;0;FEBRUARI
774;SULAWESI BARAT;MAMASA;BALLA;BALLA;166;19;27;1;92;13;0;12;1;165;1;FEBRUARI
775;SULAWESI BARAT;MAMASA;BALLA;BALLA BARAT;91;45;13;0;32;0;0;1;0;91;0;FEBRUARI
776;SULAWESI BARAT;MAMASA;BALLA;BALLA SATANETEAN;149;57;14;4;62;9;0;3;0;149;0;FEBRUARI
777;SULAWESI BARAT;MAMASA;BALLA;BALLA TUMUKA;111;38;27;1;43;1;0;1;0;111;0;FEBRUARI
778;SULAWESI BARAT;MAMASA;BALLA;SEPAKUAN;155;55;13;0;84;1;0;2;0;155;0;FEBRUARI
779;SULAWESI BARAT;MAMASA;BALLA;PIDARA;62;21;10;0;29;1;0;1;0;62;0;FEBRUARI
780;SULAWESI BARAT;MAMASA;BALLA;BAMBAPUANG;64;27;16;0;21;0;0;0;0;64;0;FEBRUARI
781;SULAWESI BARAT;MAMASA;BALLA;BALLA TIMUR;37;7;2;0;24;1;0;3;0;37;0;FEBRUARI
782;SULAWESI BARAT;MAMASA;BAMBANG;MOKALLANG;43;18;21;0;3;0;0;1;0;43;0;FEBRUARI
783;SULAWESI BARAT;MAMASA;BAMBANG;MASOSO;45;18;14;0;13;0;0;0;0;45;0;FEBRUARI
784;SULAWESI BARAT;MAMASA;BAMBANG;SALUASSING;124;90;21;4;8;0;0;1;0;124;0;FEBRUARI
785;SULAWESI BARAT;MAMASA;BAMBANG;SALUBULO;64;26;19;0;14;1;0;0;0;60;4;FEBRUARI
786;SULAWESI BARAT;MAMASA;BAMBANG;SALUKADI;78;33;37;0;8;0;0;0;0;78;0;FEBRUARI
787;SULAWESI BARAT;MAMASA;BAMBANG;SALUKEPOPOK;115;55;21;9;28;1;0;0;0;114;1;FEBRUARI
788;SULAWESI BARAT;MAMASA;BAMBANG;ULUMAMBI BARAT;61;26;35;0;0;0;0;0;0;61;0;FEBRUARI
789;SULAWESI BARAT;MAMASA;BAMBANG;LIMBADEBATA;105;35;12;0;54;1;0;3;0;105;0;FEBRUARI
790;SULAWESI BARAT;MAMASA;BAMBANG;TANETE TOMBA;56;26;27;0;3;0;0;0;0;56;0;FEBRUARI
791;SULAWESI BARAT;MAMASA;BAMBANG;BAMBANG;133;85;17;0;24;3;0;3;0;132;1;FEBRUARI
792;SULAWESI BARAT;MAMASA;BAMBANG;RANTELEMO;51;12;22;0;15;2;0;0;0;51;0;FEBRUARI
793;SULAWESI BARAT;MAMASA;BAMBANG;SALUDENGEN;37;10;21;0;2;1;0;0;0;34;3;FEBRUARI
794;SULAWESI BARAT;MAMASA;BAMBANG;ULUMAMBI;62;10;44;1;0;0;0;0;0;55;7;FEBRUARI
795;SULAWESI BARAT;MAMASA;BAMBANG;BAMBANG TIMUR;63;38;21;0;2;1;0;1;0;63;0;FEBRUARI
796;SULAWESI BARAT;MAMASA;BAMBANG;MINANGA;134;50;39;0;40;0;0;4;0;133;1;FEBRUARI
797;SULAWESI BARAT;MAMASA;BAMBANG;SIKAMASE;57;20;36;0;1;0;0;0;0;57;0;FEBRUARI
798;SULAWESI BARAT;MAMASA;BAMBANG;RANTETARIMA;30;3;27;0;0;0;0;0;0;30;0;FEBRUARI
799;SULAWESI BARAT;MAMASA;BAMBANG;SALURURU;31;4;1;3;22;0;0;1;0;31;0;FEBRUARI
800;SULAWESI BARAT;MAMASA;BAMBANG;SALUTABANG;34;18;10;1;2;2;0;1;0;34;0;FEBRUARI
801;SULAWESI BARAT;MAMASA;BAMBANG;BALATANA;53;37;16;0;0;0;0;0;0;53;0;FEBRUARI
802;SULAWESI BARAT;MAMUJU;KALUKKU;SINYONYOI;445;234;127;11;47;4;0;11;0;434;11;FEBRUARI
803;SULAWESI BARAT;MAMUJU;KALUKKU;BEBANGA;755;454;199;4;66;5;2;22;0;752;3;FEBRUARI
804;SULAWESI BARAT;MAMUJU;KALUKKU;KALUKKU;680;227;181;8;188;24;1;29;0;658;22;FEBRUARI
805;SULAWESI BARAT;MAMUJU;KALUKKU;SINYONYOI SELATAN;261;124;72;5;33;3;0;19;0;256;5;FEBRUARI
806;SULAWESI BARAT;MAMUJU;KALUKKU;SONDOANG;270;120;77;1;65;1;0;4;1;269;1;FEBRUARI
807;SULAWESI BARAT;MAMUJU;KALUKKU;BERU-BERU;552;309;94;2;133;3;0;10;1;552;0;FEBRUARI
808;SULAWESI BARAT;MAMUJU;KALUKKU;BELANG BELANG;378;174;114;2;74;2;0;12;0;378;0;FEBRUARI
809;SULAWESI BARAT;MAMUJU;KALUKKU;KABULOANG;368;146;133;3;74;1;1;7;1;366;2;FEBRUARI
810;SULAWESI BARAT;MAMUJU;KALUKKU;KEANG;234;68;130;1;28;1;0;4;0;232;2;FEBRUARI
811;SULAWESI BARAT;MAMUJU;KALUKKU;POKKANG;193;78;39;2;62;3;1;8;0;193;0;FEBRUARI
812;SULAWESI BARAT;MAMUJU;KALUKKU;GULILING;166;50;81;0;33;0;0;1;0;165;1;FEBRUARI
813;SULAWESI BARAT;MAMUJU;KALUKKU;UHAIMATE;126;83;35;1;7;0;0;0;0;126;0;FEBRUARI
814;SULAWESI BARAT;MAMUJU;KALUKKU;KALUKKU BARAT;479;285;64;1;123;2;0;4;0;479;0;FEBRUARI
815;SULAWESI BARAT;MAMUJU;KALUKKU;PAMMULUKANG;228;115;73;9;18;0;0;11;1;227;1;FEBRUARI
816;SULAWESI BARAT;POLEWALI MANDAR;ALLU;PETOOSANG;78;25;19;7;13;3;0;9;0;76;2;FEBRUARI
817;SULAWESI BARAT;POLEWALI MANDAR;ALLU;MOMBI;135;59;29;4;32;0;4;6;0;134;1;FEBRUARI
818;SULAWESI BARAT;POLEWALI MANDAR;ALLU;KALUMAMMANG;90;27;39;0;18;0;0;6;0;90;0;FEBRUARI
819;SULAWESI BARAT;POLEWALI MANDAR;ALLU;PAO-PAO;199;84;58;1;55;0;0;1;0;199;0;FEBRUARI
820;SULAWESI BARAT;POLEWALI MANDAR;ALLU;PUPPU URING;211;81;84;2;25;0;1;1;1;195;16;FEBRUARI
821;SULAWESI BARAT;POLEWALI MANDAR;ALLU;SARAGIAN;117;64;15;6;23;0;0;8;0;116;1;FEBRUARI
822;SULAWESI BARAT;POLEWALI MANDAR;ALLU;SAYOANG;53;27;18;0;5;1;0;2;0;53;0;FEBRUARI
823;SULAWESI BARAT;POLEWALI MANDAR;ALLU;ALU;123;49;42;9;20;1;0;2;0;123;0;FEBRUARI
824;SULAWESI BARAT;POLEWALI MANDAR;ANREAPI;ANREAPI;178;36;56;10;49;10;0;14;1;176;2;FEBRUARI
825;SULAWESI BARAT;POLEWALI MANDAR;ANREAPI;DUAMPANUA;393;118;147;20;81;5;0;17;0;388;5;FEBRUARI
826;SULAWESI BARAT;POLEWALI MANDAR;ANREAPI;KELAPA DUA;272;72;124;4;53;3;2;13;0;271;1;FEBRUARI
827;SULAWESI BARAT;POLEWALI MANDAR;ANREAPI;PAPPANDANGAN;261;101;74;7;64;2;3;8;0;259;2;FEBRUARI
828;SULAWESI BARAT;POLEWALI MANDAR;ANREAPI;KUNYI;241;36;113;3;67;2;0;10;2;233;8;FEBRUARI
829;SULAWESI BARAT;POLEWALI MANDAR;BALANIPA;BALANIPA;230;103;46;24;38;8;0;11;0;230;0;FEBRUARI
830;SULAWESI BARAT;POLEWALI MANDAR;BALANIPA;TAMMAJARRA;194;126;18;30;13;4;0;3;0;194;0;FEBRUARI
831;SULAWESI BARAT;POLEWALI MANDAR;BALANIPA;TAMANGGALLE;103;54;17;0;29;1;0;1;1;103;0;FEBRUARI
832;SULAWESI BARAT;POLEWALI MANDAR;BALANIPA;MOSSO;83;57;16;7;3;0;0;0;0;83;0;FEBRUARI
833;SULAWESI BARAT;POLEWALI MANDAR;BALANIPA;GALUNG TULUK;209;104;50;22;21;1;0;11;0;209;0;FEBRUARI
834;SULAWESI BARAT;POLEWALI MANDAR;BALANIPA;SABANG SUBIK;255;133;65;21;26;3;0;7;0;255;0;FEBRUARI
835;SULAWESI BARAT;POLEWALI MANDAR;BALANIPA;PAMBUSUANG;421;256;64;12;26;10;0;24;1;393;28;FEBRUARI
836;SULAWESI BARAT;POLEWALI MANDAR;BALANIPA;BALA;324;253;23;3;19;4;0;19;0;321;3;FEBRUARI
837;SULAWESI BARAT;POLEWALI MANDAR;BALANIPA;LAMBANAN;24;7;7;8;2;0;0;0;0;24;0;FEBRUARI
838;SULAWESI BARAT;POLEWALI MANDAR;BALANIPA;LEGO;106;68;25;0;5;0;0;8;0;106;0;FEBRUARI
839;SULAWESI BARAT;POLEWALI MANDAR;BALANIPA;PALLIS;29;13;7;1;5;1;0;2;0;29;0;FEBRUARI
840;SULAWESI BARAT;POLEWALI MANDAR;BINUANG;AMASSANGAN;301;143;56;2;66;2;0;32;0;301;0;FEBRUARI
841;SULAWESI BARAT;POLEWALI MANDAR;BINUANG;TONYAMAN;530;213;180;3;97;13;0;10;1;517;13;FEBRUARI
842;SULAWESI BARAT;POLEWALI MANDAR;BINUANG;KUAJANG;372;179;63;10;106;4;1;9;0;372;0;FEBRUARI
843;SULAWESI BARAT;POLEWALI MANDAR;BINUANG;PAKU;185;86;41;14;31;0;1;11;1;185;0;FEBRUARI
844;SULAWESI BARAT;POLEWALI MANDAR;BINUANG;MIRRING;247;124;44;13;45;1;0;17;0;244;3;FEBRUARI
845;SULAWESI BARAT;POLEWALI MANDAR;BINUANG;BATETANGNGA;693;402;144;11;83;7;0;15;2;664;29;FEBRUARI
846;SULAWESI BARAT;POLEWALI MANDAR;BINUANG;MAMMI;258;87;71;8;81;3;0;7;0;257;1;FEBRUARI
847;SULAWESI BARAT;POLEWALI MANDAR;BINUANG;KALEOK;158;55;70;3;26;0;0;4;0;158;0;FEBRUARI
848;SULAWESI BARAT;POLEWALI MANDAR;BINUANG;AMOLA;164;87;32;5;37;0;1;2;0;164;0;FEBRUARI
849;SULAWESI BARAT;POLEWALI MANDAR;BINUANG;REA;289;116;86;13;48;1;2;17;0;283;6;FEBRUARI
850;SULAWESI BARAT;MAJENE;BANGGAE;BANGGAE;362;96;138;18;62;32;1;15;0;362;0;FEBRUARI
851;SULAWESI BARAT;MAJENE;BANGGAE;BARU;516;152;124;11;191;11;0;27;0;516;0;FEBRUARI
852;SULAWESI BARAT;MAJENE;BANGGAE;PANGALI ALI;879;291;265;14;214;58;2;32;0;876;3;FEBRUARI
853;SULAWESI BARAT;MAJENE;BANGGAE;TOTOLI;437;143;109;15;139;12;1;18;0;437;0;FEBRUARI
854;SULAWESI BARAT;MAJENE;BANGGAE;RANGAS;916;355;345;18;148;33;1;14;2;916;0;FEBRUARI
855;SULAWESI BARAT;MAJENE;BANGGAE;GALUNG;251;51;18;32;81;29;0;38;0;249;2;FEBRUARI
856;SULAWESI BARAT;MAJENE;BANGGAE;PALIPI SOREANG;259;113;51;20;53;11;0;11;0;259;0;FEBRUARI
857;SULAWESI BARAT;MAJENE;BANGGAE;PAMBOBORANG;251;49;82;14;78;5;0;22;0;250;1;FEBRUARI
858;SULAWESI BARAT;MAJENE;PAMBOANG;LALAMPANUA;157;30;30;29;46;10;0;10;1;156;1;FEBRUARI
859;SULAWESI BARAT;MAJENE;PAMBOANG;SIRINDU;143;29;22;1;67;10;0;14;0;143;0;FEBRUARI
860;SULAWESI BARAT;MAJENE;PAMBOANG;ADOLANG;100;22;5;1;63;4;0;5;0;100;0;FEBRUARI
861;SULAWESI BARAT;MAJENE;PAMBOANG;BABABULO;194;98;29;9;48;5;1;4;0;194;0;FEBRUARI
862;SULAWESI BARAT;MAJENE;PAMBOANG;BONDE;252;153;59;2;13;9;0;14;0;250;2;FEBRUARI
863;SULAWESI BARAT;MAJENE;PAMBOANG;BETTENG;107;59;17;2;27;1;0;1;0;107;0;FEBRUARI
864;SULAWESI BARAT;MAJENE;PAMBOANG;SIMBANG;59;14;14;5;21;3;0;2;0;59;0;FEBRUARI
865;SULAWESI BARAT;MAJENE;PAMBOANG;BONDE UTARA;361;234;41;4;40;10;2;15;0;346;15;FEBRUARI
866;SULAWESI BARAT;MAJENE;PAMBOANG;BABABULO UTARA;115;51;28;12;14;3;0;7;0;115;0;FEBRUARI
867;SULAWESI BARAT;MAJENE;PAMBOANG;BUTTU PAMBOANG;108;49;21;3;24;6;0;5;0;108;0;FEBRUARI
868;SULAWESI BARAT;MAJENE;PAMBOANG;BANUA ADOLANG;112;35;38;0;30;6;0;3;0;112;0;FEBRUARI
869;SULAWESI BARAT;MAJENE;PAMBOANG;ADOLANG DHUA;96;38;7;2;41;0;1;5;0;94;2;FEBRUARI
870;SULAWESI BARAT;MAJENE;PAMBOANG;TINAMBUNG;177;40;43;17;48;6;0;23;0;177;0;FEBRUARI
871;SULAWESI BARAT;MAJENE;PAMBOANG;PESULOANG;116;39;16;14;34;1;3;9;0;116;0;FEBRUARI
872;SULAWESI BARAT;MAJENE;PAMBOANG;BALOMBONG;118;34;16;3;55;7;0;3;0;118;0;FEBRUARI
873;SULAWESI BARAT;MAJENE;TUBO SENDANA;ONANG;339;108;62;21;113;8;14;10;0;336;3;FEBRUARI
874;SULAWESI BARAT;MAJENE;TUBO SENDANA;TUBO;93;19;14;36;8;11;1;4;0;93;0;FEBRUARI
875;SULAWESI BARAT;MAJENE;TUBO SENDANA;ONANG UTARA;98;23;24;1;33;11;4;2;0;98;0;FEBRUARI
876;SULAWESI BARAT;MAJENE;TUBO SENDANA;TUBO SELATAN;97;38;16;1;25;11;2;4;0;97;0;FEBRUARI
877;SULAWESI BARAT;MAJENE;TUBO SENDANA;BONDE BONDE;96;21;14;11;23;16;6;5;0;96;0;FEBRUARI
878;SULAWESI BARAT;MAJENE;TUBO SENDANA;TUBO TENGAH;101;25;31;4;14;17;1;9;0;101;0;FEBRUARI
879;SULAWESI BARAT;MAJENE;TUBO SENDANA;TUBO POANG;95;43;28;9;10;1;0;4;0;95;0;FEBRUARI
880;SULAWESI BARAT;MAJENE;ULUMANDA;KABIRAAN;146;95;24;0;24;1;0;2;0;146;0;FEBRUARI
881;SULAWESI BARAT;MAJENE;ULUMANDA;SAMBABO;96;51;19;2;22;0;0;0;0;94;2;FEBRUARI
882;SULAWESI BARAT;MAJENE;ULUMANDA;TANDEALLO;124;63;42;4;7;2;0;5;0;123;1;FEBRUARI
883;SULAWESI BARAT;MAJENE;ULUMANDA;ULUMANDA;158;53;79;3;10;5;1;7;0;158;0;FEBRUARI
884;SULAWESI BARAT;MAJENE;ULUMANDA;SALUTAMBUNG;117;89;15;1;10;0;0;2;0;117;0;FEBRUARI
885;SULAWESI BARAT;MAJENE;ULUMANDA;POPENGA;75;59;16;0;0;0;0;0;0;75;0;FEBRUARI
886;SULAWESI BARAT;MAJENE;ULUMANDA;SULAI;129;56;49;4;16;0;0;3;0;128;1;FEBRUARI
887;SULAWESI BARAT;MAJENE;ULUMANDA;PANGGALO;104;53;36;3;8;2;0;0;0;102;2;FEBRUARI
888;SULAWESI BARAT;MAJENE;BANGGAE TIMUR;BAURUNG;512;225;74;34;157;11;1;8;1;511;1;FEBRUARI
889;SULAWESI BARAT;MAJENE;BANGGAE TIMUR;BARUGA;192;51;26;40;39;14;0;8;0;178;14;FEBRUARI
890;SULAWESI BARAT;MAJENE;BANGGAE TIMUR;BARUGA DHUA;174;63;34;37;36;2;0;1;0;173;1;FEBRUARI
891;SULAWESI BARAT;MAJENE;BANGGAE TIMUR;LABUANG;280;59;56;33;101;17;1;13;0;280;0;FEBRUARI
892;SULAWESI BARAT;MAJENE;BANGGAE TIMUR;TANDE;131;29;39;21;29;4;0;4;0;126;5;FEBRUARI
893;SULAWESI BARAT;MAJENE;BANGGAE TIMUR;LEMBANG;694;285;155;116;103;24;0;11;0;694;0;FEBRUARI
894;SULAWESI BARAT;MAJENE;BANGGAE TIMUR;LABUANG UTARA;316;89;80;20;64;36;1;24;0;314;2;FEBRUARI
895;SULAWESI BARAT;MAJENE;BANGGAE TIMUR;TANDE TIMUR;113;49;9;5;30;9;0;11;0;113;0;FEBRUARI
896;SULAWESI BARAT;MAJENE;BANGGAE TIMUR;BUTTU BARUGA;91;24;19;4;42;0;0;1;0;90;1;FEBRUARI
897;SULAWESI BARAT;MAJENE;SENDANA;MOSSO;331;153;85;4;58;18;1;10;1;330;1;FEBRUARI
898;SULAWESI BARAT;MAJENE;SENDANA;MOSSO DHUA;100;35;21;8;11;11;2;5;0;93;7;FEBRUARI
899;SULAWESI BARAT;MAJENE;SENDANA;TOTOLISI SENDANA;122;42;40;5;17;8;1;7;0;120;2;FEBRUARI
900;SULAWESI BARAT;MAJENE;SENDANA;TALLUBANUA;133;47;30;9;10;19;1;7;0;123;10;FEBRUARI
901;SULAWESI BARAT;MAJENE;SENDANA;LALATEDZONG;100;32;18;7;19;17;0;5;1;99;1;FEBRUARI
902;SULAWESI BARAT;MAJENE;SENDANA;BINANGA;71;32;13;7;10;6;1;2;0;71;0;FEBRUARI
903;SULAWESI BARAT;MAJENE;SENDANA;PUTTADA;78;43;22;0;10;1;1;1;0;78;0;FEBRUARI
904;SULAWESI BARAT;MAJENE;SENDANA;PAMINGGALAN;48;37;11;0;0;0;0;0;0;48;0;FEBRUARI
905;SULAWESI BARAT;MAJENE;SENDANA;LEPPANGANG;64;33;18;0;7;2;0;4;0;64;0;FEBRUARI
906;SULAWESI BARAT;MAJENE;SENDANA;PUNDAU;66;6;26;6;21;5;0;2;0;66;0;FEBRUARI
907;SULAWESI BARAT;MAJENE;SENDANA;SENDANA;80;38;26;1;0;7;1;7;0;80;0;FEBRUARI
908;SULAWESI BARAT;MAJENE;SENDANA;BANUA SENDANA;103;64;10;4;1;19;0;5;0;103;0;FEBRUARI
909;SULAWESI BARAT;MAJENE;SENDANA;TALLUBANUA UTARA;167;76;51;3;7;26;0;4;0;167;0;FEBRUARI
910;SULAWESI BARAT;MAJENE;SENDANA;LIMBORO RAMBU-RAMBU;99;23;33;3;34;4;0;0;0;97;2;FEBRUARI
911;SULAWESI BARAT;MAJENE;SENDANA;LIMBUA;95;36;21;2;20;13;0;3;0;95;0;FEBRUARI
912;SULAWESI BARAT;MAJENE;SENDANA;BUKIT SAMANG;124;37;25;9;24;19;4;6;0;124;0;FEBRUARI
913;SULAWESI BARAT;POLEWALI MANDAR;LUYO;BATUPANGA;231;111;39;4;63;2;1;7;0;227;4;FEBRUARI
914;SULAWESI BARAT;POLEWALI MANDAR;LUYO;MAMBU;211;106;28;2;50;3;1;13;2;205;6;FEBRUARI
915;SULAWESI BARAT;POLEWALI MANDAR;LUYO;TENGGELANG;289;145;59;17;48;0;1;8;0;278;11;FEBRUARI
916;SULAWESI BARAT;POLEWALI MANDAR;LUYO;BARU;305;90;91;41;45;7;0;20;0;294;11;FEBRUARI
917;SULAWESI BARAT;POLEWALI MANDAR;LUYO;PUSSUI;177;97;30;2;40;0;1;5;1;176;1;FEBRUARI
918;SULAWESI BARAT;POLEWALI MANDAR;LUYO;MAPILI BARAT;199;119;38;11;21;0;0;10;0;199;0;FEBRUARI
919;SULAWESI BARAT;POLEWALI MANDAR;LUYO;SAMBALI WALI;260;154;40;14;38;1;0;2;0;249;11;FEBRUARI
920;SULAWESI BARAT;POLEWALI MANDAR;LUYO;BATUPANGA DAALA;317;151;48;3;108;0;1;5;0;316;1;FEBRUARI
921;SULAWESI BARAT;POLEWALI MANDAR;LUYO;LUYO;207;125;20;0;44;2;3;12;0;206;1;FEBRUARI
922;SULAWESI BARAT;POLEWALI MANDAR;LUYO;PUSSUI BARAT;106;50;11;3;24;13;1;3;0;105;1;FEBRUARI
923;SULAWESI BARAT;POLEWALI MANDAR;LUYO;PUCCADI;208;152;20;0;29;2;0;5;0;208;0;FEBRUARI
924;SULAWESI BARAT;MAMUJU;TOMMO;TOMMO;351;132;83;0;122;5;0;9;0;351;0;FEBRUARI
925;SULAWESI BARAT;MAMUJU;TOMMO;CAMPALOGA;306;91;131;10;63;7;0;0;0;302;4;FEBRUARI
926;SULAWESI BARAT;MAMUJU;TOMMO;BUANA SAKTI;217;82;49;1;84;1;0;0;0;217;0;FEBRUARI
927;SULAWESI BARAT;MAMUJU;TOMMO;TAMEMONGGA;242;89;114;0;35;1;0;3;0;242;0;FEBRUARI
928;SULAWESI BARAT;MAMUJU;TOMMO;TAMEJARRA;191;70;46;5;52;6;1;11;0;191;0;FEBRUARI
929;SULAWESI BARAT;MAMUJU;TOMMO;RANTEMARIO;165;65;69;3;17;6;0;5;0;165;0;FEBRUARI
930;SULAWESI BARAT;MAMUJU;TOMMO;MALINO;76;40;19;8;5;1;0;2;0;75;1;FEBRUARI
931;SULAWESI BARAT;MAMUJU;TOMMO;KAKULLASANG;370;155;146;7;50;1;0;6;0;365;5;FEBRUARI
932;SULAWESI BARAT;MAMUJU;TOMMO;LELING;134;40;65;0;28;0;0;1;0;134;0;FEBRUARI
933;SULAWESI BARAT;MAMUJU;TOMMO;KALEPU;101;54;41;1;4;1;0;0;0;101;0;FEBRUARI
934;SULAWESI BARAT;MAMUJU;TOMMO;SANDANA;136;53;52;1;18;2;0;9;1;136;0;FEBRUARI
935;SULAWESI BARAT;MAMUJU;TOMMO;LELING BARAT;225;71;92;3;49;6;0;3;0;224;1;FEBRUARI
936;SULAWESI BARAT;MAMUJU;TOMMO;LELING UTARA;200;82;92;0;26;0;0;0;0;200;0;FEBRUARI
937;SULAWESI BARAT;MAMUJU;TOMMO;SALUDENGEN;133;68;58;1;6;0;0;0;0;133;0;FEBRUARI
938;SULAWESI BARAT;MAJENE;MALUNDA;MALUNDA;142;47;40;15;21;11;3;5;0;142;0;FEBRUARI
939;SULAWESI BARAT;MAJENE;MALUNDA;LAMUNGANG BATU;137;47;50;2;21;5;0;11;0;136;1;FEBRUARI
940;SULAWESI BARAT;MAJENE;MALUNDA;BAMBANGAN;165;87;47;2;26;2;0;1;0;165;0;FEBRUARI
941;SULAWESI BARAT;MAJENE;MALUNDA;LOMBANG;103;48;28;2;21;2;0;2;0;103;0;FEBRUARI
942;SULAWESI BARAT;MAJENE;MALUNDA;LOMBONG;230;68;101;7;29;5;0;19;0;229;1;FEBRUARI
943;SULAWESI BARAT;MAJENE;MALUNDA;MEKKATTA;202;102;25;6;55;2;0;6;0;196;6;FEBRUARI
944;SULAWESI BARAT;MAJENE;MALUNDA;MALIAYA;168;77;35;9;39;2;0;6;0;168;0;FEBRUARI
945;SULAWESI BARAT;MAJENE;MALUNDA;LOMBANG TIMUR;160;99;54;1;5;1;0;0;0;160;0;FEBRUARI
946;SULAWESI BARAT;MAJENE;MALUNDA;SALUTAHONGAN;98;59;28;0;8;1;0;1;0;97;1;FEBRUARI
947;SULAWESI BARAT;MAJENE;MALUNDA;LOMBONG TIMUR;96;19;28;7;4;19;0;19;0;96;0;FEBRUARI
948;SULAWESI BARAT;MAJENE;MALUNDA;MEKKATTA SELATAN;129;47;29;5;34;6;0;6;2;129;0;FEBRUARI
949;SULAWESI BARAT;MAJENE;MALUNDA;KAYUANGIN;190;88;43;15;15;12;0;13;0;186;4;FEBRUARI
950;SULAWESI BARAT;POLEWALI MANDAR;CAMPALAGIAN;PAPPANG;148;83;14;9;7;7;0;13;1;134;14;FEBRUARI
951;SULAWESI BARAT;POLEWALI MANDAR;CAMPALAGIAN;LALIKO;176;113;35;2;6;3;0;17;0;176;0;FEBRUARI
952;SULAWESI BARAT;POLEWALI MANDAR;CAMPALAGIAN;BONDE;177;101;37;5;12;10;0;12;0;177;0;FEBRUARI
953;SULAWESI BARAT;POLEWALI MANDAR;CAMPALAGIAN;KATUMBANGAN LEMO;149;90;25;14;14;4;0;2;0;149;0;FEBRUARI
954;SULAWESI BARAT;POLEWALI MANDAR;CAMPALAGIAN;PANYAMPA;198;130;43;2;7;3;0;10;2;197;1;FEBRUARI
955;SULAWESI BARAT;POLEWALI MANDAR;CAMPALAGIAN;SURUANG;159;86;42;10;8;1;0;7;0;154;5;FEBRUARI
956;SULAWESI BARAT;POLEWALI MANDAR;CAMPALAGIAN;LAMPOKO;229;146;55;11;9;2;0;6;0;229;0;FEBRUARI
957;SULAWESI BARAT;POLEWALI MANDAR;CAMPALAGIAN;KATUMBANGAN;287;124;39;5;65;40;0;14;0;287;0;FEBRUARI
958;SULAWESI BARAT;POLEWALI MANDAR;CAMPALAGIAN;LAPEO;124;69;16;7;17;3;0;11;0;123;1;FEBRUARI
959;SULAWESI BARAT;POLEWALI MANDAR;CAMPALAGIAN;PARAPPE;221;135;44;2;34;3;0;1;0;219;2;FEBRUARI
960;SULAWESI BARAT;POLEWALI MANDAR;CAMPALAGIAN;ONGKO;117;44;21;13;31;5;0;3;0;117;0;FEBRUARI
961;SULAWESI BARAT;POLEWALI MANDAR;CAMPALAGIAN;KENJE;150;106;11;7;17;3;0;6;0;150;0;FEBRUARI
962;SULAWESI BARAT;POLEWALI MANDAR;CAMPALAGIAN;SUMARRANG;435;241;124;4;60;6;0;0;0;435;0;FEBRUARI
963;SULAWESI BARAT;POLEWALI MANDAR;CAMPALAGIAN;BOTTO;258;129;62;0;55;3;0;7;0;256;2;FEBRUARI
964;SULAWESI BARAT;POLEWALI MANDAR;CAMPALAGIAN;GATTUNGAN;175;59;23;23;45;16;0;8;0;174;1;FEBRUARI
965;SULAWESI BARAT;POLEWALI MANDAR;CAMPALAGIAN;PADANG TIMUR;127;59;19;3;39;2;0;5;0;127;0;FEBRUARI
966;SULAWESI BARAT;POLEWALI MANDAR;CAMPALAGIAN;PADANG;63;36;7;3;12;0;0;0;0;58;5;FEBRUARI
967;SULAWESI BARAT;POLEWALI MANDAR;CAMPALAGIAN;LAGI-AGI;238;176;28;6;19;3;0;6;0;238;0;FEBRUARI
968;SULAWESI BARAT;POLEWALI MANDAR;BULO;BULO;110;22;11;4;71;2;0;0;0;110;0;FEBRUARI
969;SULAWESI BARAT;POLEWALI MANDAR;BULO;PULLIWA;307;105;48;3;136;3;0;11;0;306;1;FEBRUARI
970;SULAWESI BARAT;POLEWALI MANDAR;BULO;PATAMBANUA;145;32;99;0;11;0;0;1;0;143;2;FEBRUARI
971;SULAWESI BARAT;POLEWALI MANDAR;BULO;KAROMBANG;138;79;23;0;33;2;0;1;0;138;0;FEBRUARI
972;SULAWESI BARAT;POLEWALI MANDAR;BULO;DAALA TIMUR;125;43;64;2;15;0;0;1;0;125;0;FEBRUARI
973;SULAWESI BARAT;POLEWALI MANDAR;BULO;LENGGO;61;17;37;2;3;1;0;1;0;61;0;FEBRUARI
974;SULAWESI BARAT;POLEWALI MANDAR;BULO;SABURA;70;27;30;0;12;0;0;1;0;70;0;FEBRUARI
975;SULAWESI BARAT;POLEWALI MANDAR;BULO;SEPPORRAKI;105;26;25;0;52;0;0;2;0;105;0;FEBRUARI
976;SULAWESI BARAT;POLEWALI MANDAR;BULO;IHING;105;21;24;1;54;1;0;1;0;102;3;FEBRUARI
977;SULAWESI BARAT;MAMUJU;TAPALANG BARAT;DUNGKAIT;246;105;94;5;34;3;1;2;0;244;2;FEBRUARI
978;SULAWESI BARAT;MAMUJU;TAPALANG BARAT;LEBANI;114;40;49;0;8;0;0;5;2;104;10;FEBRUARI
979;SULAWESI BARAT;MAMUJU;TAPALANG BARAT;LABUANG RANO;223;113;83;0;10;4;0;2;0;212;11;FEBRUARI
980;SULAWESI BARAT;MAMUJU;TAPALANG BARAT;PASABU;166;49;69;7;15;8;0;12;2;162;4;FEBRUARI
981;SULAWESI BARAT;MAMUJU;TAPALANG BARAT;TANETE PAO;43;31;10;0;1;0;0;0;0;42;1;FEBRUARI
982;SULAWESI BARAT;MAMUJU;TAPALANG BARAT;PANGASAAN;59;24;23;2;7;2;0;0;0;58;1;FEBRUARI
983;SULAWESI BARAT;MAMUJU;TAPALANG BARAT;AHU;172;92;60;2;8;0;0;2;0;164;8;FEBRUARI
984;SULAWESI BARAT;MAMUJU;KALUMPANG;KALUMPANG;52;26;14;0;6;0;0;2;0;48;4;FEBRUARI
985;SULAWESI BARAT;MAMUJU;KALUMPANG;KARATAUN;177;112;27;0;35;0;0;1;0;175;2;FEBRUARI
986;SULAWESI BARAT;MAMUJU;KALUMPANG;KARAMA;122;52;48;0;21;0;0;1;0;122;0;FEBRUARI
987;SULAWESI BARAT;MAMUJU;KALUMPANG;SIRAUN;103;60;23;0;18;0;0;0;1;102;1;FEBRUARI
988;SULAWESI BARAT;MAMUJU;KALUMPANG;TUMOGA;76;35;13;0;20;0;0;0;0;68;8;FEBRUARI
989;SULAWESI BARAT;MAMUJU;KALUMPANG;SALUMAKKI;98;68;18;0;10;0;0;0;0;96;2;FEBRUARI
990;SULAWESI BARAT;MAMUJU;KALUMPANG;POLIO;62;30;24;0;7;0;0;0;1;62;0;FEBRUARI
991;SULAWESI BARAT;MAMUJU;KALUMPANG;LIMBONG;92;26;15;0;49;1;0;1;0;92;0;FEBRUARI
992;SULAWESI BARAT;MAMUJU;KALUMPANG;SANDAPANG;93;27;4;0;61;0;0;0;0;92;1;FEBRUARI
993;SULAWESI BARAT;MAMUJU;KALUMPANG;KONDO BULO;88;54;25;0;7;0;0;1;0;87;1;FEBRUARI
994;SULAWESI BARAT;MAMUJU;KALUMPANG;MAKKALIKI;69;34;18;0;17;0;0;0;0;69;0;FEBRUARI
995;SULAWESI BARAT;MAMUJU;KALUMPANG;BATU MAKKADA;83;37;38;0;7;0;0;0;0;82;1;FEBRUARI
996;SULAWESI BARAT;MAMUJU;KALUMPANG;LASA';117;74;26;0;13;0;0;0;1;114;3;FEBRUARI
997;SULAWESI BARAT;MAMASA;ARALLE;ARALLE;112;40;60;2;6;1;0;3;0;112;0;FEBRUARI
998;SULAWESI BARAT;MAMASA;ARALLE;RALLE ANAK;37;8;21;0;6;0;0;2;0;37;0;FEBRUARI
999;SULAWESI BARAT;MAMASA;ARALLE;PANETEAN;73;57;16;0;0;0;0;0;0;73;0;FEBRUARI
1000;SULAWESI BARAT;MAMASA;ARALLE;UHAILANU;74;26;28;0;11;3;0;5;0;73;1;FEBRUARI
1001;SULAWESI BARAT;MAMASA;ARALLE;ARALLE UTARA;68;29;38;0;1;0;0;0;0;68;0;FEBRUARI
1002;SULAWESI BARAT;MAMASA;ARALLE;UHAIDAHO;52;12;33;3;4;0;0;0;0;52;0;FEBRUARI
1003;SULAWESI BARAT;MAMASA;ARALLE;BARURU;91;64;25;0;1;0;0;0;1;91;0;FEBRUARI
1004;SULAWESI BARAT;MAMASA;ARALLE;RALLEANAK UTARA;41;20;16;0;4;0;0;1;0;41;0;FEBRUARI
1005;SULAWESI BARAT;MAMASA;ARALLE;PAMOSEANG PANGGA;36;12;21;2;1;0;0;0;0;36;0;FEBRUARI
1006;SULAWESI BARAT;MAMASA;ARALLE;KALABE;63;22;39;0;2;0;0;0;0;63;0;FEBRUARI
1007;SULAWESI BARAT;MAMASA;ARALLE;ARALLE SELATAN;29;10;17;0;1;0;0;1;0;29;0;FEBRUARI
1008;SULAWESI BARAT;MAMASA;ARALLE;HAHANGAN;35;16;13;0;6;0;0;0;0;35;0;FEBRUARI
1009;SULAWESI BARAT;POLEWALI MANDAR;WONOMULYO;SIDODADI;395;200;89;3;57;29;0;14;1;393;2;FEBRUARI
1010;SULAWESI BARAT;POLEWALI MANDAR;WONOMULYO;SIDOREJO;342;178;76;12;41;13;0;19;0;339;3;FEBRUARI
1011;SULAWESI BARAT;POLEWALI MANDAR;WONOMULYO;SUMBEREJO;562;276;96;30;104;41;0;7;1;555;7;FEBRUARI
1012;SULAWESI BARAT;POLEWALI MANDAR;WONOMULYO;BUMIAYU;402;177;69;9;50;52;0;18;0;375;27;FEBRUARI
1013;SULAWESI BARAT;POLEWALI MANDAR;WONOMULYO;KEBUNSARI;300;115;56;11;44;46;1;11;0;284;16;FEBRUARI
1014;SULAWESI BARAT;POLEWALI MANDAR;WONOMULYO;BANUA BARU;197;111;30;7;21;14;0;7;0;190;7;FEBRUARI
1015;SULAWESI BARAT;POLEWALI MANDAR;WONOMULYO;NEPO;268;155;51;5;40;9;1;5;0;266;2;FEBRUARI
1016;SULAWESI BARAT;POLEWALI MANDAR;WONOMULYO;SUGIHWARAS;573;274;142;22;80;32;0;11;0;561;12;FEBRUARI
1017;SULAWESI BARAT;POLEWALI MANDAR;WONOMULYO;CAMPURJO;234;112;42;6;37;19;0;17;0;233;1;FEBRUARI
1018;SULAWESI BARAT;POLEWALI MANDAR;WONOMULYO;BUMIMULYO;223;112;53;1;39;13;0;3;0;221;2;FEBRUARI
1019;SULAWESI BARAT;POLEWALI MANDAR;WONOMULYO;TUMPILING;244;127;54;5;36;2;0;9;0;233;11;FEBRUARI
1020;SULAWESI BARAT;POLEWALI MANDAR;WONOMULYO;BAKKA-BAKKA;196;110;40;5;30;3;0;5;0;193;3;FEBRUARI
1021;SULAWESI BARAT;POLEWALI MANDAR;WONOMULYO;ARJO SARI;279;150;84;8;11;14;0;6;0;273;6;FEBRUARI
1022;SULAWESI BARAT;POLEWALI MANDAR;WONOMULYO;GALESON;306;198;45;6;37;8;0;7;0;301;5;FEBRUARI
1023;SULAWESI BARAT;POLEWALI MANDAR;TUTAR;TARAMANU;198;88;34;5;47;1;13;10;0;198;0;FEBRUARI
1024;SULAWESI BARAT;POLEWALI MANDAR;TUTAR;AMBOPADANG;268;106;51;1;107;2;0;1;0;268;0;FEBRUARI
1025;SULAWESI BARAT;POLEWALI MANDAR;TUTAR;TUBBI;132;39;71;4;8;2;0;8;0;132;0;FEBRUARI
1026;SULAWESI BARAT;POLEWALI MANDAR;TUTAR;RATTE;177;52;73;3;46;1;1;0;1;177;0;FEBRUARI
1027;SULAWESI BARAT;POLEWALI MANDAR;TUTAR;BESOANGIN;123;70;8;2;43;0;0;0;0;123;0;FEBRUARI
1028;SULAWESI BARAT;POLEWALI MANDAR;TUTAR;PIRIANG TAPIKO;109;35;47;0;25;0;0;2;0;109;0;FEBRUARI
1029;SULAWESI BARAT;POLEWALI MANDAR;TUTAR;PEBURRU;182;92;52;3;28;2;0;5;0;182;0;FEBRUARI
1030;SULAWESI BARAT;POLEWALI MANDAR;TUTAR;TALOBA;96;40;36;0;16;0;0;3;0;95;1;FEBRUARI
1031;SULAWESI BARAT;POLEWALI MANDAR;TUTAR;POLLEWANI;270;140;92;5;30;0;0;3;0;270;0;FEBRUARI
1032;SULAWESI BARAT;POLEWALI MANDAR;TUTAR;ARABUA;140;76;32;0;14;0;16;2;0;140;0;FEBRUARI
1033;SULAWESI BARAT;POLEWALI MANDAR;TUTAR;BESOANGIN UTARA;104;53;14;4;33;0;0;0;0;104;0;FEBRUARI
1034;SULAWESI BARAT;POLEWALI MANDAR;TUTAR;PODA;123;54;48;4;13;0;1;3;0;123;0;FEBRUARI
1035;SULAWESI BARAT;POLEWALI MANDAR;TUTAR;TARAMANU TUA;167;35;49;2;71;3;0;4;0;164;3;FEBRUARI
1036;SULAWESI BARAT;MAMUJU;BONEHAU;BONEHAU;165;51;77;4;23;1;0;3;0;159;6;FEBRUARI
1037;SULAWESI BARAT;MAMUJU;BONEHAU;SALUTIWO;86;30;34;1;21;0;0;0;0;86;0;FEBRUARI
1038;SULAWESI BARAT;MAMUJU;BONEHAU;BUTTUADA;212;12;172;3;20;1;0;2;0;210;2;FEBRUARI
1039;SULAWESI BARAT;MAMUJU;BONEHAU;TAMALEA;45;6;29;0;9;0;0;1;0;45;0;FEBRUARI
1040;SULAWESI BARAT;MAMUJU;BONEHAU;LUMIKA;134;48;55;2;28;1;0;0;0;134;0;FEBRUARI
1041;SULAWESI BARAT;MAMUJU;BONEHAU;MAPPU;72;15;42;1;13;0;0;1;0;72;0;FEBRUARI
1042;SULAWESI BARAT;MAMUJU;BONEHAU;BANUADA;100;11;82;4;2;0;0;1;0;100;0;FEBRUARI
1043;SULAWESI BARAT;MAMUJU;BONEHAU;HINUA;104;27;31;7;33;1;0;3;0;102;2;FEBRUARI
1044;SULAWESI BARAT;MAMUJU;BONEHAU;KINATANG;114;22;89;1;0;0;0;2;0;114;0;FEBRUARI
1045;SULAWESI BARAT;PASANGKAYU;DURIPOKU;TAMMARUNANG;223;88;45;15;56;6;0;13;0;223;0;FEBRUARI
1046;SULAWESI BARAT;PASANGKAYU;DURIPOKU;SAPTANAJAYA;202;109;40;1;38;9;0;5;0;202;0;FEBRUARI
1047;SULAWESI BARAT;PASANGKAYU;DURIPOKU;TARANGGI;96;17;21;5;43;8;0;2;0;96;0;FEBRUARI
1048;SULAWESI BARAT;PASANGKAYU;DURIPOKU;SIPAKAINGA;76;38;23;1;11;2;0;1;0;76;0;FEBRUARI
1049;SULAWESI BARAT;MAMASA;RANTEBULAHAN TIMUR;SALUMOKANAN;95;41;18;0;29;6;0;1;0;95;0;FEBRUARI
1050;SULAWESI BARAT;MAMASA;RANTEBULAHAN TIMUR;SALUMOKANAN BARAT;109;44;25;0;37;0;0;0;1;107;2;FEBRUARI
1051;SULAWESI BARAT;MAMASA;RANTEBULAHAN TIMUR;BUANGIN;94;63;17;0;13;0;0;0;0;93;1;FEBRUARI
1052;SULAWESI BARAT;MAMASA;RANTEBULAHAN TIMUR;BAMBANG BUDA;121;33;65;0;21;1;0;1;0;121;0;FEBRUARI
1053;SULAWESI BARAT;MAMASA;RANTEBULAHAN TIMUR;LEKO;22;5;12;0;5;0;0;0;0;22;0;FEBRUARI
1054;SULAWESI BARAT;MAMASA;RANTEBULAHAN TIMUR;KIRAK;72;44;22;0;6;0;0;0;0;72;0;FEBRUARI
1055;SULAWESI BARAT;MAMASA;RANTEBULAHAN TIMUR;SALUMOKANAN UTARA;110;66;7;0;35;1;0;1;0;110;0;FEBRUARI
1056;SULAWESI BARAT;MAMASA;RANTEBULAHAN TIMUR;SAMPALE;55;15;15;0;25;0;0;0;0;55;0;FEBRUARI
1057;SULAWESI BARAT;PASANGKAYU;PASANGKAYU;PASANGKAYU;1551;661;408;30;148;227;24;48;0;1546;5;FEBRUARI
1058;SULAWESI BARAT;PASANGKAYU;PASANGKAYU;MARTAJAYA;187;65;36;2;43;27;0;14;0;187;0;FEBRUARI
1059;SULAWESI BARAT;PASANGKAYU;PASANGKAYU;PAKAVA;399;219;106;4;64;4;0;2;0;399;0;FEBRUARI
1060;SULAWESI BARAT;PASANGKAYU;PASANGKAYU;KARYA BERSAMA;327;169;46;4;78;20;0;10;0;327;0;FEBRUARI
1061;SULAWESI BARAT;PASANGKAYU;PASANGKAYU;AKO;432;204;78;7;80;39;0;13;0;421;11;FEBRUARI
1062;SULAWESI BARAT;PASANGKAYU;PASANGKAYU;GUNUNG SARI;586;339;82;4;106;21;0;26;0;578;8;FEBRUARI
1063;SULAWESI BARAT;MAMASA;TABANG;TABANG;75;28;12;2;6;26;0;1;0;75;0;FEBRUARI
1064;SULAWESI BARAT;MAMASA;TABANG;TADOKALUA;95;34;27;1;24;1;0;3;0;90;5;FEBRUARI
1065;SULAWESI BARAT;MAMASA;TABANG;TABANG BARAT;157;69;44;1;40;2;0;0;1;157;0;FEBRUARI
1066;SULAWESI BARAT;MAMASA;TABANG;MASUPU;79;8;65;1;4;0;0;0;1;79;0;FEBRUARI
1067;SULAWESI BARAT;MAMASA;TABANG;KALAMA;69;10;24;0;21;3;0;1;0;59;10;FEBRUARI
1068;SULAWESI BARAT;MAMASA;TABANG;BAKADISURA;88;19;55;0;12;1;0;1;0;88;0;FEBRUARI
1069;SULAWESI BARAT;MAMASA;TABANG;SALUKONA;97;45;45;0;7;0;0;0;0;97;0;FEBRUARI
1070;SULAWESI BARAT;MAMASA;SUMARORONG;SUMARORONG;147;51;41;5;31;6;0;11;0;145;2;FEBRUARI
1071;SULAWESI BARAT;MAMASA;SUMARORONG;TABONE;92;22;36;0;33;0;0;1;0;92;0;FEBRUARI
1072;SULAWESI BARAT;MAMASA;SUMARORONG;BATANG URU;93;38;39;0;13;2;0;1;0;93;0;FEBRUARI
1073;SULAWESI BARAT;MAMASA;SUMARORONG;SASAKAN;157;52;84;1;12;7;0;0;0;156;1;FEBRUARI
1074;SULAWESI BARAT;MAMASA;SUMARORONG;TADISI;51;12;33;0;6;0;0;0;0;51;0;FEBRUARI
1075;SULAWESI BARAT;MAMASA;SUMARORONG;SIBANAWA;93;28;46;0;18;0;0;1;0;93;0;FEBRUARI
1076;SULAWESI BARAT;MAMASA;SUMARORONG;BATANGNGURU TIMUR;101;26;68;1;6;0;0;0;0;101;0;FEBRUARI
1077;SULAWESI BARAT;MAMASA;SUMARORONG;SALUBALO;121;61;39;0;19;0;0;2;0;121;0;FEBRUARI
1078;SULAWESI BARAT;MAMASA;SUMARORONG;BANEA;65;28;26;0;9;1;0;1;0;65;0;FEBRUARI
1079;SULAWESI BARAT;MAMASA;SUMARORONG;RANTE KAMASE;165;84;25;3;39;5;0;8;0;164;1;FEBRUARI
1080;SULAWESI BARAT;MAMASA;PANA;PANA;59;13;38;2;5;1;0;0;0;59;0;FEBRUARI
1081;SULAWESI BARAT;MAMASA;PANA;MANIPI;122;62;47;3;7;1;0;1;0;121;1;FEBRUARI
1082;SULAWESI BARAT;MAMASA;PANA;MAMULLU;63;13;38;0;10;1;0;1;0;63;0;FEBRUARI
1083;SULAWESI BARAT;MAMASA;PANA;SAPAN;55;18;12;0;25;0;0;0;0;55;0;FEBRUARI
1084;SULAWESI BARAT;MAMASA;PANA;DATUBARINGAN;79;27;39;1;11;0;0;1;0;79;0;FEBRUARI
1085;SULAWESI BARAT;MAMASA;PANA;PANURA;61;13;43;0;5;0;0;0;0;61;0;FEBRUARI
1086;SULAWESI BARAT;MAMASA;PANA;TALLANG BULAWAN;72;21;39;4;7;0;0;1;0;72;0;FEBRUARI
1087;SULAWESI BARAT;MAMASA;PANA;KARAKA;56;23;26;0;6;0;0;1;0;56;0;FEBRUARI
1088;SULAWESI BARAT;MAMASA;PANA;ULUSALU;49;4;44;0;0;1;0;0;0;49;0;FEBRUARI
1089;SULAWESI BARAT;MAMASA;PANA;WERI;51;7;36;2;4;1;0;1;0;51;0;FEBRUARI
1090;SULAWESI BARAT;MAMASA;PANA;SALUTAMBUN;45;1;44;0;0;0;0;0;0;45;0;FEBRUARI
1091;SULAWESI BARAT;MAMASA;PANA;SALOAN;98;29;57;0;11;0;0;0;0;97;1;FEBRUARI
1092;SULAWESI BARAT;MAMASA;PANA;ULUSALU INDAH;52;34;18;0;0;0;0;0;0;52;0;FEBRUARI
1093;SULAWESI BARAT;MAMASA;NOSU;NOSU;84;7;34;4;24;8;0;5;0;82;2;FEBRUARI
1094;SULAWESI BARAT;MAMASA;NOSU;MINANGA;25;2;14;1;8;0;0;0;0;25;0;FEBRUARI
1095;SULAWESI BARAT;MAMASA;NOSU;BATUPAPAN;54;19;18;1;15;1;0;0;0;54;0;FEBRUARI
1096;SULAWESI BARAT;MAMASA;NOSU;MASEWWE;30;11;4;0;15;0;0;0;0;30;0;FEBRUARI
1097;SULAWESI BARAT;MAMASA;NOSU;SIWI;24;11;5;1;5;1;0;1;0;24;0;FEBRUARI
1098;SULAWESI BARAT;MAMASA;NOSU;MINANGA TIMUR;12;3;3;0;6;0;0;0;0;12;0;FEBRUARI
1099;SULAWESI BARAT;MAMASA;NOSU;PARINDING;24;2;16;0;6;0;0;0;0;24;0;FEBRUARI
1100;SULAWESI BARAT;PASANGKAYU;SARJO;SARJO;280;87;45;22;66;12;0;45;1;278;2;FEBRUARI
1101;SULAWESI BARAT;PASANGKAYU;SARJO;MAPONU;127;39;31;0;40;10;0;4;2;126;1;FEBRUARI
1102;SULAWESI BARAT;PASANGKAYU;SARJO;LETAWA;207;79;18;12;68;11;1;18;0;207;0;FEBRUARI
1103;SULAWESI BARAT;PASANGKAYU;SARJO;SARUDE;234;57;38;18;83;11;0;25;0;232;2;FEBRUARI
1104;SULAWESI BARAT;MAMASA;SESENAPADANG;OROBUA;209;39;22;2;115;20;0;4;3;205;4;FEBRUARI
1105;SULAWESI BARAT;MAMASA;SESENAPADANG;PALADAN;65;12;6;0;43;1;0;0;0;62;3;FEBRUARI
1106;SULAWESI BARAT;MAMASA;SESENAPADANG;OROBUA TIMUR;43;18;7;0;15;1;0;2;0;43;0;FEBRUARI
1107;SULAWESI BARAT;MAMASA;SESENAPADANG;RANTE PUANG;100;24;23;0;47;2;0;1;0;97;3;FEBRUARI
1108;SULAWESI BARAT;MAMASA;SESENAPADANG;SATENETEAN;49;7;25;0;15;1;0;1;0;49;0;FEBRUARI
1109;SULAWESI BARAT;MAMASA;SESENAPADANG;LISUAN ADA;70;34;13;0;23;0;0;0;0;70;0;FEBRUARI
1110;SULAWESI BARAT;MAMASA;SESENAPADANG;OROBUA SELATAN;68;18;12;0;19;19;0;0;0;68;0;FEBRUARI
1111;SULAWESI BARAT;MAMASA;SESENAPADANG;MALANGKENA PADANG;73;18;6;0;48;0;0;0;1;73;0;FEBRUARI
1112;SULAWESI BARAT;MAMASA;SESENAPADANG;MALIMBONG;27;6;3;0;17;0;0;1;0;27;0;FEBRUARI
1113;SULAWESI BARAT;MAMASA;SESENAPADANG;MARAMPAN OROBUA;41;17;3;0;11;9;0;0;0;40;1;FEBRUARI
1114;SULAWESI BARAT;PASANGKAYU;SARUDU;SARUDU;392;224;62;1;75;13;1;14;0;390;2;FEBRUARI
1115;SULAWESI BARAT;PASANGKAYU;SARUDU;BULU MARIO;308;99;49;14;97;31;0;18;0;308;0;FEBRUARI
1116;SULAWESI BARAT;PASANGKAYU;SARUDU;KUMASARI;262;128;42;5;69;10;0;6;1;261;1;FEBRUARI
1117;SULAWESI BARAT;PASANGKAYU;SARUDU;PATIKA;69;23;18;1;12;3;0;5;0;62;7;FEBRUARI
1118;SULAWESI BARAT;PASANGKAYU;SARUDU;DODA;292;138;68;2;76;5;0;3;0;292;0;FEBRUARI
1119;SULAWESI BARAT;PASANGKAYU;PEDONGGA;MALEI;229;109;67;1;37;13;0;2;0;229;0;FEBRUARI
1120;SULAWESI BARAT;PASANGKAYU;PEDONGGA;PEDANDA;197;52;50;3;80;5;0;6;0;196;1;FEBRUARI
1121;SULAWESI BARAT;PASANGKAYU;PEDONGGA;BATU OGE;150;61;30;1;50;7;0;1;0;150;0;FEBRUARI
1122;SULAWESI BARAT;PASANGKAYU;PEDONGGA;MARTASARI;576;226;64;6;245;23;0;10;0;574;2;FEBRUARI
1123;SULAWESI BARAT;MAMUJU TENGAH;TOBADAK;MAHAHE;337;137;73;13;91;11;0;10;1;336;1;FEBRUARI
1124;SULAWESI BARAT;MAMUJU TENGAH;TOBADAK;SALOBAJA;375;211;50;12;86;7;0;9;0;375;0;FEBRUARI
1125;SULAWESI BARAT;MAMUJU TENGAH;TOBADAK;TOBADAK;1336;577;285;20;326;36;3;26;1;1274;62;FEBRUARI
1126;SULAWESI BARAT;MAMUJU TENGAH;TOBADAK;PALONGAAN;283;105;85;4;73;2;0;13;0;282;1;FEBRUARI
1127;SULAWESI BARAT;MAMUJU TENGAH;TOBADAK;BATU PARIGI;728;167;235;5;265;24;1;21;0;718;10;FEBRUARI
1128;SULAWESI BARAT;MAMUJU TENGAH;TOBADAK;BAMBADARU;195;65;54;9;59;1;1;6;0;195;0;FEBRUARI
1129;SULAWESI BARAT;MAMUJU TENGAH;TOBADAK;SEJATI;153;89;26;4;27;2;0;5;0;153;0;FEBRUARI
1130;SULAWESI BARAT;MAMUJU TENGAH;TOBADAK;SALOADAK;259;118;10;1;109;11;0;7;0;256;3;FEBRUARI
1131;SULAWESI BARAT;MAMASA;TAWALIAN;TAWALIAN;249;122;38;0;72;8;0;7;0;247;2;FEBRUARI
1132;SULAWESI BARAT;MAMASA;TAWALIAN;TAWALIAN TIMUR;168;69;49;2;43;1;0;1;0;165;3;FEBRUARI
1133;SULAWESI BARAT;MAMASA;TAWALIAN;KARIANGO;209;80;52;0;77;0;0;0;0;209;0;FEBRUARI
1134;SULAWESI BARAT;MAMASA;TAWALIAN;RANTETANGNGA;140;27;34;5;66;4;0;3;0;139;1;FEBRUARI
1135;SULAWESI BARAT;MAMASA;TANDUK KALUA;MINAKE;77;22;6;1;44;2;0;2;0;77;0;FEBRUARI
1136;SULAWESI BARAT;MAMASA;TANDUK KALUA;MALABO;52;24;12;0;7;6;0;3;0;52;0;FEBRUARI
1137;SULAWESI BARAT;MAMASA;TANDUK KALUA;SINDAGAMANIK;142;79;18;1;42;1;0;1;0;142;0;FEBRUARI
1138;SULAWESI BARAT;MAMASA;TANDUK KALUA;PARONDOBULAWAN;107;72;11;1;20;1;0;2;0;107;0;FEBRUARI
1139;SULAWESI BARAT;MAMASA;TANDUK KALUA;TAMALANTIK;156;58;57;0;32;4;0;2;1;154;2;FEBRUARI
1140;SULAWESI BARAT;MAMASA;TANDUK KALUA;MANNABABA;68;26;1;0;41;0;0;0;0;68;0;FEBRUARI
1141;SULAWESI BARAT;MAMASA;TANDUK KALUA;MESAKADA;123;55;27;0;41;0;0;0;0;123;0;FEBRUARI
1142;SULAWESI BARAT;MAMASA;TANDUK KALUA;BALLABATU;151;21;15;0;111;3;0;1;0;151;0;FEBRUARI
1143;SULAWESI BARAT;MAMASA;TANDUK KALUA;PAMBE;86;24;16;1;42;2;1;0;0;86;0;FEBRUARI
1144;SULAWESI BARAT;MAMASA;TANDUK KALUA;SALURANO;73;29;14;0;28;1;0;1;0;73;0;FEBRUARI
1145;SULAWESI BARAT;MAMASA;TANDUK KALUA;TALIMBUNG;94;44;44;0;5;0;0;1;0;94;0;FEBRUARI
1146;SULAWESI BARAT;MAMASA;TANDUK KALUA;KANAN;119;44;26;0;37;9;0;1;0;117;2;FEBRUARI
1147;SULAWESI BARAT;MAMASA;TABULAHAN;LAKAHANG;277;96;153;2;16;2;1;7;0;277;0;FEBRUARI
1148;SULAWESI BARAT;MAMASA;TABULAHAN;PERIANGAN;67;18;48;0;1;0;0;0;0;67;0;FEBRUARI
1149;SULAWESI BARAT;MAMASA;TABULAHAN;MALATIRO;141;63;68;0;3;1;0;2;0;137;4;FEBRUARI
1150;SULAWESI BARAT;MAMASA;TABULAHAN;TABULAHAN;60;21;35;0;1;1;0;2;0;60;0;FEBRUARI
1151;SULAWESI BARAT;MAMASA;TABULAHAN;SALULEANG;35;9;25;0;1;0;0;0;0;35;0;FEBRUARI
1152;SULAWESI BARAT;MAMASA;TABULAHAN;TAMPAK KURRA;177;52;120;0;4;0;1;0;0;177;0;FEBRUARI
1153;SULAWESI BARAT;MAMASA;TABULAHAN;GANDANG DEWATA;34;12;20;0;2;0;0;0;0;34;0;FEBRUARI
1154;SULAWESI BARAT;MAMASA;TABULAHAN;BURANA;98;25;67;0;4;0;1;1;0;98;0;FEBRUARI
1155;SULAWESI BARAT;MAMASA;TABULAHAN;SALUBAKKA;100;62;37;0;0;0;0;1;0;100;0;FEBRUARI
1156;SULAWESI BARAT;MAMASA;TABULAHAN;PANGANDARAN;139;42;93;0;4;0;0;0;0;139;0;FEBRUARI
1157;SULAWESI BARAT;MAMASA;TABULAHAN;TALOPAK;53;14;32;0;7;0;0;0;0;53;0;FEBRUARI
1158;SULAWESI BARAT;MAMASA;TABULAHAN;PEU';53;19;34;0;0;0;0;0;0;53;0;FEBRUARI
1159;SULAWESI BARAT;MAMASA;TABULAHAN;TIMORO;42;11;23;0;5;1;0;2;0;42;0;FEBRUARI
1160;SULAWESI BARAT;MAMASA;TABULAHAN;LAKAHANG UTAMA;76;36;35;0;1;0;0;3;0;75;1;FEBRUARI
1161;SULAWESI BARAT;PASANGKAYU;LARIANG;PARABU;141;31;24;8;39;22;0;9;0;133;8;FEBRUARI
1162;SULAWESI BARAT;PASANGKAYU;LARIANG;KENANGAN;54;13;5;2;20;7;0;5;0;52;2;FEBRUARI
1163;SULAWESI BARAT;PASANGKAYU;LARIANG;BAJAWALI;130;28;24;1;54;11;0;12;0;130;0;FEBRUARI
1164;SULAWESI BARAT;PASANGKAYU;LARIANG;SINGGANI;192;73;60;1;38;9;0;7;0;188;4;FEBRUARI
1165;SULAWESI BARAT;PASANGKAYU;LARIANG;KULU;110;37;33;0;29;9;0;1;0;109;1;FEBRUARI
1166;SULAWESI BARAT;PASANGKAYU;LARIANG;BATU MATORU;93;32;19;0;24;8;0;10;0;93;0;FEBRUARI
1167;SULAWESI BARAT;PASANGKAYU;LARIANG;BAMBAKORO;160;53;40;2;46;11;0;8;0;160;0;FEBRUARI
1168;SULAWESI BARAT;PASANGKAYU;BULU TABA;LILIMORI;286;109;38;7;80;33;0;19;0;286;0;FEBRUARI
1169;SULAWESI BARAT;PASANGKAYU;BULU TABA;KARAVE;257;98;47;23;61;9;0;8;0;246;11;FEBRUARI
1170;SULAWESI BARAT;PASANGKAYU;BULU TABA;BUKIT HARAPAN;143;59;36;0;35;9;1;3;0;143;0;FEBRUARI
1171;SULAWESI BARAT;PASANGKAYU;BULU TABA;KASTABUANA;162;90;29;1;26;7;0;8;0;161;1;FEBRUARI
1172;SULAWESI BARAT;PASANGKAYU;BULU TABA;SUMBER SARI;31;22;5;0;3;1;0;0;0;31;0;FEBRUARI
1173;SULAWESI BARAT;PASANGKAYU;BULU TABA;LELEJAE;164;72;27;2;41;11;0;9;1;163;1;FEBRUARI
1174;SULAWESI BARAT;PASANGKAYU;BULU TABA;OMPI;104;46;32;4;18;3;0;1;0;104;0;FEBRUARI
1175;SULAWESI BARAT;MAMUJU TENGAH;BUDONG-BUDONG;BABANA;588;285;95;10;161;20;2;14;0;587;1;FEBRUARI
1176;SULAWESI BARAT;MAMUJU TENGAH;BUDONG-BUDONG;LUMU;240;103;31;0;94;3;0;7;0;238;2;FEBRUARI
1177;SULAWESI BARAT;MAMUJU TENGAH;BUDONG-BUDONG;PONTANAKAYANG;347;215;26;11;84;5;0;0;1;342;5;FEBRUARI
1178;SULAWESI BARAT;MAMUJU TENGAH;BUDONG-BUDONG;SALOGATTA;535;192;93;13;201;11;0;7;0;517;18;FEBRUARI
1179;SULAWESI BARAT;MAMUJU TENGAH;BUDONG-BUDONG;KIRE;196;67;38;3;85;1;0;2;0;196;0;FEBRUARI
1180;SULAWESI BARAT;MAMUJU TENGAH;BUDONG-BUDONG;TINALI;246;116;43;0;77;3;0;7;0;246;0;FEBRUARI
1181;SULAWESI BARAT;MAMUJU TENGAH;BUDONG-BUDONG;SALUMANURUNG;153;74;42;3;26;2;0;6;0;153;0;FEBRUARI
1182;SULAWESI BARAT;MAMUJU TENGAH;BUDONG-BUDONG;PASAPA;177;83;52;1;28;0;0;8;0;172;5;FEBRUARI
1183;SULAWESI BARAT;MAMUJU TENGAH;BUDONG-BUDONG;BOJO;255;108;61;1;76;6;0;3;0;255;0;FEBRUARI
1184;SULAWESI BARAT;MAMUJU TENGAH;BUDONG-BUDONG;BARAKKANG;112;54;18;4;34;1;0;1;0;112;0;FEBRUARI
1185;SULAWESI BARAT;MAMUJU TENGAH;BUDONG-BUDONG;LEMBAH HADA;66;29;11;0;23;1;0;2;0;66;0;FEBRUARI
1186;SULAWESI BARAT;MAMUJU TENGAH;PANGALE;POLO PANGALE;254;67;54;11;115;3;0;3;0;253;1;FEBRUARI
1187;SULAWESI BARAT;MAMUJU TENGAH;PANGALE;PANGALE;219;60;87;13;42;5;2;10;0;219;0;FEBRUARI
1188;SULAWESI BARAT;MAMUJU TENGAH;PANGALE;SARTANAMAJU;92;28;22;12;19;7;0;4;0;92;0;FEBRUARI
1189;SULAWESI BARAT;MAMUJU TENGAH;PANGALE;POLO LERENG;228;71;49;4;93;4;0;4;0;225;3;FEBRUARI
1190;SULAWESI BARAT;MAMUJU TENGAH;PANGALE;KUO;428;217;61;2;126;11;0;8;3;428;0;FEBRUARI
1191;SULAWESI BARAT;MAMUJU TENGAH;PANGALE;POLO CAMBA;150;49;46;11;39;1;0;1;3;150;0;FEBRUARI
1192;SULAWESI BARAT;MAMUJU TENGAH;PANGALE;LAMBA-LAMBA;126;46;33;2;42;1;0;2;0;126;0;FEBRUARI
1193;SULAWESI BARAT;MAMUJU TENGAH;PANGALE;KOMBILING;250;77;59;6;93;3;0;9;0;247;3;FEBRUARI
1194;SULAWESI BARAT;MAMUJU TENGAH;PANGALE;LEMO-LEMO;129;50;38;1;37;2;1;0;0;129;0;FEBRUARI
1195;SULAWESI BARAT;PASANGKAYU;DAPURANG;DAPURANG;432;244;65;5;79;23;1;6;0;423;9;FEBRUARI
1196;SULAWESI BARAT;PASANGKAYU;DAPURANG;BENGGAULU;303;130;80;0;72;7;0;14;0;303;0;FEBRUARI
1197;SULAWESI BARAT;PASANGKAYU;DAPURANG;TIRTABUANA;148;86;15;2;38;2;0;5;0;148;0;FEBRUARI
1198;SULAWESI BARAT;PASANGKAYU;DAPURANG;BULU BONGGU;261;72;52;3;119;6;0;4;0;256;5;FEBRUARI
1199;SULAWESI BARAT;PASANGKAYU;DAPURANG;SARASA;191;103;57;1;20;6;0;4;0;191;0;FEBRUARI
1200;SULAWESI BARAT;PASANGKAYU;BAMBAIRA;BAMBAIRA;284;80;49;8;122;10;0;12;0;281;3;FEBRUARI
1201;SULAWESI BARAT;PASANGKAYU;BAMBAIRA;KASOLOANG;174;63;23;0;67;11;0;10;0;174;0;FEBRUARI
1202;SULAWESI BARAT;PASANGKAYU;BAMBAIRA;TAMPAURE;246;107;52;2;61;6;0;12;0;240;6;FEBRUARI
1203;SULAWESI BARAT;PASANGKAYU;BAMBAIRA;KALUKU NANGKA;288;134;63;3;70;5;0;13;0;288;0;FEBRUARI
1204;SULAWESI BARAT;MAJENE;TAMMERODO SENDANA;SEPPONG;146;73;51;6;6;5;0;5;0;146;0;FEBRUARI
1205;SULAWESI BARAT;MAJENE;TAMMERODO SENDANA;TAMMERODO;143;70;28;1;13;19;3;6;0;140;3;FEBRUARI
1206;SULAWESI BARAT;MAJENE;TAMMERODO SENDANA;ULIDANG;176;98;31;3;20;8;2;14;0;176;0;FEBRUARI
1207;SULAWESI BARAT;MAJENE;TAMMERODO SENDANA;TALLAMBALAO;203;119;55;2;5;3;1;18;0;203;0;FEBRUARI
1208;SULAWESI BARAT;MAJENE;TAMMERODO SENDANA;TAMMERODO UTARA;182;88;41;7;11;25;0;9;1;182;0;FEBRUARI
1209;SULAWESI BARAT;MAJENE;TAMMERODO SENDANA;MANYAMBA;168;106;32;1;19;5;0;4;0;167;1;FEBRUARI
1210;SULAWESI BARAT;MAJENE;TAMMERODO SENDANA;AWO;130;78;16;0;6;9;6;11;0;126;4;FEBRUARI
1211;SULAWESI BARAT;PASANGKAYU;BARAS;BARAS;277;94;35;2;92;39;0;14;1;277;0;FEBRUARI
1212;SULAWESI BARAT;PASANGKAYU;BARAS;BALANTI;364;192;74;2;75;10;0;8;0;361;3;FEBRUARI
1213;SULAWESI BARAT;PASANGKAYU;BARAS;MOTU;574;214;134;11;119;62;0;31;0;571;3;FEBRUARI
1214;SULAWESI BARAT;PASANGKAYU;BARAS;BULU PARIGI;177;76;14;2;80;4;0;1;0;177;0;FEBRUARI
1215;SULAWESI BARAT;PASANGKAYU;BARAS;TOWONI;179;43;50;2;72;5;0;7;0;179;0;FEBRUARI
1216;SULAWESI BARAT;PASANGKAYU;BARAS;KASANO;303;190;31;0;70;10;0;2;0;303;0;FEBRUARI
1217;SULAWESI BARAT;MAMUJU TENGAH;TOPOYO;BUDONG-BUDONG;256;105;70;6;48;6;0;11;0;246;10;FEBRUARI
1218;SULAWESI BARAT;MAMUJU TENGAH;TOPOYO;TOPOYO;942;316;232;14;181;58;0;24;0;825;117;FEBRUARI
1219;SULAWESI BARAT;MAMUJU TENGAH;TOPOYO;TUMBU;343;162;69;4;80;18;0;10;0;343;0;FEBRUARI
1220;SULAWESI BARAT;MAMUJU TENGAH;TOPOYO;KABUBU;275;85;49;17;106;12;1;4;0;274;1;FEBRUARI
1221;SULAWESI BARAT;MAMUJU TENGAH;TOPOYO;WAEPUTEH;271;140;28;12;77;6;0;4;0;267;4;FEBRUARI
1222;SULAWESI BARAT;MAMUJU TENGAH;TOPOYO;TANGKOU;140;74;26;0;31;4;0;3;2;140;0;FEBRUARI
1223;SULAWESI BARAT;MAMUJU TENGAH;TOPOYO;TABOLANG;449;158;99;16;106;6;1;9;1;396;53;FEBRUARI
1224;SULAWESI BARAT;MAMUJU TENGAH;TOPOYO;PARAILI;194;102;38;2;32;15;2;3;0;194;0;FEBRUARI
1225;SULAWESI BARAT;MAMUJU TENGAH;TOPOYO;SALUPANGKANG;480;145;63;10;250;8;0;2;1;479;1;FEBRUARI
1226;SULAWESI BARAT;MAMUJU TENGAH;TOPOYO;SALUPANGKANG IV;62;41;2;0;17;0;0;1;0;61;1;FEBRUARI
1227;SULAWESI BARAT;MAMUJU TENGAH;TOPOYO;TAPPILINA;153;48;35;11;39;13;0;7;0;153;0;FEBRUARI
1228;SULAWESI BARAT;MAMUJU TENGAH;TOPOYO;BAMBAMANURUNG;153;66;11;4;67;4;0;0;1;153;0;FEBRUARI
1229;SULAWESI BARAT;MAMUJU TENGAH;TOPOYO;SALULEKBO;391;164;85;5;133;2;0;1;0;390;1;FEBRUARI
1230;SULAWESI BARAT;MAMUJU TENGAH;TOPOYO;PANGALLOANG;251;79;50;2;111;6;0;2;0;250;1;FEBRUARI
1231;SULAWESI BARAT;MAMUJU TENGAH;TOPOYO;SINABATTA;120;60;37;2;12;5;0;0;0;116;4;FEBRUARI
1232;SULAWESI BARAT;MAMUJU TENGAH;KAROSSA;KAROSSA;619;308;111;5;165;13;1;15;1;619;0;FEBRUARI
1233;SULAWESI BARAT;MAMUJU TENGAH;KAROSSA;TASOKKO;421;163;109;8;110;8;2;21;0;421;0;FEBRUARI
1234;SULAWESI BARAT;MAMUJU TENGAH;KAROSSA;LARA;118;34;11;0;65;4;1;3;0;118;0;FEBRUARI
1235;SULAWESI BARAT;MAMUJU TENGAH;KAROSSA;KADAILA;157;52;27;3;72;2;0;1;0;157;0;FEBRUARI
1236;SULAWESI BARAT;MAMUJU TENGAH;KAROSSA;KAYU CALLA;78;31;15;3;28;1;0;0;0;78;0;FEBRUARI
1237;SULAWESI BARAT;MAMUJU TENGAH;KAROSSA;LEMBAH HOPO;125;29;13;11;64;1;0;7;0;125;0;FEBRUARI
1238;SULAWESI BARAT;MAMUJU TENGAH;KAROSSA;BENGGAULU;260;124;58;0;62;8;0;6;0;258;2;FEBRUARI
1239;SULAWESI BARAT;MAMUJU TENGAH;KAROSSA;SUKA MAJU;115;46;35;2;27;1;0;1;0;112;3;FEBRUARI
1240;SULAWESI BARAT;MAMUJU TENGAH;KAROSSA;KAMBUNONG;280;147;72;0;43;6;0;11;0;279;1;FEBRUARI
1241;SULAWESI BARAT;MAMUJU TENGAH;KAROSSA;SALUBIRO;160;86;28;1;35;0;0;10;0;160;0;FEBRUARI
1242;SULAWESI BARAT;MAMUJU TENGAH;KAROSSA;SANJANGO;148;48;35;1;56;1;4;3;0;148;0;FEBRUARI
1243;SULAWESI BARAT;POLEWALI MANDAR;LIMBORO;LIMBORO;127;39;30;15;22;3;0;9;0;118;9;FEBRUARI
1244;SULAWESI BARAT;POLEWALI MANDAR;LIMBORO;LEMBANG LEMBANG;231;91;55;32;35;5;0;13;0;231;0;FEBRUARI
1245;SULAWESI BARAT;POLEWALI MANDAR;LIMBORO;TANDASURA;147;75;18;12;28;2;0;10;0;145;2;FEBRUARI
1246;SULAWESI BARAT;POLEWALI MANDAR;LIMBORO;SAMASUNDU;147;48;52;11;24;6;0;6;0;147;0;FEBRUARI
1247;SULAWESI BARAT;POLEWALI MANDAR;LIMBORO;NAPO;159;87;26;3;34;0;0;9;0;159;0;FEBRUARI
1248;SULAWESI BARAT;POLEWALI MANDAR;LIMBORO;TODANG TODANG;40;17;15;5;3;0;0;0;0;40;0;FEBRUARI
1249;SULAWESI BARAT;POLEWALI MANDAR;LIMBORO;PENDULANGAN;58;34;19;0;3;0;0;2;0;58;0;FEBRUARI
1250;SULAWESI BARAT;POLEWALI MANDAR;LIMBORO;RENGGEANG;112;36;35;7;30;0;0;4;0;112;0;FEBRUARI
1251;SULAWESI BARAT;POLEWALI MANDAR;LIMBORO;SALARRI;61;24;17;7;11;1;0;1;0;61;0;FEBRUARI
1252;SULAWESI BARAT;POLEWALI MANDAR;LIMBORO;TANGAN BARU;81;29;12;2;33;0;0;5;0;81;0;FEBRUARI
1253;SULAWESI BARAT;POLEWALI MANDAR;LIMBORO;PALECE;122;28;44;29;14;3;0;4;0;122;0;FEBRUARI
1254;SULAWESI BARAT;MAMUJU;SIMBORO;SIMBORO;1541;620;178;68;163;249;1;62;5;1346;195;FEBRUARI
1255;SULAWESI BARAT;MAMUJU;SIMBORO;RANGAS;573;182;155;22;123;18;3;10;0;513;60;FEBRUARI
1256;SULAWESI BARAT;MAMUJU;SIMBORO;BOTTENG;185;111;36;1;21;3;0;12;0;184;1;FEBRUARI
1257;SULAWESI BARAT;MAMUJU;SIMBORO;SALETTO;291;133;81;4;44;7;1;21;0;291;0;FEBRUARI
1258;SULAWESI BARAT;MAMUJU;SIMBORO;SUMARE;224;104;81;2;26;10;0;1;0;224;0;FEBRUARI
1259;SULAWESI BARAT;MAMUJU;SIMBORO;BOTTENG UTARA;353;145;85;1;100;4;1;0;0;336;17;FEBRUARI
1260;SULAWESI BARAT;MAMUJU;SIMBORO;TAPANDULLU;44;27;0;0;13;0;2;2;0;44;0;FEBRUARI
1261;SULAWESI BARAT;MAMUJU;SIMBORO;PATI'DI;188;106;42;2;34;1;0;3;0;188;0;FEBRUARI
1262;SULAWESI BARAT;POLEWALI MANDAR;MATAKALI;MATAKALI;330;153;83;16;52;13;0;13;0;330;0;FEBRUARI
1263;SULAWESI BARAT;POLEWALI MANDAR;MATAKALI;PETAMPANUA;278;126;91;3;34;17;2;5;0;278;0;FEBRUARI
1264;SULAWESI BARAT;POLEWALI MANDAR;MATAKALI;BARUMBUNG;217;85;73;7;41;8;0;3;0;217;0;FEBRUARI
1265;SULAWESI BARAT;POLEWALI MANDAR;MATAKALI;PASIANG;422;159;79;15;138;8;0;19;0;418;4;FEBRUARI
1266;SULAWESI BARAT;POLEWALI MANDAR;MATAKALI;TONROLIMA;238;123;51;2;37;5;0;10;2;230;8;FEBRUARI
1267;SULAWESI BARAT;POLEWALI MANDAR;MATAKALI;INDOMAKKOMBONG;392;193;107;1;67;5;0;10;2;385;7;FEBRUARI
1268;SULAWESI BARAT;POLEWALI MANDAR;MATAKALI;BUNGA-BUNGA;133;57;48;7;17;0;0;4;0;133;0;FEBRUARI
1269;SULAWESI BARAT;POLEWALI MANDAR;MAPILLI;MAPILI;118;48;9;6;37;4;0;14;0;118;0;FEBRUARI
1270;SULAWESI BARAT;POLEWALI MANDAR;MAPILLI;UGIBARU;178;65;18;14;33;8;0;24;0;162;16;FEBRUARI
1271;SULAWESI BARAT;POLEWALI MANDAR;MAPILLI;RUMPA;158;82;18;2;47;5;0;4;0;158;0;FEBRUARI
1272;SULAWESI BARAT;POLEWALI MANDAR;MAPILLI;KURMA;312;177;50;0;69;1;0;15;0;312;0;FEBRUARI
1273;SULAWESI BARAT;POLEWALI MANDAR;MAPILLI;BUKU;236;168;31;4;25;2;0;2;0;232;4;FEBRUARI
1274;SULAWESI BARAT;POLEWALI MANDAR;MAPILLI;BONNE BONNE;132;46;19;12;39;9;0;7;0;132;0;FEBRUARI
1275;SULAWESI BARAT;POLEWALI MANDAR;MAPILLI;BEROANGIN;216;69;28;1;95;4;0;14;1;212;4;FEBRUARI
1276;SULAWESI BARAT;POLEWALI MANDAR;MAPILLI;SEGERANG;168;99;36;3;23;1;0;6;0;168;0;FEBRUARI
1277;SULAWESI BARAT;POLEWALI MANDAR;MAPILLI;BONRA;193;93;53;2;30;3;0;12;0;193;0;FEBRUARI
1278;SULAWESI BARAT;POLEWALI MANDAR;MAPILLI;SATTOKO;75;20;7;0;43;0;0;5;0;75;0;FEBRUARI
1279;SULAWESI BARAT;POLEWALI MANDAR;MAPILLI;RAPPANG BARAT;325;102;116;5;72;4;0;25;0;324;1;FEBRUARI
1280;SULAWESI BARAT;POLEWALI MANDAR;MAPILLI;LANDI KANUSUANG;322;126;36;1;141;0;0;18;0;322;0;FEBRUARI
1281;SULAWESI BARAT;PASANGKAYU;BAMBALAMOTU;BAMBALAMOTU;401;194;73;4;79;25;0;24;0;399;2;FEBRUARI
1282;SULAWESI BARAT;PASANGKAYU;BAMBALAMOTU;POLEWALI;449;162;147;3;89;31;0;17;0;449;0;FEBRUARI
1283;SULAWESI BARAT;PASANGKAYU;BAMBALAMOTU;RANDOMAYANG;441;150;63;3;159;18;0;36;0;429;12;FEBRUARI
1284;SULAWESI BARAT;PASANGKAYU;BAMBALAMOTU;PANGIANG;189;95;49;2;21;15;0;7;0;189;0;FEBRUARI
1285;SULAWESI BARAT;PASANGKAYU;BAMBALAMOTU;KALOLA;472;117;115;0;210;17;0;13;0;472;0;FEBRUARI
1286;SULAWESI BARAT;PASANGKAYU;BAMBALAMOTU;WULAI;266;60;77;0;106;5;0;17;0;265;1;FEBRUARI
1287;SULAWESI BARAT;MAMUJU;PAPALANG;TOABO;654;289;149;4;199;8;0;3;1;653;1;FEBRUARI
1288;SULAWESI BARAT;MAMUJU;PAPALANG;PAPALANG;669;321;156;5;139;2;0;5;0;628;41;FEBRUARI
1289;SULAWESI BARAT;MAMUJU;PAPALANG;BONDA;314;177;89;1;44;0;0;2;0;313;1;FEBRUARI
1290;SULAWESI BARAT;MAMUJU;PAPALANG;TOPORE;196;107;40;7;33;1;0;2;0;190;6;FEBRUARI
1291;SULAWESI BARAT;MAMUJU;PAPALANG;SALUKAYU;258;130;91;0;29;2;0;6;0;258;0;FEBRUARI
1292;SULAWESI BARAT;MAMUJU;PAPALANG;SUKADAMAI;113;61;35;1;12;0;0;4;0;113;0;FEBRUARI
1293;SULAWESI BARAT;MAMUJU;PAPALANG;BODA-BODA;167;93;49;1;22;0;0;1;0;166;1;FEBRUARI
1294;SULAWESI BARAT;MAMUJU;PAPALANG;SISANGO;108;28;69;0;6;3;0;1;0;107;1;FEBRUARI
1295;SULAWESI BARAT;MAMUJU;PAPALANG;BATU AMPA;166;60;80;8;17;0;0;1;0;166;0;FEBRUARI
1296;SULAWESI BARAT;MAMUJU;BONEHAU;BONEHAU;164;50;77;4;22;2;0;3;0;158;6;MARET
1297;SULAWESI BARAT;MAMUJU;BONEHAU;SALUTIWO;89;32;36;1;20;0;0;0;0;89;0;MARET
1298;SULAWESI BARAT;MAMUJU;BONEHAU;BUTTUADA;206;11;168;3;19;1;0;2;0;204;2;MARET
1299;SULAWESI BARAT;MAMUJU;BONEHAU;TAMALEA;47;4;32;1;9;0;0;1;0;47;0;MARET
1300;SULAWESI BARAT;MAMUJU;BONEHAU;LUMIKA;126;39;54;2;30;1;0;0;0;126;0;MARET
1301;SULAWESI BARAT;MAMUJU;BONEHAU;MAPPU;72;15;42;1;13;0;0;1;0;72;0;MARET
1302;SULAWESI BARAT;MAMUJU;BONEHAU;BANUADA;98;11;80;3;3;0;0;1;0;98;0;MARET
1303;SULAWESI BARAT;MAMUJU;BONEHAU;HINUA;99;25;27;7;33;1;0;3;1;97;2;MARET
1304;SULAWESI BARAT;MAMUJU;BONEHAU;KINATANG;106;20;82;2;0;0;0;2;0;106;0;MARET
1305;SULAWESI BARAT;MAMASA;ARALLE;ARALLE;108;40;55;2;7;1;0;3;0;108;0;MARET
1306;SULAWESI BARAT;MAMASA;ARALLE;RALLE ANAK;33;5;20;0;6;0;0;2;0;33;0;MARET
1307;SULAWESI BARAT;MAMASA;ARALLE;PANETEAN;74;55;19;0;0;0;0;0;0;74;0;MARET
1308;SULAWESI BARAT;MAMASA;ARALLE;UHAILANU;66;22;25;0;10;3;0;5;0;65;1;MARET
1309;SULAWESI BARAT;MAMASA;ARALLE;ARALLE UTARA;68;31;36;0;1;0;0;0;0;68;0;MARET
1310;SULAWESI BARAT;MAMASA;ARALLE;UHAIDAHO;54;9;36;3;6;0;0;0;0;54;0;MARET
1311;SULAWESI BARAT;MAMASA;ARALLE;BARURU;91;62;27;0;1;0;0;0;1;91;0;MARET
1312;SULAWESI BARAT;MAMASA;ARALLE;RALLEANAK UTARA;40;21;15;0;3;0;0;1;0;40;0;MARET
1313;SULAWESI BARAT;MAMASA;ARALLE;PAMOSEANG PANGGA;36;12;21;2;1;0;0;0;0;36;0;MARET
1314;SULAWESI BARAT;MAMASA;ARALLE;KALABE;62;21;39;0;2;0;0;0;0;62;0;MARET
1315;SULAWESI BARAT;MAMASA;ARALLE;ARALLE SELATAN;28;10;16;0;1;0;0;1;0;28;0;MARET
1316;SULAWESI BARAT;MAMASA;ARALLE;HAHANGAN;35;16;13;0;6;0;0;0;0;35;0;MARET
1317;SULAWESI BARAT;POLEWALI MANDAR;TAPANGO;PELITAKAN;161;94;25;1;13;1;0;11;0;145;16;MARET
1318;SULAWESI BARAT;POLEWALI MANDAR;TAPANGO;TAPANGO;214;120;39;3;41;5;0;6;0;214;0;MARET
1319;SULAWESI BARAT;POLEWALI MANDAR;TAPANGO;RAPPANG;208;113;42;2;40;2;0;8;0;207;1;MARET
1320;SULAWESI BARAT;POLEWALI MANDAR;TAPANGO;DAKKA;155;73;36;3;34;2;0;4;0;152;3;MARET
1321;SULAWESI BARAT;POLEWALI MANDAR;TAPANGO;BATU;132;75;23;1;25;1;0;5;0;130;2;MARET
1322;SULAWESI BARAT;POLEWALI MANDAR;TAPANGO;RISO;176;96;14;0;55;4;0;5;0;174;2;MARET
1323;SULAWESI BARAT;POLEWALI MANDAR;TAPANGO;PALATTA;179;71;61;1;36;1;0;0;0;170;9;MARET
1324;SULAWESI BARAT;POLEWALI MANDAR;TAPANGO;TAPANGO BARAT;145;78;35;1;19;3;0;9;0;145;0;MARET
1325;SULAWESI BARAT;POLEWALI MANDAR;TAPANGO;KURRAK;77;39;32;0;4;1;0;1;0;77;0;MARET
1326;SULAWESI BARAT;POLEWALI MANDAR;TAPANGO;BUSSU;144;87;32;4;17;2;0;2;0;144;0;MARET
1327;SULAWESI BARAT;POLEWALI MANDAR;TAPANGO;TUTTULA;107;70;14;2;14;1;0;1;0;102;5;MARET
1328;SULAWESI BARAT;POLEWALI MANDAR;TAPANGO;JAMBU MALEA;197;80;72;6;29;0;0;10;0;197;0;MARET
1329;SULAWESI BARAT;POLEWALI MANDAR;TAPANGO;KALIMBUA;193;124;38;1;23;2;0;5;0;193;0;MARET
1330;SULAWESI BARAT;POLEWALI MANDAR;TAPANGO;BANATO REJO;331;207;79;0;31;6;0;3;0;326;5;MARET
1331;SULAWESI BARAT;MAMUJU;KALUMPANG;KALUMPANG;51;25;13;0;6;0;0;3;0;47;4;MARET
1332;SULAWESI BARAT;MAMUJU;KALUMPANG;KARATAUN;179;114;27;0;35;0;0;1;0;177;2;MARET
1333;SULAWESI BARAT;MAMUJU;KALUMPANG;KARAMA;123;54;48;0;20;0;0;1;0;123;0;MARET
1334;SULAWESI BARAT;MAMUJU;KALUMPANG;SIRAUN;103;60;23;0;18;0;0;0;1;102;1;MARET
1335;SULAWESI BARAT;MAMUJU;KALUMPANG;TUMOGA;73;36;13;0;16;0;0;0;0;65;8;MARET
1336;SULAWESI BARAT;MAMUJU;KALUMPANG;SALUMAKKI;96;66;18;0;10;0;0;0;0;94;2;MARET
1337;SULAWESI BARAT;MAMUJU;KALUMPANG;POLIO;62;30;24;0;7;0;0;0;1;62;0;MARET
1338;SULAWESI BARAT;MAMUJU;KALUMPANG;LIMBONG;90;26;15;0;47;1;0;1;0;90;0;MARET
1339;SULAWESI BARAT;MAMUJU;KALUMPANG;SANDAPANG;93;28;3;0;61;0;0;0;0;92;1;MARET
1340;SULAWESI BARAT;MAMUJU;KALUMPANG;KONDO BULO;87;52;27;0;6;0;0;1;0;86;1;MARET
1341;SULAWESI BARAT;MAMUJU;KALUMPANG;MAKKALIKI;69;34;18;0;17;0;0;0;0;69;0;MARET
1342;SULAWESI BARAT;MAMUJU;KALUMPANG;BATU MAKKADA;81;36;37;0;7;0;0;0;0;80;1;MARET
1343;SULAWESI BARAT;MAMUJU;KALUMPANG;LASA';116;73;26;0;13;0;0;0;1;113;3;MARET
1344;SULAWESI BARAT;POLEWALI MANDAR;TUTAR;TARAMANU;196;90;37;5;41;1;12;10;0;196;0;MARET
1345;SULAWESI BARAT;POLEWALI MANDAR;TUTAR;AMBOPADANG;271;106;56;1;105;2;0;1;0;271;0;MARET
1346;SULAWESI BARAT;POLEWALI MANDAR;TUTAR;TUBBI;129;45;62;4;7;3;0;8;0;129;0;MARET
1347;SULAWESI BARAT;POLEWALI MANDAR;TUTAR;RATTE;180;65;68;2;42;1;1;0;1;180;0;MARET
1348;SULAWESI BARAT;POLEWALI MANDAR;TUTAR;BESOANGIN;122;67;8;2;45;0;0;0;0;122;0;MARET
1349;SULAWESI BARAT;POLEWALI MANDAR;TUTAR;PIRIANG TAPIKO;107;25;59;0;21;0;0;2;0;107;0;MARET
1350;SULAWESI BARAT;POLEWALI MANDAR;TUTAR;PEBURRU;187;104;46;3;27;2;0;5;0;187;0;MARET
1351;SULAWESI BARAT;POLEWALI MANDAR;TUTAR;TALOBA;94;39;37;0;14;0;0;3;0;93;1;MARET
1352;SULAWESI BARAT;POLEWALI MANDAR;TUTAR;POLLEWANI;255;141;78;2;31;0;0;3;0;255;0;MARET
1353;SULAWESI BARAT;POLEWALI MANDAR;TUTAR;ARABUA;146;83;33;0;11;0;16;3;0;146;0;MARET
1354;SULAWESI BARAT;POLEWALI MANDAR;TUTAR;BESOANGIN UTARA;105;60;14;4;27;0;0;0;0;105;0;MARET
1355;SULAWESI BARAT;POLEWALI MANDAR;TUTAR;PODA;117;50;47;4;12;0;1;3;0;117;0;MARET
1356;SULAWESI BARAT;POLEWALI MANDAR;TUTAR;TARAMANU TUA;168;33;48;2;75;3;0;4;0;165;3;MARET
1357;SULAWESI BARAT;POLEWALI MANDAR;WONOMULYO;SIDODADI;391;199;87;3;56;29;0;14;1;389;2;MARET
1358;SULAWESI BARAT;POLEWALI MANDAR;WONOMULYO;SIDOREJO;267;153;52;11;20;12;0;16;0;264;3;MARET
1359;SULAWESI BARAT;POLEWALI MANDAR;WONOMULYO;SUMBEREJO;476;226;81;26;98;32;0;6;1;470;6;MARET
1360;SULAWESI BARAT;POLEWALI MANDAR;WONOMULYO;BUMIAYU;403;193;66;8;46;51;0;16;0;380;23;MARET
1361;SULAWESI BARAT;POLEWALI MANDAR;WONOMULYO;KEBUNSARI;292;114;54;10;42;43;1;11;0;275;17;MARET
1362;SULAWESI BARAT;POLEWALI MANDAR;WONOMULYO;BANUA BARU;184;99;29;7;18;15;0;8;0;176;8;MARET
1363;SULAWESI BARAT;POLEWALI MANDAR;WONOMULYO;NEPO;250;149;43;3;38;9;1;4;0;247;3;MARET
1364;SULAWESI BARAT;POLEWALI MANDAR;WONOMULYO;SUGIHWARAS;510;239;126;12;78;30;0;13;0;498;12;MARET
1365;SULAWESI BARAT;POLEWALI MANDAR;WONOMULYO;CAMPURJO;236;111;42;6;39;19;0;18;0;235;1;MARET
1366;SULAWESI BARAT;POLEWALI MANDAR;WONOMULYO;BUMIMULYO;192;107;44;0;30;7;0;2;0;190;2;MARET
1367;SULAWESI BARAT;POLEWALI MANDAR;WONOMULYO;TUMPILING;228;118;51;2;34;4;0;8;0;217;11;MARET
1368;SULAWESI BARAT;POLEWALI MANDAR;WONOMULYO;BAKKA-BAKKA;186;103;36;3;28;5;0;6;0;181;5;MARET
1369;SULAWESI BARAT;POLEWALI MANDAR;WONOMULYO;ARJO SARI;275;150;80;5;12;16;0;6;0;269;6;MARET
1370;SULAWESI BARAT;POLEWALI MANDAR;WONOMULYO;GALESON;231;154;31;3;26;5;0;7;0;226;5;MARET
1371;SULAWESI BARAT;POLEWALI MANDAR;MATANGNGA;MATANGNGA;65;29;8;3;21;1;0;3;0;65;0;MARET
1372;SULAWESI BARAT;POLEWALI MANDAR;MATANGNGA;LILLI;107;42;13;1;49;0;0;1;0;106;1;MARET
1373;SULAWESI BARAT;POLEWALI MANDAR;MATANGNGA;RANGOAN;67;23;27;0;15;0;0;0;0;65;2;MARET
1374;SULAWESI BARAT;POLEWALI MANDAR;MATANGNGA;TAPUA;161;70;29;7;54;0;0;1;0;161;0;MARET
1375;SULAWESI BARAT;POLEWALI MANDAR;MATANGNGA;MAMBU TAPUA;94;31;11;1;48;0;0;3;0;94;0;MARET
1376;SULAWESI BARAT;POLEWALI MANDAR;MATANGNGA;BA'BA TAPUA;71;30;10;0;31;0;0;0;0;71;0;MARET
1377;SULAWESI BARAT;POLEWALI MANDAR;MATANGNGA;KATIMBANG;89;38;22;1;26;1;0;0;0;88;1;MARET
1378;SULAWESI BARAT;MAMUJU;SAMPAGA;BUNDE;514;253;129;3;123;1;0;5;0;514;0;MARET
1379;SULAWESI BARAT;MAMUJU;SAMPAGA;KALONDING;450;183;183;6;70;4;0;3;0;449;1;MARET
1380;SULAWESI BARAT;MAMUJU;SAMPAGA;TARAILU;262;120;81;0;50;5;0;6;0;262;0;MARET
1381;SULAWESI BARAT;MAMUJU;SAMPAGA;SAMPAGA;186;85;68;2;25;3;0;2;1;186;0;MARET
1382;SULAWESI BARAT;MAMUJU;SAMPAGA;TANAMBUAH;71;23;25;1;20;0;0;2;0;71;0;MARET
1383;SULAWESI BARAT;MAMUJU;SAMPAGA;SALUBARANA;77;36;21;2;15;1;0;2;0;77;0;MARET
1384;SULAWESI BARAT;MAMUJU;SAMPAGA;LOSSO;127;53;23;1;49;0;0;0;0;126;1;MARET
1385;SULAWESI BARAT;POLEWALI MANDAR;TINAMBUNG;TINAMBUNG;128;41;27;5;25;4;0;26;0;128;0;MARET
1386;SULAWESI BARAT;POLEWALI MANDAR;TINAMBUNG;KARAMA;458;328;49;21;43;2;0;15;0;458;0;MARET
1387;SULAWESI BARAT;POLEWALI MANDAR;TINAMBUNG;TANGNGA TANGNGA;205;144;37;2;13;1;0;8;0;205;0;MARET
1388;SULAWESI BARAT;POLEWALI MANDAR;TINAMBUNG;LEKOPADIS;91;36;16;5;27;1;0;5;0;90;1;MARET
1389;SULAWESI BARAT;POLEWALI MANDAR;TINAMBUNG;GALUNG LOMBOK;134;52;21;9;34;3;0;15;0;134;0;MARET
1390;SULAWESI BARAT;POLEWALI MANDAR;TINAMBUNG;TANDUNG;116;54;25;5;16;4;0;11;0;115;1;MARET
1391;SULAWESI BARAT;POLEWALI MANDAR;TINAMBUNG;BATULAYA;114;45;20;18;17;4;0;10;0;114;0;MARET
1392;SULAWESI BARAT;POLEWALI MANDAR;TINAMBUNG;SEPABATU;99;33;26;9;16;2;0;13;0;99;0;MARET
1393;SULAWESI BARAT;MAMUJU;KEP. BALA BALAKANG;BALA BALAKANG;124;64;48;3;8;0;0;0;0;123;1;MARET
1394;SULAWESI BARAT;MAMUJU;KEP. BALA BALAKANG;BALA-BALAKANG TIMUR;99;26;71;1;0;0;1;0;0;99;0;MARET
1395;SULAWESI BARAT;MAMASA;MEHALAAN;MEHALAAN;55;21;18;1;13;0;0;2;0;55;0;MARET
1396;SULAWESI BARAT;MAMASA;MEHALAAN;BOTTENG;64;27;15;0;20;0;1;1;0;64;0;MARET
1397;SULAWESI BARAT;MAMASA;MEHALAAN;SALUKONTA;53;26;10;2;14;0;0;1;0;53;0;MARET
1398;SULAWESI BARAT;MAMASA;MEHALAAN;MESAKADA;56;17;19;1;19;0;0;0;0;56;0;MARET
1399;SULAWESI BARAT;MAMASA;MEHALAAN;MEHALAAN BARAT;92;35;23;0;31;0;0;3;0;92;0;MARET
1400;SULAWESI BARAT;MAMASA;MEHALAAN;SALUAHOK;70;20;26;1;19;0;0;4;0;70;0;MARET
1401;SULAWESI BARAT;MAMASA;MEHALAAN;SALUBALO;44;24;13;0;7;0;0;0;0;44;0;MARET
1402;SULAWESI BARAT;MAMASA;MEHALAAN;PASSEMBUK;40;19;10;0;11;0;0;0;0;40;0;MARET
1403;SULAWESI BARAT;MAMASA;MEHALAAN;KONDO;34;17;9;0;7;0;0;1;0;34;0;MARET
1404;SULAWESI BARAT;MAMASA;MEHALAAN;LEKO SUKAMAJU;31;12;10;0;8;0;0;1;0;31;0;MARET
1405;SULAWESI BARAT;MAMASA;MEHALAAN;ULUMEA;27;14;2;0;11;0;0;0;0;27;0;MARET
1406;SULAWESI BARAT;MAMASA;TANDUK KALUA;MINAKE;78;23;5;2;44;2;0;2;0;78;0;MARET
1407;SULAWESI BARAT;MAMASA;TANDUK KALUA;MALABO;51;23;13;0;5;7;0;3;0;51;0;MARET
1408;SULAWESI BARAT;MAMASA;TANDUK KALUA;SINDAGAMANIK;141;77;19;1;42;1;0;1;0;141;0;MARET
1409;SULAWESI BARAT;MAMASA;TANDUK KALUA;PARONDOBULAWAN;107;71;11;1;20;1;0;3;0;107;0;MARET
1410;SULAWESI BARAT;MAMASA;TANDUK KALUA;TAMALANTIK;153;57;56;0;32;4;0;1;1;151;2;MARET
1411;SULAWESI BARAT;MAMASA;TANDUK KALUA;MANNABABA;70;29;2;0;39;0;0;0;0;70;0;MARET
1412;SULAWESI BARAT;MAMASA;TANDUK KALUA;MESAKADA;123;53;27;0;43;0;0;0;0;123;0;MARET
1413;SULAWESI BARAT;MAMASA;TANDUK KALUA;BALLABATU;150;20;14;0;112;3;0;1;0;150;0;MARET
1414;SULAWESI BARAT;MAMASA;TANDUK KALUA;PAMBE;84;23;15;1;42;2;1;0;0;84;0;MARET
1415;SULAWESI BARAT;MAMASA;TANDUK KALUA;SALURANO;73;29;14;0;28;1;0;1;0;73;0;MARET
1416;SULAWESI BARAT;MAMASA;TANDUK KALUA;TALIMBUNG;94;48;40;0;5;0;0;1;0;94;0;MARET
1417;SULAWESI BARAT;MAMASA;TANDUK KALUA;KANAN;114;43;25;0;35;8;0;1;0;112;2;MARET
1418;SULAWESI BARAT;MAMASA;SUMARORONG;SUMARORONG;146;51;40;5;31;6;0;11;0;144;2;MARET
1419;SULAWESI BARAT;MAMASA;SUMARORONG;TABONE;92;22;36;0;33;0;0;1;0;92;0;MARET
1420;SULAWESI BARAT;MAMASA;SUMARORONG;BATANG URU;94;34;44;0;13;2;0;1;0;94;0;MARET
1421;SULAWESI BARAT;MAMASA;SUMARORONG;SASAKAN;156;47;88;1;12;7;0;0;0;155;1;MARET
1422;SULAWESI BARAT;MAMASA;SUMARORONG;TADISI;51;12;33;0;6;0;0;0;0;51;0;MARET
1423;SULAWESI BARAT;MAMASA;SUMARORONG;SIBANAWA;95;32;44;0;18;0;0;1;0;95;0;MARET
1424;SULAWESI BARAT;MAMASA;SUMARORONG;BATANGNGURU TIMUR;101;26;68;1;6;0;0;0;0;101;0;MARET
1425;SULAWESI BARAT;MAMASA;SUMARORONG;SALUBALO;121;59;40;0;20;0;0;2;0;121;0;MARET
1426;SULAWESI BARAT;MAMASA;SUMARORONG;BANEA;61;23;30;0;6;1;0;1;0;61;0;MARET
1427;SULAWESI BARAT;MAMASA;SUMARORONG;RANTE KAMASE;164;83;25;3;39;5;0;8;0;163;1;MARET
1428;SULAWESI BARAT;MAMASA;TABANG;TABANG;79;25;16;1;10;26;0;1;0;79;0;MARET
1429;SULAWESI BARAT;MAMASA;TABANG;TADOKALUA;94;36;29;1;19;1;0;3;0;89;5;MARET
1430;SULAWESI BARAT;MAMASA;TABANG;TABANG BARAT;159;69;47;1;39;2;0;0;1;159;0;MARET
1431;SULAWESI BARAT;MAMASA;TABANG;MASUPU;79;8;65;1;4;0;0;0;1;79;0;MARET
1432;SULAWESI BARAT;MAMASA;TABANG;KALAMA;69;11;23;0;21;3;0;1;0;59;10;MARET
1433;SULAWESI BARAT;MAMASA;TABANG;BAKADISURA;95;21;61;0;11;1;0;1;0;95;0;MARET
1434;SULAWESI BARAT;MAMASA;TABANG;SALUKONA;97;44;45;0;7;1;0;0;0;97;0;MARET
1435;SULAWESI BARAT;MAMASA;RANTEBULAHAN TIMUR;SALUMOKANAN;96;42;17;0;30;6;0;1;0;96;0;MARET
1436;SULAWESI BARAT;MAMASA;RANTEBULAHAN TIMUR;SALUMOKANAN BARAT;109;43;27;0;36;0;0;0;1;107;2;MARET
1437;SULAWESI BARAT;MAMASA;RANTEBULAHAN TIMUR;BUANGIN;92;64;16;0;10;0;0;0;0;90;2;MARET
1438;SULAWESI BARAT;MAMASA;RANTEBULAHAN TIMUR;BAMBANG BUDA;119;31;64;1;20;1;0;2;0;119;0;MARET
1439;SULAWESI BARAT;MAMASA;RANTEBULAHAN TIMUR;LEKO;22;6;11;0;5;0;0;0;0;22;0;MARET
1440;SULAWESI BARAT;MAMASA;RANTEBULAHAN TIMUR;KIRAK;71;43;22;0;6;0;0;0;0;71;0;MARET
1441;SULAWESI BARAT;MAMASA;RANTEBULAHAN TIMUR;SALUMOKANAN UTARA;110;66;7;0;35;1;0;1;0;110;0;MARET
1442;SULAWESI BARAT;MAMASA;RANTEBULAHAN TIMUR;SAMPALE;53;15;15;0;23;0;0;0;0;53;0;MARET
1443;SULAWESI BARAT;PASANGKAYU;PEDONGGA;MALEI;228;110;66;1;36;13;0;2;0;228;0;MARET
1444;SULAWESI BARAT;PASANGKAYU;PEDONGGA;PEDANDA;198;52;50;3;80;5;0;7;0;197;1;MARET
1445;SULAWESI BARAT;PASANGKAYU;PEDONGGA;BATU OGE;143;62;25;1;47;7;0;1;0;143;0;MARET
1446;SULAWESI BARAT;PASANGKAYU;PEDONGGA;MARTASARI;574;224;64;6;245;22;0;11;0;572;2;MARET
1447;SULAWESI BARAT;PASANGKAYU;PASANGKAYU;PASANGKAYU;1523;654;385;32;148;227;24;48;0;1518;5;MARET
1448;SULAWESI BARAT;PASANGKAYU;PASANGKAYU;MARTAJAYA;179;62;34;1;44;25;0;13;0;179;0;MARET
1449;SULAWESI BARAT;PASANGKAYU;PASANGKAYU;PAKAVA;392;221;100;5;60;4;0;2;0;392;0;MARET
1450;SULAWESI BARAT;PASANGKAYU;PASANGKAYU;KARYA BERSAMA;319;161;51;1;76;19;0;11;0;319;0;MARET
1451;SULAWESI BARAT;PASANGKAYU;PASANGKAYU;AKO;433;218;69;6;76;39;0;14;0;422;11;MARET
1452;SULAWESI BARAT;PASANGKAYU;PASANGKAYU;GUNUNG SARI;561;316;79;4;105;23;0;26;0;553;8;MARET
1453;SULAWESI BARAT;MAMASA;SESENAPADANG;OROBUA;205;37;19;3;116;18;0;4;3;200;5;MARET
1454;SULAWESI BARAT;MAMASA;SESENAPADANG;PALADAN;65;11;6;0;44;1;0;0;0;62;3;MARET
1455;SULAWESI BARAT;MAMASA;SESENAPADANG;OROBUA TIMUR;42;18;7;0;14;1;0;2;0;42;0;MARET
1456;SULAWESI BARAT;MAMASA;SESENAPADANG;RANTE PUANG;95;20;20;0;49;2;0;1;0;92;3;MARET
1457;SULAWESI BARAT;MAMASA;SESENAPADANG;SATENETEAN;47;7;23;0;15;1;0;1;0;47;0;MARET
1458;SULAWESI BARAT;MAMASA;SESENAPADANG;LISUAN ADA;66;31;12;0;23;0;0;0;0;66;0;MARET
1459;SULAWESI BARAT;MAMASA;SESENAPADANG;OROBUA SELATAN;64;18;9;0;19;18;0;0;0;64;0;MARET
1460;SULAWESI BARAT;MAMASA;SESENAPADANG;MALANGKENA PADANG;71;18;6;0;46;0;0;0;1;71;0;MARET
1461;SULAWESI BARAT;MAMASA;SESENAPADANG;MALIMBONG;27;7;1;0;18;0;0;1;0;27;0;MARET
1462;SULAWESI BARAT;MAMASA;SESENAPADANG;MARAMPAN OROBUA;41;15;4;1;11;9;0;0;0;40;1;MARET
1463;SULAWESI BARAT;PASANGKAYU;SARJO;SARJO;283;87;48;22;66;12;0;45;1;281;2;MARET
1464;SULAWESI BARAT;PASANGKAYU;SARJO;MAPONU;131;42;31;0;41;10;0;4;2;130;1;MARET
1465;SULAWESI BARAT;PASANGKAYU;SARJO;LETAWA;216;82;24;14;67;10;1;18;0;216;0;MARET
1466;SULAWESI BARAT;PASANGKAYU;SARJO;SARUDE;236;56;41;18;83;12;0;25;0;235;1;MARET
1467;SULAWESI BARAT;PASANGKAYU;SARUDU;SARUDU;394;227;61;1;75;13;1;14;0;392;2;MARET
1468;SULAWESI BARAT;PASANGKAYU;SARUDU;BULU MARIO;315;110;48;14;97;28;0;18;0;315;0;MARET
1469;SULAWESI BARAT;PASANGKAYU;SARUDU;KUMASARI;259;124;44;5;68;10;0;6;1;258;1;MARET
1470;SULAWESI BARAT;PASANGKAYU;SARUDU;PATIKA;67;20;19;1;12;3;0;5;0;60;7;MARET
1471;SULAWESI BARAT;PASANGKAYU;SARUDU;DODA;279;133;59;3;78;3;0;3;0;279;0;MARET
1472;SULAWESI BARAT;MAMASA;NOSU;NOSU;79;6;35;2;22;7;0;5;0;77;2;MARET
1473;SULAWESI BARAT;MAMASA;NOSU;MINANGA;24;0;16;1;7;0;0;0;0;24;0;MARET
1474;SULAWESI BARAT;MAMASA;NOSU;BATUPAPAN;53;18;18;1;15;1;0;0;0;53;0;MARET
1475;SULAWESI BARAT;MAMASA;NOSU;MASEWWE;22;6;3;0;13;0;0;0;0;22;0;MARET
1476;SULAWESI BARAT;MAMASA;NOSU;SIWI;24;11;5;1;5;1;0;1;0;24;0;MARET
1477;SULAWESI BARAT;MAMASA;NOSU;MINANGA TIMUR;11;2;3;0;6;0;0;0;0;11;0;MARET
1478;SULAWESI BARAT;MAMASA;NOSU;PARINDING;23;2;16;0;5;0;0;0;0;23;0;MARET
1479;SULAWESI BARAT;MAMASA;PANA;PANA;57;15;33;2;5;1;0;0;1;57;0;MARET
1480;SULAWESI BARAT;MAMASA;PANA;MANIPI;122;63;46;3;7;1;0;1;0;121;1;MARET
1481;SULAWESI BARAT;MAMASA;PANA;MAMULLU;63;13;38;0;10;1;0;1;0;63;0;MARET
1482;SULAWESI BARAT;MAMASA;PANA;SAPAN;55;18;12;0;25;0;0;0;0;55;0;MARET
1483;SULAWESI BARAT;MAMASA;PANA;DATUBARINGAN;78;24;41;1;11;0;0;1;0;78;0;MARET
1484;SULAWESI BARAT;MAMASA;PANA;PANURA;61;16;40;0;5;0;0;0;0;61;0;MARET
1485;SULAWESI BARAT;MAMASA;PANA;TALLANG BULAWAN;72;21;39;4;7;0;0;1;0;72;0;MARET
1486;SULAWESI BARAT;MAMASA;PANA;KARAKA;56;23;26;0;6;0;0;1;0;56;0;MARET
1487;SULAWESI BARAT;MAMASA;PANA;ULUSALU;49;4;44;0;0;1;0;0;0;49;0;MARET
1488;SULAWESI BARAT;MAMASA;PANA;WERI;51;7;36;2;4;1;0;1;0;51;0;MARET
1489;SULAWESI BARAT;MAMASA;PANA;SALUTAMBUN;45;1;44;0;0;0;0;0;0;45;0;MARET
1490;SULAWESI BARAT;MAMASA;PANA;SALOAN;98;32;55;0;10;0;0;0;0;97;1;MARET
1491;SULAWESI BARAT;MAMASA;PANA;ULUSALU INDAH;52;34;18;0;0;0;0;0;0;52;0;MARET
1492;SULAWESI BARAT;MAMASA;TABULAHAN;LAKAHANG;271;97;151;2;10;3;1;7;0;271;0;MARET
1493;SULAWESI BARAT;MAMASA;TABULAHAN;PERIANGAN;68;18;48;0;2;0;0;0;0;68;0;MARET
1494;SULAWESI BARAT;MAMASA;TABULAHAN;MALATIRO;140;63;69;0;2;1;0;2;0;137;3;MARET
1495;SULAWESI BARAT;MAMASA;TABULAHAN;TABULAHAN;59;20;35;0;1;1;0;2;0;59;0;MARET
1496;SULAWESI BARAT;MAMASA;TABULAHAN;SALULEANG;35;12;22;0;1;0;0;0;0;35;0;MARET
1497;SULAWESI BARAT;MAMASA;TABULAHAN;TAMPAK KURRA;177;49;123;0;4;0;1;0;0;177;0;MARET
1498;SULAWESI BARAT;MAMASA;TABULAHAN;GANDANG DEWATA;34;12;20;0;2;0;0;0;0;34;0;MARET
1499;SULAWESI BARAT;MAMASA;TABULAHAN;BURANA;98;26;66;0;4;0;1;1;0;98;0;MARET
1500;SULAWESI BARAT;MAMASA;TABULAHAN;SALUBAKKA;101;62;37;0;0;0;0;2;0;101;0;MARET
1501;SULAWESI BARAT;MAMASA;TABULAHAN;PANGANDARAN;136;41;91;0;4;0;0;0;0;136;0;MARET
1502;SULAWESI BARAT;MAMASA;TABULAHAN;TALOPAK;53;16;32;0;5;0;0;0;0;53;0;MARET
1503;SULAWESI BARAT;MAMASA;TABULAHAN;PEU';51;17;34;0;0;0;0;0;0;51;0;MARET
1504;SULAWESI BARAT;MAMASA;TABULAHAN;TIMORO;43;12;22;0;6;1;0;2;0;43;0;MARET
1505;SULAWESI BARAT;MAMASA;TABULAHAN;LAKAHANG UTAMA;78;28;44;0;2;0;0;3;0;77;1;MARET
1506;SULAWESI BARAT;PASANGKAYU;LARIANG;PARABU;136;29;22;9;38;21;0;9;0;128;8;MARET
1507;SULAWESI BARAT;PASANGKAYU;LARIANG;KENANGAN;54;12;6;2;20;7;0;5;0;52;2;MARET
1508;SULAWESI BARAT;PASANGKAYU;LARIANG;BAJAWALI;129;30;23;1;50;13;0;12;0;129;0;MARET
1509;SULAWESI BARAT;PASANGKAYU;LARIANG;SINGGANI;186;71;56;0;37;9;0;9;0;182;4;MARET
1510;SULAWESI BARAT;PASANGKAYU;LARIANG;KULU;104;35;33;0;25;9;0;1;0;103;1;MARET
1511;SULAWESI BARAT;PASANGKAYU;LARIANG;BATU MATORU;93;32;19;0;24;8;0;10;0;93;0;MARET
1512;SULAWESI BARAT;PASANGKAYU;LARIANG;BAMBAKORO;150;55;31;1;44;11;0;8;0;150;0;MARET
1513;SULAWESI BARAT;MAMUJU TENGAH;TOBADAK;MAHAHE;320;133;65;10;88;10;0;10;3;319;1;MARET
1514;SULAWESI BARAT;MAMUJU TENGAH;TOBADAK;SALOBAJA;375;206;50;14;89;7;0;9;0;375;0;MARET
1515;SULAWESI BARAT;MAMUJU TENGAH;TOBADAK;TOBADAK;1349;583;282;25;325;40;3;29;1;1288;61;MARET
1516;SULAWESI BARAT;MAMUJU TENGAH;TOBADAK;PALONGAAN;275;96;83;3;74;4;0;14;0;274;1;MARET
1517;SULAWESI BARAT;MAMUJU TENGAH;TOBADAK;BATU PARIGI;723;167;233;7;261;23;1;21;0;713;10;MARET
1518;SULAWESI BARAT;MAMUJU TENGAH;TOBADAK;BAMBADARU;194;68;52;10;56;1;1;6;0;194;0;MARET
1519;SULAWESI BARAT;MAMUJU TENGAH;TOBADAK;SEJATI;154;88;29;3;27;2;0;5;0;154;0;MARET
1520;SULAWESI BARAT;MAMUJU TENGAH;TOBADAK;SALOADAK;258;118;13;2;105;10;0;7;0;255;3;MARET
1521;SULAWESI BARAT;PASANGKAYU;DURIPOKU;TAMMARUNANG;215;80;48;15;53;6;0;13;0;215;0;MARET
1522;SULAWESI BARAT;PASANGKAYU;DURIPOKU;SAPTANAJAYA;205;113;39;1;37;10;0;5;0;205;0;MARET
1523;SULAWESI BARAT;PASANGKAYU;DURIPOKU;TARANGGI;91;15;21;5;40;8;0;2;0;91;0;MARET
1524;SULAWESI BARAT;PASANGKAYU;DURIPOKU;SIPAKAINGA;79;41;23;1;11;2;0;1;0;79;0;MARET
1525;SULAWESI BARAT;MAMASA;TAWALIAN;TAWALIAN;249;117;42;0;72;8;0;8;0;247;2;MARET
1526;SULAWESI BARAT;MAMASA;TAWALIAN;TAWALIAN TIMUR;169;70;50;2;43;1;0;1;0;167;2;MARET
1527;SULAWESI BARAT;MAMASA;TAWALIAN;KARIANGO;208;78;52;0;78;0;0;0;0;208;0;MARET
1528;SULAWESI BARAT;MAMASA;TAWALIAN;RANTETANGNGA;141;25;36;5;67;4;0;3;0;140;1;MARET
1529;SULAWESI BARAT;PASANGKAYU;DAPURANG;DAPURANG;397;218;64;4;74;20;1;6;0;387;10;MARET
1530;SULAWESI BARAT;PASANGKAYU;DAPURANG;BENGGAULU;281;119;73;0;68;6;0;14;0;280;1;MARET
1531;SULAWESI BARAT;PASANGKAYU;DAPURANG;TIRTABUANA;147;87;15;2;36;2;0;5;0;147;0;MARET
1532;SULAWESI BARAT;PASANGKAYU;DAPURANG;BULU BONGGU;252;68;47;2;119;6;0;4;0;246;6;MARET
1533;SULAWESI BARAT;PASANGKAYU;DAPURANG;SARASA;190;108;51;1;20;6;0;4;0;190;0;MARET
1534;SULAWESI BARAT;MAMUJU TENGAH;PANGALE;POLO PANGALE;243;62;56;7;111;3;0;3;0;242;1;MARET
1535;SULAWESI BARAT;MAMUJU TENGAH;PANGALE;PANGALE;219;59;87;13;43;5;2;10;0;219;0;MARET
1536;SULAWESI BARAT;MAMUJU TENGAH;PANGALE;SARTANAMAJU;84;30;19;10;18;2;0;5;0;84;0;MARET
1537;SULAWESI BARAT;MAMUJU TENGAH;PANGALE;POLO LERENG;223;70;51;6;84;4;0;4;0;219;4;MARET
1538;SULAWESI BARAT;MAMUJU TENGAH;PANGALE;KUO;429;212;66;2;127;12;0;8;2;429;0;MARET
1539;SULAWESI BARAT;MAMUJU TENGAH;PANGALE;POLO CAMBA;144;49;42;11;36;1;0;2;3;144;0;MARET
1540;SULAWESI BARAT;MAMUJU TENGAH;PANGALE;LAMBA-LAMBA;128;45;35;3;41;2;0;2;0;128;0;MARET
1541;SULAWESI BARAT;MAMUJU TENGAH;PANGALE;KOMBILING;248;74;62;6;92;2;0;9;0;245;3;MARET
1542;SULAWESI BARAT;MAMUJU TENGAH;PANGALE;LEMO-LEMO;130;50;40;1;36;2;1;0;0;130;0;MARET
1543;SULAWESI BARAT;MAMUJU TENGAH;BUDONG-BUDONG;BABANA;595;289;97;10;161;21;2;14;0;594;1;MARET
1544;SULAWESI BARAT;MAMUJU TENGAH;BUDONG-BUDONG;LUMU;243;104;32;0;94;3;0;8;0;241;2;MARET
1545;SULAWESI BARAT;MAMUJU TENGAH;BUDONG-BUDONG;PONTANAKAYANG;338;207;27;8;85;4;0;0;1;332;6;MARET
1546;SULAWESI BARAT;MAMUJU TENGAH;BUDONG-BUDONG;SALOGATTA;541;196;102;13;194;11;0;7;0;523;18;MARET
1547;SULAWESI BARAT;MAMUJU TENGAH;BUDONG-BUDONG;KIRE;190;65;37;3;82;1;0;2;0;190;0;MARET
1548;SULAWESI BARAT;MAMUJU TENGAH;BUDONG-BUDONG;TINALI;221;102;41;0;69;2;0;7;0;221;0;MARET
1549;SULAWESI BARAT;MAMUJU TENGAH;BUDONG-BUDONG;SALUMANURUNG;151;70;44;3;26;2;0;6;0;151;0;MARET
1550;SULAWESI BARAT;MAMUJU TENGAH;BUDONG-BUDONG;PASAPA;174;82;51;1;27;0;0;8;0;169;5;MARET
1551;SULAWESI BARAT;MAMUJU TENGAH;BUDONG-BUDONG;BOJO;244;108;57;1;68;6;0;4;0;244;0;MARET
1552;SULAWESI BARAT;MAMUJU TENGAH;BUDONG-BUDONG;BARAKKANG;115;56;17;5;35;1;0;1;0;115;0;MARET
1553;SULAWESI BARAT;MAMUJU TENGAH;BUDONG-BUDONG;LEMBAH HADA;57;28;7;0;20;1;0;1;0;57;0;MARET
1554;SULAWESI BARAT;PASANGKAYU;BULU TABA;LILIMORI;290;109;38;7;81;33;0;22;0;290;0;MARET
1555;SULAWESI BARAT;PASANGKAYU;BULU TABA;KARAVE;255;97;44;21;62;10;0;9;0;243;12;MARET
1556;SULAWESI BARAT;PASANGKAYU;BULU TABA;BUKIT HARAPAN;144;59;38;0;34;9;1;3;0;144;0;MARET
1557;SULAWESI BARAT;PASANGKAYU;BULU TABA;KASTABUANA;157;88;27;1;26;7;0;7;0;156;1;MARET
1558;SULAWESI BARAT;PASANGKAYU;BULU TABA;SUMBER SARI;29;21;5;0;3;0;0;0;0;29;0;MARET
1559;SULAWESI BARAT;PASANGKAYU;BULU TABA;LELEJAE;165;72;27;2;42;11;0;9;1;164;1;MARET
1560;SULAWESI BARAT;PASANGKAYU;BULU TABA;OMPI;101;45;31;3;18;3;0;1;0;101;0;MARET
1561;SULAWESI BARAT;PASANGKAYU;BAMBAIRA;BAMBAIRA;258;67;37;8;120;10;0;13;0;255;3;MARET
1562;SULAWESI BARAT;PASANGKAYU;BAMBAIRA;KASOLOANG;173;65;23;0;64;11;0;10;0;173;0;MARET
1563;SULAWESI BARAT;PASANGKAYU;BAMBAIRA;TAMPAURE;243;107;53;2;57;6;0;12;0;237;6;MARET
1564;SULAWESI BARAT;PASANGKAYU;BAMBAIRA;KALUKU NANGKA;293;133;73;3;67;5;0;12;0;293;0;MARET
1565;SULAWESI BARAT;MAMASA;MAMBI;MAMBI;78;45;22;2;8;1;0;0;0;78;0;MARET
1566;SULAWESI BARAT;MAMASA;MAMBI;TALIPUKKI;120;89;13;3;9;2;0;3;0;119;1;MARET
1567;SULAWESI BARAT;MAMASA;MAMBI;RANTEBULAHAN;56;17;29;0;7;1;0;1;0;55;1;MARET
1568;SULAWESI BARAT;MAMASA;MAMBI;SONDONGLAYU;36;17;5;2;7;0;0;5;0;36;0;MARET
1569;SULAWESI BARAT;MAMASA;MAMBI;SALUBANUA;36;14;20;0;1;0;0;0;0;35;1;MARET
1570;SULAWESI BARAT;MAMASA;MAMBI;TAPALINA;113;76;30;6;0;0;0;0;0;112;1;MARET
1571;SULAWESI BARAT;MAMASA;MAMBI;SENDANA;154;65;72;3;14;0;0;0;0;154;0;MARET
1572;SULAWESI BARAT;MAMASA;MAMBI;PAMOSEAN;52;41;8;3;0;0;0;0;0;52;0;MARET
1573;SULAWESI BARAT;MAMASA;MAMBI;SELUMAKA;125;30;95;0;0;0;0;0;0;125;0;MARET
1574;SULAWESI BARAT;MAMASA;MAMBI;BUJUNG MANURUNG;44;22;18;1;2;1;0;0;0;44;0;MARET
1575;SULAWESI BARAT;MAMASA;MAMBI;SALU ALO;80;24;49;0;7;0;0;0;0;80;0;MARET
1576;SULAWESI BARAT;MAMASA;MAMBI;INDOBANUA;28;10;11;0;1;6;0;0;0;28;0;MARET
1577;SULAWESI BARAT;MAMASA;MAMBI;SALUDURIAN;85;25;50;0;8;1;0;1;0;85;0;MARET
1578;SULAWESI BARAT;MAMASA;BALLA;BALLA;169;22;29;1;90;13;0;12;1;168;1;MARET
1579;SULAWESI BARAT;MAMASA;BALLA;BALLA BARAT;89;39;14;0;35;0;0;1;0;89;0;MARET
1580;SULAWESI BARAT;MAMASA;BALLA;BALLA SATANETEAN;149;57;13;4;64;8;0;3;0;149;0;MARET
1581;SULAWESI BARAT;MAMASA;BALLA;BALLA TUMUKA;113;41;31;0;39;1;0;1;0;113;0;MARET
1582;SULAWESI BARAT;MAMASA;BALLA;SEPAKUAN;153;50;14;0;86;1;0;2;0;153;0;MARET
1583;SULAWESI BARAT;MAMASA;BALLA;PIDARA;65;25;9;0;29;1;0;1;0;65;0;MARET
1584;SULAWESI BARAT;MAMASA;BALLA;BAMBAPUANG;64;30;13;0;21;0;0;0;0;64;0;MARET
1585;SULAWESI BARAT;MAMASA;BALLA;BALLA TIMUR;37;7;2;0;24;1;0;3;0;37;0;MARET
1586;SULAWESI BARAT;MAMASA;BAMBANG;MOKALLANG;40;16;19;1;3;0;0;1;0;40;0;MARET
1587;SULAWESI BARAT;MAMASA;BAMBANG;MASOSO;44;18;13;0;13;0;0;0;0;44;0;MARET
1588;SULAWESI BARAT;MAMASA;BAMBANG;SALUASSING;125;88;22;6;8;0;0;1;0;125;0;MARET
1589;SULAWESI BARAT;MAMASA;BAMBANG;SALUBULO;58;28;12;0;13;1;0;0;0;54;4;MARET
1590;SULAWESI BARAT;MAMASA;BAMBANG;SALUKADI;78;32;37;0;9;0;0;0;0;78;0;MARET
1591;SULAWESI BARAT;MAMASA;BAMBANG;SALUKEPOPOK;110;54;18;9;27;1;0;0;0;109;1;MARET
1592;SULAWESI BARAT;MAMASA;BAMBANG;ULUMAMBI BARAT;61;24;37;0;0;0;0;0;0;61;0;MARET
1593;SULAWESI BARAT;MAMASA;BAMBANG;LIMBADEBATA;103;33;12;0;54;1;0;3;0;103;0;MARET
1594;SULAWESI BARAT;MAMASA;BAMBANG;TANETE TOMBA;56;27;26;0;3;0;0;0;0;56;0;MARET
1595;SULAWESI BARAT;MAMASA;BAMBANG;BAMBANG;132;82;18;1;24;3;0;3;0;131;1;MARET
1596;SULAWESI BARAT;MAMASA;BAMBANG;RANTELEMO;53;11;24;0;16;2;0;0;0;53;0;MARET
1597;SULAWESI BARAT;MAMASA;BAMBANG;SALUDENGEN;34;7;21;0;2;1;0;0;0;31;3;MARET
1598;SULAWESI BARAT;MAMASA;BAMBANG;ULUMAMBI;61;9;44;1;0;0;0;0;0;54;7;MARET
1599;SULAWESI BARAT;MAMASA;BAMBANG;BAMBANG TIMUR;63;37;22;0;2;1;0;1;0;63;0;MARET
1600;SULAWESI BARAT;MAMASA;BAMBANG;MINANGA;132;49;39;0;40;0;0;4;0;132;0;MARET
1601;SULAWESI BARAT;MAMASA;BAMBANG;SIKAMASE;56;17;38;0;1;0;0;0;0;56;0;MARET
1602;SULAWESI BARAT;MAMASA;BAMBANG;RANTETARIMA;30;4;26;0;0;0;0;0;0;30;0;MARET
1603;SULAWESI BARAT;MAMASA;BAMBANG;SALURURU;30;3;1;3;22;0;0;1;0;30;0;MARET
1604;SULAWESI BARAT;MAMASA;BAMBANG;SALUTABANG;35;19;11;1;1;2;0;1;0;35;0;MARET
1605;SULAWESI BARAT;MAMASA;BAMBANG;BALATANA;52;33;19;0;0;0;0;0;0;52;0;MARET
1606;SULAWESI BARAT;MAMUJU;TAPALANG;GALUNG;258;57;106;6;40;24;0;19;2;254;4;MARET
1607;SULAWESI BARAT;MAMUJU;TAPALANG;KASAMBANG;212;72;64;1;57;4;0;11;2;211;1;MARET
1608;SULAWESI BARAT;MAMUJU;TAPALANG;DAYANGINNA;122;34;38;9;25;6;0;7;0;119;3;MARET
1609;SULAWESI BARAT;MAMUJU;TAPALANG;OROBATU;89;34;25;12;6;6;0;6;0;89;0;MARET
1610;SULAWESI BARAT;MAMUJU;TAPALANG;TAKANDEANG;194;66;37;3;65;16;1;5;1;194;0;MARET
1611;SULAWESI BARAT;MAMUJU;TAPALANG;BELA;46;30;7;0;9;0;0;0;0;46;0;MARET
1612;SULAWESI BARAT;MAMUJU;TAPALANG;TAAN;240;89;83;2;54;3;0;8;0;239;1;MARET
1613;SULAWESI BARAT;MAMUJU;TAPALANG;TAMPALANG;171;78;23;1;53;4;0;11;1;171;0;MARET
1614;SULAWESI BARAT;MAMUJU;TAPALANG;RANTEDODA;71;36;12;7;10;0;0;6;0;71;0;MARET
1615;SULAWESI BARAT;MAMUJU;TAPALANG;KOPEANG;71;41;22;0;8;0;0;0;0;71;0;MARET
1616;SULAWESI BARAT;MAMUJU;KALUKKU;SINYONYOI;449;237;129;9;47;4;0;11;0;437;12;MARET
1617;SULAWESI BARAT;MAMUJU;KALUKKU;BEBANGA;754;451;202;4;65;5;2;22;0;751;3;MARET
1618;SULAWESI BARAT;MAMUJU;KALUKKU;KALUKKU;685;232;190;7;183;24;1;28;0;665;20;MARET
1619;SULAWESI BARAT;MAMUJU;KALUKKU;SINYONYOI SELATAN;270;128;75;5;31;3;0;22;0;264;6;MARET
1620;SULAWESI BARAT;MAMUJU;KALUKKU;SONDOANG;271;116;82;1;65;1;0;4;1;270;1;MARET
1621;SULAWESI BARAT;MAMUJU;KALUKKU;BERU-BERU;553;311;94;2;132;3;0;10;1;553;0;MARET
1622;SULAWESI BARAT;MAMUJU;KALUKKU;BELANG BELANG;382;175;116;2;75;2;0;12;0;382;0;MARET
1623;SULAWESI BARAT;MAMUJU;KALUKKU;KABULOANG;351;136;127;2;72;1;1;8;1;348;3;MARET
1624;SULAWESI BARAT;MAMUJU;KALUKKU;KEANG;234;68;130;1;28;1;0;4;0;232;2;MARET
1625;SULAWESI BARAT;MAMUJU;KALUKKU;POKKANG;197;81;39;2;63;3;1;8;0;197;0;MARET
1626;SULAWESI BARAT;MAMUJU;KALUKKU;GULILING;139;43;57;0;32;1;0;2;3;138;1;MARET
1627;SULAWESI BARAT;MAMUJU;KALUKKU;UHAIMATE;121;79;34;1;7;0;0;0;0;121;0;MARET
1628;SULAWESI BARAT;MAMUJU;KALUKKU;KALUKKU BARAT;479;285;65;1;122;2;0;4;0;479;0;MARET
1629;SULAWESI BARAT;MAMUJU;KALUKKU;PAMMULUKANG;229;117;75;7;17;0;0;11;1;228;1;MARET
1630;SULAWESI BARAT;MAMASA;MAMASA;MAMASA;366;59;44;3;181;60;0;19;0;366;0;MARET
1631;SULAWESI BARAT;MAMASA;MAMASA;RAMBUSARATU;255;90;82;14;52;11;0;6;0;255;0;MARET
1632;SULAWESI BARAT;MAMASA;MAMASA;OSANGO;476;89;73;10;193;92;0;14;1;472;4;MARET
1633;SULAWESI BARAT;MAMASA;MAMASA;LAMBANAN;223;67;54;9;78;6;0;9;0;223;0;MARET
1634;SULAWESI BARAT;MAMASA;MAMASA;LEMBANA SALULO;90;18;14;1;46;5;0;6;0;90;0;MARET
1635;SULAWESI BARAT;MAMASA;MAMASA;TAUPE;233;54;27;9;139;1;1;2;0;233;0;MARET
1636;SULAWESI BARAT;MAMASA;MAMASA;BUNTU BUDA;299;76;29;8;107;29;0;5;1;255;44;MARET
1637;SULAWESI BARAT;MAMASA;MAMASA;TONDOK BAKARU;266;91;82;14;60;10;0;8;0;265;1;MARET
1638;SULAWESI BARAT;MAMASA;MAMASA;PEBASSIAN;93;20;29;2;38;2;0;2;0;93;0;MARET
1639;SULAWESI BARAT;MAMASA;MAMASA;MAMBULILING;117;56;19;1;37;3;0;1;0;117;0;MARET
1640;SULAWESI BARAT;MAMASA;MAMASA;BOMBONG LAMBE;150;43;21;2;69;14;0;1;0;150;0;MARET
1641;SULAWESI BARAT;MAMASA;MAMASA;BUBUN BATU;127;24;7;7;76;2;0;2;0;118;9;MARET
1642;SULAWESI BARAT;MAMASA;BUNTUMALANGKA;BUNTUMALANGKA;130;26;68;1;25;4;0;5;0;129;1;MARET
1643;SULAWESI BARAT;MAMASA;BUNTUMALANGKA;RANTEBERAN;122;58;57;0;6;0;0;1;0;122;0;MARET
1644;SULAWESI BARAT;MAMASA;BUNTUMALANGKA;KEBANGA;52;8;29;0;14;0;0;0;1;52;0;MARET
1645;SULAWESI BARAT;MAMASA;BUNTUMALANGKA;SALURINDU;52;23;19;1;7;0;0;2;0;52;0;MARET
1646;SULAWESI BARAT;MAMASA;BUNTUMALANGKA;TAORA;49;14;31;0;2;0;0;2;0;49;0;MARET
1647;SULAWESI BARAT;MAMASA;BUNTUMALANGKA;KABAE;79;11;63;0;4;0;0;1;0;79;0;MARET
1648;SULAWESI BARAT;MAMASA;BUNTUMALANGKA;SALUTAMBUN BARAT;60;25;34;0;1;0;0;0;0;60;0;MARET
1649;SULAWESI BARAT;MAMASA;BUNTUMALANGKA;PENATANGAN;121;44;46;0;22;2;1;1;1;117;4;MARET
1650;SULAWESI BARAT;MAMASA;BUNTUMALANGKA;SALUTAMBUN TIMUR;49;13;34;0;1;0;0;1;0;49;0;MARET
1651;SULAWESI BARAT;MAMASA;BUNTUMALANGKA;SALUTAMBUN;38;9;22;0;3;2;0;2;0;38;0;MARET
1652;SULAWESI BARAT;MAMASA;BUNTUMALANGKA;ARALLE TIMUR;103;24;68;0;3;0;0;1;0;96;7;MARET
1653;SULAWESI BARAT;MAMUJU;MAMUJU;BINANGA;780;453;159;16;69;52;1;17;4;771;9;MARET
1654;SULAWESI BARAT;MAMUJU;MAMUJU;MAMUNYU;614;319;165;39;47;25;1;14;0;610;4;MARET
1655;SULAWESI BARAT;MAMUJU;MAMUJU;KAREMA;863;450;124;39;98;61;2;31;0;805;58;MARET
1656;SULAWESI BARAT;MAMUJU;MAMUJU;RIMUKU;704;306;157;36;51;74;2;31;1;658;46;MARET
1657;SULAWESI BARAT;MAMUJU;MAMUJU;BAMBU;388;228;77;15;47;5;0;16;0;388;0;MARET
1658;SULAWESI BARAT;MAMUJU;MAMUJU;KARAMPUANG;468;351;60;1;28;11;0;14;0;465;3;MARET
1659;SULAWESI BARAT;MAMUJU;MAMUJU;TADUI;496;166;217;1;56;7;0;28;3;478;18;MARET
1660;SULAWESI BARAT;MAMUJU;MAMUJU;BATU PANNU;185;132;33;0;13;3;0;4;0;185;0;MARET
1661;SULAWESI BARAT;MAMASA;MESSAWA;MESSAWA;35;8;19;0;6;0;0;2;0;35;0;MARET
1662;SULAWESI BARAT;MAMASA;MESSAWA;RIPPUNG;134;67;52;0;15;0;0;0;0;134;0;MARET
1663;SULAWESI BARAT;MAMASA;MESSAWA;MAKUANG;107;56;34;0;17;0;0;0;0;107;0;MARET
1664;SULAWESI BARAT;MAMASA;MESSAWA;SEPANG;72;45;25;0;2;0;0;0;0;72;0;MARET
1665;SULAWESI BARAT;MAMASA;MESSAWA;MALIMBONG;55;15;37;0;3;0;0;0;0;55;0;MARET
1666;SULAWESI BARAT;MAMASA;MESSAWA;MATANDE;85;18;57;6;4;0;0;0;0;85;0;MARET
1667;SULAWESI BARAT;MAMASA;MESSAWA;SIPAI;78;33;35;0;10;0;0;0;0;78;0;MARET
1668;SULAWESI BARAT;MAMASA;MESSAWA;PASMA MAMBU;48;16;22;0;10;0;0;0;0;48;0;MARET
1669;SULAWESI BARAT;MAMASA;MESSAWA;TANETE BATU;55;28;23;0;3;0;0;1;0;55;0;MARET
1670;SULAWESI BARAT;PASANGKAYU;TIKKE RAYA;TIKKE;322;94;61;4;101;41;0;12;0;313;9;MARET
1671;SULAWESI BARAT;PASANGKAYU;TIKKE RAYA;MAKMUR JAYA;478;182;119;5;124;25;0;19;1;475;3;MARET
1672;SULAWESI BARAT;PASANGKAYU;TIKKE RAYA;LARIANG;451;171;84;7;159;17;0;10;0;448;3;MARET
1673;SULAWESI BARAT;PASANGKAYU;TIKKE RAYA;PAJALELE;403;172;80;1;103;27;1;16;1;401;2;MARET
1674;SULAWESI BARAT;PASANGKAYU;TIKKE RAYA;JENGENG RAYA;239;87;48;6;70;21;0;7;0;239;0;MARET
1675;SULAWESI BARAT;POLEWALI MANDAR;LUYO;BATUPANGA;226;109;39;4;61;2;1;6;0;222;4;MARET
1676;SULAWESI BARAT;POLEWALI MANDAR;LUYO;MAMBU;195;97;27;2;42;1;1;13;3;186;9;MARET
1677;SULAWESI BARAT;POLEWALI MANDAR;LUYO;TENGGELANG;259;132;50;12;46;0;1;7;0;248;11;MARET
1678;SULAWESI BARAT;POLEWALI MANDAR;LUYO;BARU;248;82;57;25;40;6;0;22;0;232;16;MARET
1679;SULAWESI BARAT;POLEWALI MANDAR;LUYO;PUSSUI;174;92;32;2;40;0;1;5;1;173;1;MARET
1680;SULAWESI BARAT;POLEWALI MANDAR;LUYO;MAPILI BARAT;185;109;38;11;17;0;0;10;0;185;0;MARET
1681;SULAWESI BARAT;POLEWALI MANDAR;LUYO;SAMBALI WALI;254;144;40;14;39;2;0;3;0;242;12;MARET
1682;SULAWESI BARAT;POLEWALI MANDAR;LUYO;BATUPANGA DAALA;311;149;47;3;105;0;1;5;0;310;1;MARET
1683;SULAWESI BARAT;POLEWALI MANDAR;LUYO;LUYO;195;115;18;0;44;2;3;12;0;194;1;MARET
1684;SULAWESI BARAT;POLEWALI MANDAR;LUYO;PUSSUI BARAT;106;49;11;3;25;13;1;3;0;105;1;MARET
1685;SULAWESI BARAT;POLEWALI MANDAR;LUYO;PUCCADI;200;145;21;0;26;2;0;6;0;200;0;MARET
1686;SULAWESI BARAT;POLEWALI MANDAR;BALANIPA;BALANIPA;195;93;36;15;34;6;0;11;0;195;0;MARET
1687;SULAWESI BARAT;POLEWALI MANDAR;BALANIPA;TAMMAJARRA;179;120;16;24;12;4;0;3;0;179;0;MARET
1688;SULAWESI BARAT;POLEWALI MANDAR;BALANIPA;TAMANGGALLE;103;54;16;1;29;1;0;1;1;103;0;MARET
1689;SULAWESI BARAT;POLEWALI MANDAR;BALANIPA;MOSSO;78;53;17;5;3;0;0;0;0;78;0;MARET
1690;SULAWESI BARAT;POLEWALI MANDAR;BALANIPA;GALUNG TULUK;200;104;44;20;20;1;0;11;0;200;0;MARET
1691;SULAWESI BARAT;POLEWALI MANDAR;BALANIPA;SABANG SUBIK;205;120;25;9;29;3;0;19;0;205;0;MARET
1692;SULAWESI BARAT;POLEWALI MANDAR;BALANIPA;PAMBUSUANG;422;249;70;12;27;11;0;24;1;394;28;MARET
1693;SULAWESI BARAT;POLEWALI MANDAR;BALANIPA;BALA;325;253;24;3;19;4;0;19;0;322;3;MARET
1694;SULAWESI BARAT;POLEWALI MANDAR;BALANIPA;LAMBANAN;17;6;3;5;3;0;0;0;0;17;0;MARET
1695;SULAWESI BARAT;POLEWALI MANDAR;BALANIPA;LEGO;106;68;25;0;5;0;0;8;0;106;0;MARET
1696;SULAWESI BARAT;POLEWALI MANDAR;BALANIPA;PALLIS;24;11;7;1;3;1;0;1;0;24;0;MARET
1697;SULAWESI BARAT;MAMUJU;TOMMO;TOMMO;349;134;79;0;122;5;0;9;0;349;0;MARET
1698;SULAWESI BARAT;MAMUJU;TOMMO;CAMPALOGA;302;91;124;11;65;7;0;0;0;298;4;MARET
1699;SULAWESI BARAT;MAMUJU;TOMMO;BUANA SAKTI;213;82;47;1;82;1;0;0;0;213;0;MARET
1700;SULAWESI BARAT;MAMUJU;TOMMO;TAMEMONGGA;240;86;114;0;35;2;0;3;0;240;0;MARET
1701;SULAWESI BARAT;MAMUJU;TOMMO;TAMEJARRA;194;70;47;5;53;7;1;11;0;194;0;MARET
1702;SULAWESI BARAT;MAMUJU;TOMMO;RANTEMARIO;164;65;68;3;17;6;0;5;0;164;0;MARET
1703;SULAWESI BARAT;MAMUJU;TOMMO;MALINO;74;38;19;9;4;1;0;2;0;73;1;MARET
1704;SULAWESI BARAT;MAMUJU;TOMMO;KAKULLASANG;368;152;146;7;51;1;0;6;0;363;5;MARET
1705;SULAWESI BARAT;MAMUJU;TOMMO;LELING;131;38;64;0;28;0;0;1;0;131;0;MARET
1706;SULAWESI BARAT;MAMUJU;TOMMO;KALEPU;103;54;43;1;4;1;0;0;0;103;0;MARET
1707;SULAWESI BARAT;MAMUJU;TOMMO;SANDANA;132;47;54;1;18;2;0;9;1;132;0;MARET
1708;SULAWESI BARAT;MAMUJU;TOMMO;LELING BARAT;208;67;82;1;47;6;0;3;0;206;2;MARET
1709;SULAWESI BARAT;MAMUJU;TOMMO;LELING UTARA;196;81;91;0;24;0;0;0;0;196;0;MARET
1710;SULAWESI BARAT;MAMUJU;TOMMO;SALUDENGEN;132;69;55;1;6;0;0;1;0;132;0;MARET
1711;SULAWESI BARAT;MAMUJU;TAPALANG BARAT;DUNGKAIT;244;103;96;5;32;3;1;2;0;242;2;MARET
1712;SULAWESI BARAT;MAMUJU;TAPALANG BARAT;LEBANI;113;37;52;0;7;0;0;4;2;102;11;MARET
1713;SULAWESI BARAT;MAMUJU;TAPALANG BARAT;LABUANG RANO;224;113;85;0;10;4;0;2;0;214;10;MARET
1714;SULAWESI BARAT;MAMUJU;TAPALANG BARAT;PASABU;159;43;68;7;15;8;0;13;2;156;3;MARET
1715;SULAWESI BARAT;MAMUJU;TAPALANG BARAT;TANETE PAO;44;33;9;0;1;0;0;0;0;43;1;MARET
1716;SULAWESI BARAT;MAMUJU;TAPALANG BARAT;PANGASAAN;55;23;19;2;6;4;0;0;0;54;1;MARET
1717;SULAWESI BARAT;MAMUJU;TAPALANG BARAT;AHU;167;92;57;2;6;0;0;2;0;159;8;MARET
1718;SULAWESI BARAT;POLEWALI MANDAR;CAMPALAGIAN;PAPPANG;148;82;14;9;8;7;0;13;1;134;14;MARET
1719;SULAWESI BARAT;POLEWALI MANDAR;CAMPALAGIAN;LALIKO;169;109;33;2;6;3;0;16;0;169;0;MARET
1720;SULAWESI BARAT;POLEWALI MANDAR;CAMPALAGIAN;BONDE;170;95;36;5;12;10;0;12;0;170;0;MARET
1721;SULAWESI BARAT;POLEWALI MANDAR;CAMPALAGIAN;KATUMBANGAN LEMO;142;84;24;13;14;5;0;2;0;142;0;MARET
1722;SULAWESI BARAT;POLEWALI MANDAR;CAMPALAGIAN;PANYAMPA;194;127;41;2;7;3;0;11;2;193;1;MARET
1723;SULAWESI BARAT;POLEWALI MANDAR;CAMPALAGIAN;SURUANG;151;78;40;11;8;2;0;7;0;146;5;MARET
1724;SULAWESI BARAT;POLEWALI MANDAR;CAMPALAGIAN;LAMPOKO;217;136;54;9;9;2;0;7;0;217;0;MARET
1725;SULAWESI BARAT;POLEWALI MANDAR;CAMPALAGIAN;KATUMBANGAN;273;120;39;4;58;39;0;13;0;273;0;MARET
1726;SULAWESI BARAT;POLEWALI MANDAR;CAMPALAGIAN;LAPEO;110;65;12;6;12;3;0;11;0;109;1;MARET
1727;SULAWESI BARAT;POLEWALI MANDAR;CAMPALAGIAN;PARAPPE;220;133;45;3;33;3;0;1;0;218;2;MARET
1728;SULAWESI BARAT;POLEWALI MANDAR;CAMPALAGIAN;ONGKO;90;29;12;10;31;4;0;4;0;90;0;MARET
1729;SULAWESI BARAT;POLEWALI MANDAR;CAMPALAGIAN;KENJE;149;105;11;7;17;3;0;6;0;149;0;MARET
1730;SULAWESI BARAT;POLEWALI MANDAR;CAMPALAGIAN;SUMARRANG;435;239;126;4;60;6;0;0;0;435;0;MARET
1731;SULAWESI BARAT;POLEWALI MANDAR;CAMPALAGIAN;BOTTO;246;121;57;0;56;3;0;7;0;244;2;MARET
1732;SULAWESI BARAT;POLEWALI MANDAR;CAMPALAGIAN;GATTUNGAN;159;50;19;20;44;16;0;9;0;158;1;MARET
1733;SULAWESI BARAT;POLEWALI MANDAR;CAMPALAGIAN;PADANG TIMUR;130;64;20;4;35;2;0;5;0;130;0;MARET
1734;SULAWESI BARAT;POLEWALI MANDAR;CAMPALAGIAN;PADANG;66;38;8;3;12;0;0;0;0;61;5;MARET
1735;SULAWESI BARAT;POLEWALI MANDAR;CAMPALAGIAN;LAGI-AGI;208;168;14;3;14;3;0;6;0;208;0;MARET
1736;SULAWESI BARAT;POLEWALI MANDAR;BULO;BULO;105;22;7;2;72;2;0;0;0;105;0;MARET
1737;SULAWESI BARAT;POLEWALI MANDAR;BULO;PULLIWA;306;101;50;3;138;3;0;10;0;305;1;MARET
1738;SULAWESI BARAT;POLEWALI MANDAR;BULO;PATAMBANUA;143;28;103;0;9;0;0;1;0;141;2;MARET
1739;SULAWESI BARAT;POLEWALI MANDAR;BULO;KAROMBANG;138;79;22;0;34;2;0;1;0;138;0;MARET
1740;SULAWESI BARAT;POLEWALI MANDAR;BULO;DAALA TIMUR;125;42;61;2;19;0;0;1;0;125;0;MARET
1741;SULAWESI BARAT;POLEWALI MANDAR;BULO;LENGGO;48;15;30;1;1;1;0;0;0;48;0;MARET
1742;SULAWESI BARAT;POLEWALI MANDAR;BULO;SABURA;68;29;29;0;9;0;0;1;0;68;0;MARET
1743;SULAWESI BARAT;POLEWALI MANDAR;BULO;SEPPORRAKI;97;28;24;0;43;0;0;2;0;97;0;MARET
1744;SULAWESI BARAT;POLEWALI MANDAR;BULO;IHING;108;20;24;2;56;1;0;1;0;104;4;MARET
1745;SULAWESI BARAT;POLEWALI MANDAR;POLEWALI;POLEWALI;512;160;147;41;79;30;0;43;0;500;12;MARET
1746;SULAWESI BARAT;POLEWALI MANDAR;POLEWALI;WATTANG;194;56;65;12;28;16;0;17;0;194;0;MARET
1747;SULAWESI BARAT;POLEWALI MANDAR;POLEWALI;SULEWATANG;336;87;156;3;71;7;0;12;0;336;0;MARET
1748;SULAWESI BARAT;POLEWALI MANDAR;POLEWALI;LANTORA;405;110;168;18;48;36;0;25;0;405;0;MARET
1749;SULAWESI BARAT;POLEWALI MANDAR;POLEWALI;TAKATIDUNG;481;237;93;17;76;20;0;20;0;463;18;MARET
1750;SULAWESI BARAT;POLEWALI MANDAR;POLEWALI;PEKKABATA;319;149;58;27;41;27;0;16;0;318;1;MARET
1751;SULAWESI BARAT;POLEWALI MANDAR;POLEWALI;MADATE;536;199;148;61;81;18;0;29;0;536;0;MARET
1752;SULAWESI BARAT;POLEWALI MANDAR;POLEWALI;MANDING;408;141;99;16;96;21;0;34;0;407;1;MARET
1753;SULAWESI BARAT;POLEWALI MANDAR;POLEWALI;DARMA;501;200;128;15;113;15;0;30;0;501;0;MARET
1754;SULAWESI BARAT;POLEWALI MANDAR;MAPILLI;MAPILI;109;42;9;6;34;4;0;14;0;109;0;MARET
1755;SULAWESI BARAT;POLEWALI MANDAR;MAPILLI;UGIBARU;179;56;16;24;32;8;0;25;0;161;18;MARET
1756;SULAWESI BARAT;POLEWALI MANDAR;MAPILLI;RUMPA;162;86;19;2;46;5;0;4;0;162;0;MARET
1757;SULAWESI BARAT;POLEWALI MANDAR;MAPILLI;KURMA;299;171;51;0;62;1;0;14;0;299;0;MARET
1758;SULAWESI BARAT;POLEWALI MANDAR;MAPILLI;BUKU;231;160;34;4;25;2;0;2;0;227;4;MARET
1759;SULAWESI BARAT;POLEWALI MANDAR;MAPILLI;BONNE BONNE;129;44;20;10;39;9;0;7;0;129;0;MARET
1760;SULAWESI BARAT;POLEWALI MANDAR;MAPILLI;BEROANGIN;217;72;26;1;95;4;0;13;1;212;5;MARET
1761;SULAWESI BARAT;POLEWALI MANDAR;MAPILLI;SEGERANG;164;104;30;3;20;1;0;6;0;164;0;MARET
1762;SULAWESI BARAT;POLEWALI MANDAR;MAPILLI;BONRA;173;86;47;2;28;1;0;9;0;173;0;MARET
1763;SULAWESI BARAT;POLEWALI MANDAR;MAPILLI;SATTOKO;70;19;6;0;41;0;0;4;0;70;0;MARET
1764;SULAWESI BARAT;POLEWALI MANDAR;MAPILLI;RAPPANG BARAT;311;102;107;5;68;4;0;24;0;310;1;MARET
1765;SULAWESI BARAT;POLEWALI MANDAR;MAPILLI;LANDI KANUSUANG;328;128;39;1;142;0;0;18;0;328;0;MARET
1766;SULAWESI BARAT;POLEWALI MANDAR;MATAKALI;MATAKALI;316;139;83;16;54;12;0;12;0;316;0;MARET
1767;SULAWESI BARAT;POLEWALI MANDAR;MATAKALI;PETAMPANUA;282;131;94;3;33;14;2;5;0;282;0;MARET
1768;SULAWESI BARAT;POLEWALI MANDAR;MATAKALI;BARUMBUNG;201;83;63;5;41;6;0;3;0;201;0;MARET
1769;SULAWESI BARAT;POLEWALI MANDAR;MATAKALI;PASIANG;413;149;87;11;135;8;0;19;0;409;4;MARET
1770;SULAWESI BARAT;POLEWALI MANDAR;MATAKALI;TONROLIMA;234;123;50;2;35;4;0;10;2;226;8;MARET
1771;SULAWESI BARAT;POLEWALI MANDAR;MATAKALI;INDOMAKKOMBONG;382;188;101;1;69;5;0;10;2;376;6;MARET
1772;SULAWESI BARAT;POLEWALI MANDAR;MATAKALI;BUNGA-BUNGA;145;65;49;6;20;1;0;4;0;145;0;MARET
1773;SULAWESI BARAT;MAMUJU;PAPALANG;TOABO;653;288;149;4;197;10;0;3;1;652;1;MARET
1774;SULAWESI BARAT;MAMUJU;PAPALANG;PAPALANG;678;316;172;7;137;2;0;5;0;639;39;MARET
1775;SULAWESI BARAT;MAMUJU;PAPALANG;BONDA;314;175;90;1;44;1;0;2;0;313;1;MARET
1776;SULAWESI BARAT;MAMUJU;PAPALANG;TOPORE;197;108;40;7;33;1;0;2;0;191;6;MARET
1777;SULAWESI BARAT;MAMUJU;PAPALANG;SALUKAYU;249;127;84;0;30;2;0;6;0;249;0;MARET
1778;SULAWESI BARAT;MAMUJU;PAPALANG;SUKADAMAI;109;59;33;1;11;0;0;5;0;109;0;MARET
1779;SULAWESI BARAT;MAMUJU;PAPALANG;BODA-BODA;176;100;53;1;20;0;0;1;0;175;1;MARET
1780;SULAWESI BARAT;MAMUJU;PAPALANG;SISANGO;104;31;62;0;6;3;0;1;0;103;1;MARET
1781;SULAWESI BARAT;MAMUJU;PAPALANG;BATU AMPA;171;56;86;11;17;0;0;1;0;171;0;MARET
1782;SULAWESI BARAT;MAMUJU;SIMBORO;SIMBORO;1537;613;177;68;164;249;1;65;5;1342;195;MARET
1783;SULAWESI BARAT;MAMUJU;SIMBORO;RANGAS;550;173;146;18;121;19;3;10;0;490;60;MARET
1784;SULAWESI BARAT;MAMUJU;SIMBORO;BOTTENG;189;113;39;1;21;2;0;12;0;188;1;MARET
1785;SULAWESI BARAT;MAMUJU;SIMBORO;SALETTO;289;132;78;5;45;6;1;22;0;289;0;MARET
1786;SULAWESI BARAT;MAMUJU;SIMBORO;SUMARE;224;103;83;2;25;10;0;1;0;224;0;MARET
1787;SULAWESI BARAT;MAMUJU;SIMBORO;BOTTENG UTARA;357;149;87;1;99;4;1;0;0;341;16;MARET
1788;SULAWESI BARAT;MAMUJU;SIMBORO;TAPANDULLU;43;28;1;0;10;0;2;2;0;43;0;MARET
1789;SULAWESI BARAT;MAMUJU;SIMBORO;PATI'DI;191;109;42;2;34;1;0;3;0;191;0;MARET
1790;SULAWESI BARAT;POLEWALI MANDAR;LIMBORO;LIMBORO;117;38;25;14;18;3;0;9;0;107;10;MARET
1791;SULAWESI BARAT;POLEWALI MANDAR;LIMBORO;LEMBANG LEMBANG;219;90;48;32;32;5;0;12;0;219;0;MARET
1792;SULAWESI BARAT;POLEWALI MANDAR;LIMBORO;TANDASURA;140;75;16;12;25;2;0;8;0;138;2;MARET
1793;SULAWESI BARAT;POLEWALI MANDAR;LIMBORO;SAMASUNDU;140;45;48;9;26;6;0;6;0;140;0;MARET
1794;SULAWESI BARAT;POLEWALI MANDAR;LIMBORO;NAPO;159;89;23;3;35;0;0;9;0;159;0;MARET
1795;SULAWESI BARAT;POLEWALI MANDAR;LIMBORO;TODANG TODANG;37;16;15;4;2;0;0;0;0;37;0;MARET
1796;SULAWESI BARAT;POLEWALI MANDAR;LIMBORO;PENDULANGAN;56;33;19;0;1;0;0;3;0;56;0;MARET
1797;SULAWESI BARAT;POLEWALI MANDAR;LIMBORO;RENGGEANG;100;36;26;5;29;0;0;4;0;100;0;MARET
1798;SULAWESI BARAT;POLEWALI MANDAR;LIMBORO;SALARRI;51;18;15;6;11;0;0;1;0;51;0;MARET
1799;SULAWESI BARAT;POLEWALI MANDAR;LIMBORO;TANGAN BARU;79;28;11;2;33;0;0;5;0;79;0;MARET
1800;SULAWESI BARAT;POLEWALI MANDAR;LIMBORO;PALECE;117;28;40;31;12;3;0;3;0;117;0;MARET
1801;SULAWESI BARAT;MAJENE;SENDANA;MOSSO;333;153;85;5;58;19;1;10;1;332;1;MARET
1802;SULAWESI BARAT;MAJENE;SENDANA;MOSSO DHUA;85;26;21;4;8;11;2;5;0;77;8;MARET
1803;SULAWESI BARAT;MAJENE;SENDANA;TOTOLISI SENDANA;115;36;38;4;19;8;1;7;0;113;2;MARET
1804;SULAWESI BARAT;MAJENE;SENDANA;TALLUBANUA;132;46;31;9;10;18;1;7;0;122;10;MARET
1805;SULAWESI BARAT;MAJENE;SENDANA;LALATEDZONG;91;29;18;4;16;15;0;5;2;89;2;MARET
1806;SULAWESI BARAT;MAJENE;SENDANA;BINANGA;69;32;12;6;11;5;1;2;0;69;0;MARET
1807;SULAWESI BARAT;MAJENE;SENDANA;PUTTADA;75;41;22;0;9;1;1;1;0;75;0;MARET
1808;SULAWESI BARAT;MAJENE;SENDANA;PAMINGGALAN;39;28;11;0;0;0;0;0;0;39;0;MARET
1809;SULAWESI BARAT;MAJENE;SENDANA;LEPPANGANG;57;28;15;0;8;2;0;4;0;57;0;MARET
1810;SULAWESI BARAT;MAJENE;SENDANA;PUNDAU;63;6;25;5;22;3;0;2;0;63;0;MARET
1811;SULAWESI BARAT;MAJENE;SENDANA;SENDANA;75;38;22;1;0;6;1;7;0;75;0;MARET
1812;SULAWESI BARAT;MAJENE;SENDANA;BANUA SENDANA;102;64;9;4;1;19;0;5;0;102;0;MARET
1813;SULAWESI BARAT;MAJENE;SENDANA;TALLUBANUA UTARA;153;70;43;2;5;29;0;4;0;153;0;MARET
1814;SULAWESI BARAT;MAJENE;SENDANA;LIMBORO RAMBU-RAMBU;94;19;32;2;34;4;0;0;0;91;3;MARET
1815;SULAWESI BARAT;MAJENE;SENDANA;LIMBUA;87;35;18;1;18;12;0;3;0;87;0;MARET
1816;SULAWESI BARAT;MAJENE;SENDANA;BUKIT SAMANG;118;35;25;7;24;17;4;6;0;118;0;MARET
1817;SULAWESI BARAT;MAJENE;PAMBOANG;LALAMPANUA;152;28;28;26;45;11;0;12;1;151;1;MARET
1818;SULAWESI BARAT;MAJENE;PAMBOANG;SIRINDU;137;28;17;2;66;10;0;14;0;137;0;MARET
1819;SULAWESI BARAT;MAJENE;PAMBOANG;ADOLANG;101;24;5;2;61;4;0;5;0;101;0;MARET
1820;SULAWESI BARAT;MAJENE;PAMBOANG;BABABULO;187;96;26;9;43;5;1;7;0;187;0;MARET
1821;SULAWESI BARAT;MAJENE;PAMBOANG;BONDE;255;152;56;5;15;9;1;15;0;253;2;MARET
1822;SULAWESI BARAT;MAJENE;PAMBOANG;BETTENG;103;59;13;0;27;1;0;3;0;103;0;MARET
1823;SULAWESI BARAT;MAJENE;PAMBOANG;SIMBANG;62;16;12;7;19;3;1;4;0;62;0;MARET
1824;SULAWESI BARAT;MAJENE;PAMBOANG;BONDE UTARA;364;235;42;3;42;10;2;15;0;349;15;MARET
1825;SULAWESI BARAT;MAJENE;PAMBOANG;BABABULO UTARA;109;61;18;10;10;3;0;7;0;109;0;MARET
1826;SULAWESI BARAT;MAJENE;PAMBOANG;BUTTU PAMBOANG;106;48;21;3;24;5;0;5;0;106;0;MARET
1827;SULAWESI BARAT;MAJENE;PAMBOANG;BANUA ADOLANG;108;33;35;0;31;6;0;3;0;108;0;MARET
1828;SULAWESI BARAT;MAJENE;PAMBOANG;ADOLANG DHUA;101;37;9;2;42;0;1;8;0;99;2;MARET
1829;SULAWESI BARAT;MAJENE;PAMBOANG;TINAMBUNG;180;43;44;16;49;5;0;23;0;180;0;MARET
1830;SULAWESI BARAT;MAJENE;PAMBOANG;PESULOANG;113;38;15;12;35;1;3;9;0;113;0;MARET
1831;SULAWESI BARAT;MAJENE;PAMBOANG;BALOMBONG;116;34;15;2;55;7;0;3;0;116;0;MARET
1832;SULAWESI BARAT;MAJENE;BANGGAE TIMUR;BAURUNG;494;230;61;20;160;12;1;8;1;493;1;MARET
1833;SULAWESI BARAT;MAJENE;BANGGAE TIMUR;BARUGA;189;53;23;41;36;14;0;8;0;175;14;MARET
1834;SULAWESI BARAT;MAJENE;BANGGAE TIMUR;BARUGA DHUA;174;60;37;36;36;2;0;1;0;172;2;MARET
1835;SULAWESI BARAT;MAJENE;BANGGAE TIMUR;LABUANG;279;58;57;32;102;16;1;13;0;279;0;MARET
1836;SULAWESI BARAT;MAJENE;BANGGAE TIMUR;TANDE;123;20;33;24;34;4;0;3;0;118;5;MARET
1837;SULAWESI BARAT;MAJENE;BANGGAE TIMUR;LEMBANG;701;288;155;116;106;25;0;11;0;701;0;MARET
1838;SULAWESI BARAT;MAJENE;BANGGAE TIMUR;LABUANG UTARA;307;87;79;19;62;34;1;23;0;305;2;MARET
1839;SULAWESI BARAT;MAJENE;BANGGAE TIMUR;TANDE TIMUR;121;49;11;8;32;10;0;11;0;121;0;MARET
1840;SULAWESI BARAT;MAJENE;BANGGAE TIMUR;BUTTU BARUGA;81;25;11;4;39;0;0;1;0;80;1;MARET
1841;SULAWESI BARAT;MAJENE;ULUMANDA;KABIRAAN;140;93;21;0;23;1;0;2;0;140;0;MARET
1842;SULAWESI BARAT;MAJENE;ULUMANDA;SAMBABO;90;49;14;2;23;0;0;0;0;88;2;MARET
1843;SULAWESI BARAT;MAJENE;ULUMANDA;TANDEALLO;123;66;41;2;6;1;0;6;0;122;1;MARET
1844;SULAWESI BARAT;MAJENE;ULUMANDA;ULUMANDA;140;43;72;3;8;4;1;9;0;140;0;MARET
1845;SULAWESI BARAT;MAJENE;ULUMANDA;SALUTAMBUNG;109;84;14;1;8;0;0;2;0;109;0;MARET
1846;SULAWESI BARAT;MAJENE;ULUMANDA;POPENGA;75;59;15;0;0;0;0;1;0;75;0;MARET
1847;SULAWESI BARAT;MAJENE;ULUMANDA;SULAI;124;54;47;4;12;1;0;5;0;123;1;MARET
1848;SULAWESI BARAT;MAJENE;ULUMANDA;PANGGALO;102;50;36;4;8;2;0;0;0;100;2;MARET
1849;SULAWESI BARAT;MAJENE;TUBO SENDANA;ONANG;328;103;59;18;113;7;14;11;0;325;3;MARET
1850;SULAWESI BARAT;MAJENE;TUBO SENDANA;TUBO;89;16;13;35;8;12;1;4;0;89;0;MARET
1851;SULAWESI BARAT;MAJENE;TUBO SENDANA;ONANG UTARA;88;20;18;3;30;11;4;2;0;88;0;MARET
1852;SULAWESI BARAT;MAJENE;TUBO SENDANA;TUBO SELATAN;96;34;18;2;26;10;2;4;0;96;0;MARET
1853;SULAWESI BARAT;MAJENE;TUBO SENDANA;BONDE BONDE;89;21;14;9;20;14;6;5;0;89;0;MARET
1854;SULAWESI BARAT;MAJENE;TUBO SENDANA;TUBO TENGAH;97;26;28;5;14;14;1;9;0;97;0;MARET
1855;SULAWESI BARAT;MAJENE;TUBO SENDANA;TUBO POANG;89;40;27;7;9;1;0;5;0;89;0;MARET
1856;SULAWESI BARAT;POLEWALI MANDAR;ANREAPI;ANREAPI;168;39;47;6;48;11;0;14;1;166;2;MARET
1857;SULAWESI BARAT;POLEWALI MANDAR;ANREAPI;DUAMPANUA;386;117;144;19;79;5;0;17;0;381;5;MARET
1858;SULAWESI BARAT;POLEWALI MANDAR;ANREAPI;KELAPA DUA;271;75;117;3;56;3;2;14;0;270;1;MARET
1859;SULAWESI BARAT;POLEWALI MANDAR;ANREAPI;PAPPANDANGAN;254;99;66;8;66;2;3;8;0;252;2;MARET
1860;SULAWESI BARAT;POLEWALI MANDAR;ANREAPI;KUNYI;238;30;114;3;69;2;0;10;2;230;8;MARET
1861;SULAWESI BARAT;MAJENE;MALUNDA;MALUNDA;143;48;39;15;21;11;3;6;0;143;0;MARET
1862;SULAWESI BARAT;MAJENE;MALUNDA;LAMUNGANG BATU;129;45;48;1;18;5;0;11;0;128;1;MARET
1863;SULAWESI BARAT;MAJENE;MALUNDA;BAMBANGAN;158;82;46;2;25;2;0;1;0;158;0;MARET
1864;SULAWESI BARAT;MAJENE;MALUNDA;LOMBANG;98;48;21;2;23;2;0;2;0;98;0;MARET
1865;SULAWESI BARAT;MAJENE;MALUNDA;LOMBONG;234;65;109;6;29;5;0;19;0;233;1;MARET
1866;SULAWESI BARAT;MAJENE;MALUNDA;MEKKATTA;208;106;25;6;55;3;0;7;0;202;6;MARET
1867;SULAWESI BARAT;MAJENE;MALUNDA;MALIAYA;154;71;30;8;37;2;0;6;0;154;0;MARET
1868;SULAWESI BARAT;MAJENE;MALUNDA;LOMBANG TIMUR;157;99;51;1;5;1;0;0;0;157;0;MARET
1869;SULAWESI BARAT;MAJENE;MALUNDA;SALUTAHONGAN;89;52;26;0;8;1;0;1;0;88;1;MARET
1870;SULAWESI BARAT;MAJENE;MALUNDA;LOMBONG TIMUR;96;16;28;12;3;18;0;19;0;96;0;MARET
1871;SULAWESI BARAT;MAJENE;MALUNDA;MEKKATTA SELATAN;123;41;29;4;34;6;0;7;1;122;1;MARET
1872;SULAWESI BARAT;MAJENE;MALUNDA;KAYUANGIN;180;86;41;14;12;11;0;12;0;176;4;MARET
1873;SULAWESI BARAT;POLEWALI MANDAR;ALLU;PETOOSANG;80;26;20;7;12;4;0;9;0;78;2;MARET
1874;SULAWESI BARAT;POLEWALI MANDAR;ALLU;MOMBI;123;54;26;4;29;0;4;5;0;122;1;MARET
1875;SULAWESI BARAT;POLEWALI MANDAR;ALLU;KALUMAMMANG;95;33;38;0;18;0;0;6;0;95;0;MARET
1876;SULAWESI BARAT;POLEWALI MANDAR;ALLU;PAO-PAO;189;73;56;0;59;0;0;1;0;189;0;MARET
1877;SULAWESI BARAT;POLEWALI MANDAR;ALLU;PUPPU URING;206;81;81;2;23;0;1;1;2;191;15;MARET
1878;SULAWESI BARAT;POLEWALI MANDAR;ALLU;SARAGIAN;129;67;25;5;23;0;0;8;0;128;1;MARET
1879;SULAWESI BARAT;POLEWALI MANDAR;ALLU;SAYOANG;45;21;15;0;6;1;0;2;0;45;0;MARET
1880;SULAWESI BARAT;POLEWALI MANDAR;ALLU;ALU;120;49;38;11;20;0;0;2;0;120;0;MARET
1881;SULAWESI BARAT;MAJENE;BANGGAE;BANGGAE;329;97;110;14;59;34;1;14;0;329;0;MARET
1882;SULAWESI BARAT;MAJENE;BANGGAE;BARU;508;148;124;9;188;12;0;27;0;508;0;MARET
1883;SULAWESI BARAT;MAJENE;BANGGAE;PANGALI ALI;835;308;221;11;199;59;2;32;0;832;3;MARET
1884;SULAWESI BARAT;MAJENE;BANGGAE;TOTOLI;439;144;110;15;139;12;1;18;0;439;0;MARET
1885;SULAWESI BARAT;MAJENE;BANGGAE;RANGAS;885;349;325;17;142;32;1;17;2;885;0;MARET
1886;SULAWESI BARAT;MAJENE;BANGGAE;GALUNG;250;52;17;30;82;29;0;38;0;248;2;MARET
1887;SULAWESI BARAT;MAJENE;BANGGAE;PALIPI SOREANG;236;110;38;16;55;11;0;6;0;236;0;MARET
1888;SULAWESI BARAT;MAJENE;BANGGAE;PAMBOBORANG;225;36;71;11;78;5;0;23;0;224;1;MARET
1889;SULAWESI BARAT;POLEWALI MANDAR;BINUANG;AMASSANGAN;302;145;55;1;67;2;0;32;0;302;0;MARET
1890;SULAWESI BARAT;POLEWALI MANDAR;BINUANG;TONYAMAN;495;194;161;5;93;12;0;12;1;478;17;MARET
1891;SULAWESI BARAT;POLEWALI MANDAR;BINUANG;KUAJANG;376;178;66;10;107;4;1;10;0;376;0;MARET
1892;SULAWESI BARAT;POLEWALI MANDAR;BINUANG;PAKU;153;74;39;9;19;0;1;10;1;153;0;MARET
1893;SULAWESI BARAT;POLEWALI MANDAR;BINUANG;MIRRING;222;117;39;5;40;1;0;17;0;219;3;MARET
1894;SULAWESI BARAT;POLEWALI MANDAR;BINUANG;BATETANGNGA;686;401;142;11;79;7;0;15;2;657;29;MARET
1895;SULAWESI BARAT;POLEWALI MANDAR;BINUANG;MAMMI;256;86;69;8;81;3;0;8;0;255;1;MARET
1896;SULAWESI BARAT;POLEWALI MANDAR;BINUANG;KALEOK;145;46;66;2;26;0;0;5;0;145;0;MARET
1897;SULAWESI BARAT;POLEWALI MANDAR;BINUANG;AMOLA;150;86;23;2;36;0;1;2;0;150;0;MARET
1898;SULAWESI BARAT;POLEWALI MANDAR;BINUANG;REA;245;100;76;10;32;1;2;18;0;239;6;MARET
1899;SULAWESI BARAT;PASANGKAYU;BAMBALAMOTU;BAMBALAMOTU;385;177;78;4;78;23;0;24;0;384;1;MARET
1900;SULAWESI BARAT;PASANGKAYU;BAMBALAMOTU;POLEWALI;451;163;148;3;90;30;0;17;0;451;0;MARET
1901;SULAWESI BARAT;PASANGKAYU;BAMBALAMOTU;RANDOMAYANG;443;152;65;4;156;18;0;36;0;431;12;MARET
1902;SULAWESI BARAT;PASANGKAYU;BAMBALAMOTU;PANGIANG;191;95;50;2;21;16;0;7;0;191;0;MARET
1903;SULAWESI BARAT;PASANGKAYU;BAMBALAMOTU;KALOLA;470;118;118;0;205;16;0;13;0;470;0;MARET
1904;SULAWESI BARAT;PASANGKAYU;BAMBALAMOTU;WULAI;253;56;72;0;100;5;0;19;0;252;1;MARET
1905;SULAWESI BARAT;MAJENE;TAMMERODO SENDANA;SEPPONG;138;79;36;4;7;6;0;5;1;138;0;MARET
1906;SULAWESI BARAT;MAJENE;TAMMERODO SENDANA;TAMMERODO;154;71;32;1;14;21;4;9;0;152;2;MARET
1907;SULAWESI BARAT;MAJENE;TAMMERODO SENDANA;ULIDANG;167;97;25;3;18;8;2;14;0;167;0;MARET
1908;SULAWESI BARAT;MAJENE;TAMMERODO SENDANA;TALLAMBALAO;200;113;57;3;5;3;1;18;0;200;0;MARET
1909;SULAWESI BARAT;MAJENE;TAMMERODO SENDANA;TAMMERODO UTARA;188;92;43;7;11;25;0;9;1;188;0;MARET
1910;SULAWESI BARAT;MAJENE;TAMMERODO SENDANA;MANYAMBA;171;107;32;0;22;5;0;4;0;170;1;MARET
1911;SULAWESI BARAT;MAJENE;TAMMERODO SENDANA;AWO;152;91;27;0;6;8;6;10;0;148;4;MARET
1912;SULAWESI BARAT;MAMUJU TENGAH;TOPOYO;BUDONG-BUDONG;253;103;68;6;48;6;0;11;0;242;11;MARET
1913;SULAWESI BARAT;MAMUJU TENGAH;TOPOYO;TOPOYO;937;312;225;16;185;58;0;24;0;820;117;MARET
1914;SULAWESI BARAT;MAMUJU TENGAH;TOPOYO;TUMBU;322;158;64;2;67;18;0;11;0;320;2;MARET
1915;SULAWESI BARAT;MAMUJU TENGAH;TOPOYO;KABUBU;275;84;50;18;106;12;1;4;0;275;0;MARET
1916;SULAWESI BARAT;MAMUJU TENGAH;TOPOYO;WAEPUTEH;267;141;25;13;74;6;0;4;0;263;4;MARET
1917;SULAWESI BARAT;MAMUJU TENGAH;TOPOYO;TANGKOU;137;74;25;0;31;3;0;2;2;137;0;MARET
1918;SULAWESI BARAT;MAMUJU TENGAH;TOPOYO;TABOLANG;441;160;94;13;101;7;1;9;3;388;53;MARET
1919;SULAWESI BARAT;MAMUJU TENGAH;TOPOYO;PARAILI;191;101;35;2;31;16;3;3;0;191;0;MARET
1920;SULAWESI BARAT;MAMUJU TENGAH;TOPOYO;SALUPANGKANG;476;143;62;10;249;8;0;2;1;475;1;MARET
1921;SULAWESI BARAT;MAMUJU TENGAH;TOPOYO;SALUPANGKANG IV;60;40;2;0;16;0;0;1;0;59;1;MARET
1922;SULAWESI BARAT;MAMUJU TENGAH;TOPOYO;TAPPILINA;154;49;37;11;37;13;0;7;0;154;0;MARET
1923;SULAWESI BARAT;MAMUJU TENGAH;TOPOYO;BAMBAMANURUNG;157;68;11;4;67;6;0;0;1;157;0;MARET
1924;SULAWESI BARAT;MAMUJU TENGAH;TOPOYO;SALULEKBO;391;160;88;6;133;2;0;1;0;390;1;MARET
1925;SULAWESI BARAT;MAMUJU TENGAH;TOPOYO;PANGALLOANG;254;83;49;2;111;6;0;2;0;253;1;MARET
1926;SULAWESI BARAT;MAMUJU TENGAH;TOPOYO;SINABATTA;117;60;35;2;10;5;0;1;0;113;4;MARET
1927;SULAWESI BARAT;PASANGKAYU;BARAS;BARAS;276;95;34;2;92;38;0;14;1;276;0;MARET
1928;SULAWESI BARAT;PASANGKAYU;BARAS;BALANTI;364;192;75;2;75;9;0;8;0;361;3;MARET
1929;SULAWESI BARAT;PASANGKAYU;BARAS;MOTU;575;212;135;11;119;64;0;31;0;572;3;MARET
1930;SULAWESI BARAT;PASANGKAYU;BARAS;BULU PARIGI;176;70;13;2;86;4;0;1;0;176;0;MARET
1931;SULAWESI BARAT;PASANGKAYU;BARAS;TOWONI;178;44;47;2;72;6;0;7;0;178;0;MARET
1932;SULAWESI BARAT;PASANGKAYU;BARAS;KASANO;281;183;23;0;64;9;0;2;0;281;0;MARET
1933;SULAWESI BARAT;MAMUJU TENGAH;KAROSSA;KAROSSA;624;307;120;5;162;13;1;15;1;624;0;MARET
1934;SULAWESI BARAT;MAMUJU TENGAH;KAROSSA;TASOKKO;420;167;105;8;109;8;2;21;0;420;0;MARET
1935;SULAWESI BARAT;MAMUJU TENGAH;KAROSSA;LARA;119;34;14;1;62;4;1;3;0;119;0;MARET
1936;SULAWESI BARAT;MAMUJU TENGAH;KAROSSA;KADAILA;149;47;27;2;70;2;0;1;0;149;0;MARET
1937;SULAWESI BARAT;MAMUJU TENGAH;KAROSSA;KAYU CALLA;75;25;16;2;31;1;0;0;0;75;0;MARET
1938;SULAWESI BARAT;MAMUJU TENGAH;KAROSSA;LEMBAH HOPO;142;42;12;9;68;1;0;10;0;142;0;MARET
1939;SULAWESI BARAT;MAMUJU TENGAH;KAROSSA;BENGGAULU;264;122;62;1;61;9;0;8;0;263;1;MARET
1940;SULAWESI BARAT;MAMUJU TENGAH;KAROSSA;SUKA MAJU;98;33;36;1;22;2;0;1;0;95;3;MARET
1941;SULAWESI BARAT;MAMUJU TENGAH;KAROSSA;KAMBUNONG;281;148;69;2;42;7;0;12;0;280;1;MARET
1942;SULAWESI BARAT;MAMUJU TENGAH;KAROSSA;SALUBIRO;159;82;30;1;36;0;0;10;0;159;0;MARET
1943;SULAWESI BARAT;MAMUJU TENGAH;KAROSSA;SANJANGO;147;47;35;2;55;1;4;3;0;147;0;MARET
1944;SULAWESI BARAT;PASANGKAYU;BAMBAIRA;BAMBAIRA;263;67;40;8;122;10;0;13;0;260;3;APRIL
1945;SULAWESI BARAT;PASANGKAYU;BAMBAIRA;KASOLOANG;173;67;22;0;63;11;0;10;0;173;0;APRIL
1946;SULAWESI BARAT;PASANGKAYU;BAMBAIRA;TAMPAURE;239;103;53;2;57;6;0;12;0;233;6;APRIL
1947;SULAWESI BARAT;PASANGKAYU;BAMBAIRA;KALUKU NANGKA;294;140;68;3;66;5;0;12;0;294;0;APRIL
1948;SULAWESI BARAT;PASANGKAYU;BARAS;BARAS;277;96;34;2;92;38;0;14;1;277;0;APRIL
1949;SULAWESI BARAT;PASANGKAYU;BARAS;BALANTI;363;191;75;2;75;9;0;8;0;360;3;APRIL
1950;SULAWESI BARAT;PASANGKAYU;BARAS;MOTU;574;213;133;11;119;64;0;31;0;571;3;APRIL
1951;SULAWESI BARAT;PASANGKAYU;BARAS;BULU PARIGI;175;69;13;3;85;4;0;1;0;175;0;APRIL
1952;SULAWESI BARAT;PASANGKAYU;BARAS;TOWONI;178;44;47;2;72;6;0;7;0;178;0;APRIL
1953;SULAWESI BARAT;PASANGKAYU;BARAS;KASANO;283;180;28;0;65;8;0;2;0;283;0;APRIL
1954;SULAWESI BARAT;MAMUJU TENGAH;KAROSSA;KAROSSA;625;305;120;6;164;13;1;15;1;625;0;APRIL
1955;SULAWESI BARAT;MAMUJU TENGAH;KAROSSA;TASOKKO;431;162;111;7;117;8;0;26;0;431;0;APRIL
1956;SULAWESI BARAT;MAMUJU TENGAH;KAROSSA;LARA;119;34;14;1;62;4;1;3;0;119;0;APRIL
1957;SULAWESI BARAT;MAMUJU TENGAH;KAROSSA;KADAILA;149;46;28;2;70;2;0;1;0;149;0;APRIL
1958;SULAWESI BARAT;MAMUJU TENGAH;KAROSSA;KAYU CALLA;76;25;16;2;32;1;0;0;0;76;0;APRIL
1959;SULAWESI BARAT;MAMUJU TENGAH;KAROSSA;LEMBAH HOPO;146;43;15;9;69;1;0;9;0;146;0;APRIL
1960;SULAWESI BARAT;MAMUJU TENGAH;KAROSSA;BENGGAULU;269;124;66;1;60;9;0;8;0;268;1;APRIL
1961;SULAWESI BARAT;MAMUJU TENGAH;KAROSSA;SUKA MAJU;98;33;36;1;22;2;0;1;0;95;3;APRIL
1962;SULAWESI BARAT;MAMUJU TENGAH;KAROSSA;KAMBUNONG;283;150;69;2;42;7;0;12;0;282;1;APRIL
1963;SULAWESI BARAT;MAMUJU TENGAH;KAROSSA;SALUBIRO;159;82;30;1;36;0;0;10;0;159;0;APRIL
1964;SULAWESI BARAT;MAMUJU TENGAH;KAROSSA;SANJANGO;147;47;35;2;55;1;4;3;0;147;0;APRIL
1965;SULAWESI BARAT;MAJENE;SENDANA;MOSSO;334;152;87;5;58;19;1;10;1;333;1;APRIL
1966;SULAWESI BARAT;MAJENE;SENDANA;MOSSO DHUA;87;25;23;5;8;11;2;5;0;79;8;APRIL
1967;SULAWESI BARAT;MAJENE;SENDANA;TOTOLISI SENDANA;116;33;42;4;19;8;1;7;0;114;2;APRIL
1968;SULAWESI BARAT;MAJENE;SENDANA;TALLUBANUA;134;46;31;11;10;18;1;7;0;124;10;APRIL
1969;SULAWESI BARAT;MAJENE;SENDANA;LALATEDZONG;94;28;20;6;16;15;0;5;2;92;2;APRIL
1970;SULAWESI BARAT;MAJENE;SENDANA;BINANGA;70;33;12;6;11;5;1;2;0;70;0;APRIL
1971;SULAWESI BARAT;MAJENE;SENDANA;PUTTADA;76;42;22;0;9;1;1;1;0;76;0;APRIL
1972;SULAWESI BARAT;MAJENE;SENDANA;PAMINGGALAN;39;28;11;0;0;0;0;0;0;39;0;APRIL
1973;SULAWESI BARAT;MAJENE;SENDANA;LEPPANGANG;57;28;15;0;8;2;0;4;0;57;0;APRIL
1974;SULAWESI BARAT;MAJENE;SENDANA;PUNDAU;65;6;27;5;22;3;0;2;0;65;0;APRIL
1975;SULAWESI BARAT;MAJENE;SENDANA;SENDANA;76;40;21;1;0;6;1;7;0;76;0;APRIL
1976;SULAWESI BARAT;MAJENE;SENDANA;BANUA SENDANA;103;63;11;4;1;19;0;5;0;103;0;APRIL
1977;SULAWESI BARAT;MAJENE;SENDANA;TALLUBANUA UTARA;153;68;45;2;5;29;0;4;0;153;0;APRIL
1978;SULAWESI BARAT;MAJENE;SENDANA;LIMBORO RAMBU-RAMBU;95;19;33;2;34;4;0;0;0;92;3;APRIL
1979;SULAWESI BARAT;MAJENE;SENDANA;LIMBUA;88;35;19;1;18;12;0;3;0;88;0;APRIL
1980;SULAWESI BARAT;MAJENE;SENDANA;BUKIT SAMANG;115;35;26;7;23;14;4;6;0;115;0;APRIL
1981;SULAWESI BARAT;MAJENE;PAMBOANG;LALAMPANUA;157;30;30;27;45;11;0;12;1;156;1;APRIL
1982;SULAWESI BARAT;MAJENE;PAMBOANG;SIRINDU;137;28;17;2;66;10;0;14;0;137;0;APRIL
1983;SULAWESI BARAT;MAJENE;PAMBOANG;ADOLANG;102;24;4;2;63;4;0;5;0;102;0;APRIL
1984;SULAWESI BARAT;MAJENE;PAMBOANG;BABABULO;190;98;26;9;44;5;1;7;0;190;0;APRIL
1985;SULAWESI BARAT;MAJENE;PAMBOANG;BONDE;254;151;56;5;15;9;1;15;0;252;2;APRIL
1986;SULAWESI BARAT;MAJENE;PAMBOANG;BETTENG;104;62;11;0;27;1;0;3;0;104;0;APRIL
1987;SULAWESI BARAT;MAJENE;PAMBOANG;SIMBANG;63;17;12;7;19;3;1;4;0;63;0;APRIL
1988;SULAWESI BARAT;MAJENE;PAMBOANG;BONDE UTARA;369;239;44;3;41;10;2;15;0;354;15;APRIL
1989;SULAWESI BARAT;MAJENE;PAMBOANG;BABABULO UTARA;110;61;18;10;11;3;0;7;0;110;0;APRIL
1990;SULAWESI BARAT;MAJENE;PAMBOANG;BUTTU PAMBOANG;109;50;22;3;23;5;0;6;0;109;0;APRIL
1991;SULAWESI BARAT;MAJENE;PAMBOANG;BANUA ADOLANG;110;35;33;0;33;6;0;3;0;110;0;APRIL
1992;SULAWESI BARAT;MAJENE;PAMBOANG;ADOLANG DHUA;103;36;9;2;44;0;1;9;0;101;2;APRIL
1993;SULAWESI BARAT;MAJENE;PAMBOANG;TINAMBUNG;186;43;48;17;50;5;0;23;0;186;0;APRIL
1994;SULAWESI BARAT;MAJENE;PAMBOANG;PESULOANG;113;38;15;12;35;1;3;9;0;113;0;APRIL
1995;SULAWESI BARAT;MAJENE;PAMBOANG;BALOMBONG;116;34;15;2;55;7;0;3;0;116;0;APRIL
1996;SULAWESI BARAT;MAMASA;TANDUK KALUA;MINAKE;83;25;9;1;44;2;0;2;0;83;0;APRIL
1997;SULAWESI BARAT;MAMASA;TANDUK KALUA;MALABO;51;23;13;0;5;7;0;3;0;51;0;APRIL
1998;SULAWESI BARAT;MAMASA;TANDUK KALUA;SINDAGAMANIK;141;77;20;1;41;1;0;1;0;141;0;APRIL
1999;SULAWESI BARAT;MAMASA;TANDUK KALUA;PARONDOBULAWAN;106;69;12;1;20;1;0;3;0;106;0;APRIL
2000;SULAWESI BARAT;MAMASA;TANDUK KALUA;TAMALANTIK;153;57;56;0;32;4;0;1;1;151;2;APRIL
2001;SULAWESI BARAT;MAMASA;TANDUK KALUA;MANNABABA;70;29;2;0;39;0;0;0;0;70;0;APRIL
2002;SULAWESI BARAT;MAMASA;TANDUK KALUA;MESAKADA;123;53;27;0;43;0;0;0;0;123;0;APRIL
2003;SULAWESI BARAT;MAMASA;TANDUK KALUA;BALLABATU;149;20;14;0;111;3;0;1;0;149;0;APRIL
2004;SULAWESI BARAT;MAMASA;TANDUK KALUA;PAMBE;85;23;18;1;40;2;1;0;0;85;0;APRIL
2005;SULAWESI BARAT;MAMASA;TANDUK KALUA;SALURANO;73;29;14;0;28;1;0;1;0;73;0;APRIL
2006;SULAWESI BARAT;MAMASA;TANDUK KALUA;TALIMBUNG;93;48;39;0;5;0;0;1;0;93;0;APRIL
2007;SULAWESI BARAT;MAMASA;TANDUK KALUA;KANAN;114;43;25;0;35;8;0;1;0;112;2;APRIL
2008;SULAWESI BARAT;PASANGKAYU;DAPURANG;DAPURANG;399;217;66;4;75;20;1;6;0;389;10;APRIL
2009;SULAWESI BARAT;PASANGKAYU;DAPURANG;BENGGAULU;285;119;77;0;69;6;0;14;0;285;0;APRIL
2010;SULAWESI BARAT;PASANGKAYU;DAPURANG;TIRTABUANA;147;87;15;2;36;2;0;5;0;147;0;APRIL
2011;SULAWESI BARAT;PASANGKAYU;DAPURANG;BULU BONGGU;254;73;45;3;118;6;0;3;0;248;6;APRIL
2012;SULAWESI BARAT;PASANGKAYU;DAPURANG;SARASA;192;111;50;1;20;6;0;4;0;192;0;APRIL
2013;SULAWESI BARAT;MAJENE;BANGGAE TIMUR;BAURUNG;502;237;62;20;161;11;1;8;1;501;1;APRIL
2014;SULAWESI BARAT;MAJENE;BANGGAE TIMUR;BARUGA;190;53;23;41;38;13;0;8;0;176;14;APRIL
2015;SULAWESI BARAT;MAJENE;BANGGAE TIMUR;BARUGA DHUA;175;61;38;36;36;2;0;1;0;174;1;APRIL
2016;SULAWESI BARAT;MAJENE;BANGGAE TIMUR;LABUANG;279;59;56;32;103;15;1;13;0;279;0;APRIL
2017;SULAWESI BARAT;MAJENE;BANGGAE TIMUR;TANDE;125;23;32;22;35;4;0;3;1;120;5;APRIL
2018;SULAWESI BARAT;MAJENE;BANGGAE TIMUR;LEMBANG;704;290;155;116;106;25;0;12;0;704;0;APRIL
2019;SULAWESI BARAT;MAJENE;BANGGAE TIMUR;LABUANG UTARA;308;87;78;19;63;35;1;23;0;306;2;APRIL
2020;SULAWESI BARAT;MAJENE;BANGGAE TIMUR;TANDE TIMUR;126;46;15;10;33;10;0;12;0;126;0;APRIL
2021;SULAWESI BARAT;MAJENE;BANGGAE TIMUR;BUTTU BARUGA;79;26;9;4;38;0;0;1;0;78;1;APRIL
2022;SULAWESI BARAT;MAMASA;TAWALIAN;TAWALIAN;248;116;41;0;73;8;0;8;0;246;2;APRIL
2023;SULAWESI BARAT;MAMASA;TAWALIAN;TAWALIAN TIMUR;169;67;49;2;47;1;0;1;0;167;2;APRIL
2024;SULAWESI BARAT;MAMASA;TAWALIAN;KARIANGO;206;77;52;0;77;0;0;0;0;206;0;APRIL
2025;SULAWESI BARAT;MAMASA;TAWALIAN;RANTETANGNGA;143;24;40;5;66;4;0;3;0;142;1;APRIL
2026;SULAWESI BARAT;MAJENE;TAMMERODO SENDANA;SEPPONG;138;79;36;4;7;6;0;5;1;138;0;APRIL
2027;SULAWESI BARAT;MAJENE;TAMMERODO SENDANA;TAMMERODO;148;68;32;1;13;20;4;8;0;146;2;APRIL
2028;SULAWESI BARAT;MAJENE;TAMMERODO SENDANA;ULIDANG;168;96;28;3;17;8;2;14;0;168;0;APRIL
2029;SULAWESI BARAT;MAJENE;TAMMERODO SENDANA;TALLAMBALAO;194;107;57;3;5;3;1;18;0;194;0;APRIL
2030;SULAWESI BARAT;MAJENE;TAMMERODO SENDANA;TAMMERODO UTARA;191;95;43;7;12;24;0;9;1;191;0;APRIL
2031;SULAWESI BARAT;MAJENE;TAMMERODO SENDANA;MANYAMBA;173;110;31;0;22;5;0;4;0;172;1;APRIL
2032;SULAWESI BARAT;MAJENE;TAMMERODO SENDANA;AWO;157;95;29;0;6;7;6;10;0;153;4;APRIL
2033;SULAWESI BARAT;MAMASA;SUMARORONG;SUMARORONG;146;49;40;6;32;6;0;11;0;144;2;APRIL
2034;SULAWESI BARAT;MAMASA;SUMARORONG;TABONE;94;29;36;0;28;0;0;1;0;94;0;APRIL
2035;SULAWESI BARAT;MAMASA;SUMARORONG;BATANG URU;94;33;44;0;14;2;0;1;0;94;0;APRIL
2036;SULAWESI BARAT;MAMASA;SUMARORONG;SASAKAN;156;47;88;1;12;7;0;0;0;155;1;APRIL
2037;SULAWESI BARAT;MAMASA;SUMARORONG;TADISI;51;12;33;0;6;0;0;0;0;51;0;APRIL
2038;SULAWESI BARAT;MAMASA;SUMARORONG;SIBANAWA;94;32;43;0;18;0;0;1;0;94;0;APRIL
2039;SULAWESI BARAT;MAMASA;SUMARORONG;BATANGNGURU TIMUR;106;32;68;0;6;0;0;0;0;106;0;APRIL
2040;SULAWESI BARAT;MAMASA;SUMARORONG;SALUBALO;121;59;40;0;20;0;0;2;0;121;0;APRIL
2041;SULAWESI BARAT;MAMASA;SUMARORONG;BANEA;66;24;33;0;7;1;0;1;0;66;0;APRIL
2042;SULAWESI BARAT;MAMASA;SUMARORONG;RANTE KAMASE;164;80;27;4;39;5;0;8;0;163;1;APRIL
2043;SULAWESI BARAT;PASANGKAYU;LARIANG;PARABU;136;29;22;9;38;21;0;9;0;128;8;APRIL
2044;SULAWESI BARAT;PASANGKAYU;LARIANG;KENANGAN;54;12;6;2;20;7;0;5;0;52;2;APRIL
2045;SULAWESI BARAT;PASANGKAYU;LARIANG;BAJAWALI;129;30;24;3;47;13;0;12;0;129;0;APRIL
2046;SULAWESI BARAT;PASANGKAYU;LARIANG;SINGGANI;185;72;56;0;35;9;0;9;0;181;4;APRIL
2047;SULAWESI BARAT;PASANGKAYU;LARIANG;KULU;104;35;33;0;25;9;0;1;0;103;1;APRIL
2048;SULAWESI BARAT;PASANGKAYU;LARIANG;BATU MATORU;93;32;20;0;24;7;0;10;0;93;0;APRIL
2049;SULAWESI BARAT;PASANGKAYU;LARIANG;BAMBAKORO;151;54;32;1;44;11;0;9;0;151;0;APRIL
2050;SULAWESI BARAT;PASANGKAYU;DURIPOKU;TAMMARUNANG;212;83;44;16;51;6;0;12;0;212;0;APRIL
2051;SULAWESI BARAT;PASANGKAYU;DURIPOKU;SAPTANAJAYA;205;112;39;1;38;10;0;5;0;205;0;APRIL
2052;SULAWESI BARAT;PASANGKAYU;DURIPOKU;TARANGGI;91;15;22;5;39;8;0;2;0;91;0;APRIL
2053;SULAWESI BARAT;PASANGKAYU;DURIPOKU;SIPAKAINGA;79;41;24;1;10;2;0;1;0;79;0;APRIL
2054;SULAWESI BARAT;MAJENE;MALUNDA;MALUNDA;143;48;39;15;21;11;3;6;0;143;0;APRIL
2055;SULAWESI BARAT;MAJENE;MALUNDA;LAMUNGANG BATU;131;47;49;1;17;5;0;11;0;130;1;APRIL
2056;SULAWESI BARAT;MAJENE;MALUNDA;BAMBANGAN;162;87;43;3;26;2;0;1;0;162;0;APRIL
2057;SULAWESI BARAT;MAJENE;MALUNDA;LOMBANG;98;50;19;2;23;2;0;2;0;98;0;APRIL
2058;SULAWESI BARAT;MAJENE;MALUNDA;LOMBONG;237;66;110;7;29;5;0;19;0;236;1;APRIL
2059;SULAWESI BARAT;MAJENE;MALUNDA;MEKKATTA;212;108;25;6;56;3;1;7;0;206;6;APRIL
2060;SULAWESI BARAT;MAJENE;MALUNDA;MALIAYA;154;70;31;8;37;2;0;6;0;154;0;APRIL
2061;SULAWESI BARAT;MAJENE;MALUNDA;LOMBANG TIMUR;158;98;53;1;5;1;0;0;0;158;0;APRIL
2062;SULAWESI BARAT;MAJENE;MALUNDA;SALUTAHONGAN;91;55;26;0;7;1;0;1;0;90;1;APRIL
2063;SULAWESI BARAT;MAJENE;MALUNDA;LOMBONG TIMUR;95;16;28;11;3;18;0;19;0;95;0;APRIL
2064;SULAWESI BARAT;MAJENE;MALUNDA;MEKKATTA SELATAN;123;40;31;4;33;6;0;7;1;122;1;APRIL
2065;SULAWESI BARAT;MAJENE;MALUNDA;KAYUANGIN;181;88;40;13;12;12;0;12;0;177;4;APRIL
2066;SULAWESI BARAT;MAMASA;TABANG;TABANG;80;26;21;1;7;24;0;1;0;80;0;APRIL
2067;SULAWESI BARAT;MAMASA;TABANG;TADOKALUA;93;36;28;1;19;1;0;3;0;88;5;APRIL
2068;SULAWESI BARAT;MAMASA;TABANG;TABANG BARAT;159;68;48;1;39;2;0;0;1;159;0;APRIL
2069;SULAWESI BARAT;MAMASA;TABANG;MASUPU;78;8;64;1;4;0;0;0;1;78;0;APRIL
2070;SULAWESI BARAT;MAMASA;TABANG;KALAMA;69;11;24;0;20;3;0;1;0;59;10;APRIL
2071;SULAWESI BARAT;MAMASA;TABANG;BAKADISURA;96;23;60;0;11;1;0;1;0;96;0;APRIL
2072;SULAWESI BARAT;MAMASA;TABANG;SALUKONA;97;43;45;0;8;1;0;0;0;97;0;APRIL
2073;SULAWESI BARAT;MAMASA;TABULAHAN;LAKAHANG;269;96;150;2;10;3;1;7;0;269;0;APRIL
2074;SULAWESI BARAT;MAMASA;TABULAHAN;PERIANGAN;68;19;47;0;2;0;0;0;0;68;0;APRIL
2075;SULAWESI BARAT;MAMASA;TABULAHAN;MALATIRO;139;62;69;0;2;1;0;2;0;136;3;APRIL
2076;SULAWESI BARAT;MAMASA;TABULAHAN;TABULAHAN;59;19;36;0;1;1;0;2;0;59;0;APRIL
2077;SULAWESI BARAT;MAMASA;TABULAHAN;SALULEANG;35;12;22;0;1;0;0;0;0;35;0;APRIL
2078;SULAWESI BARAT;MAMASA;TABULAHAN;TAMPAK KURRA;177;51;121;0;4;0;1;0;0;177;0;APRIL
2079;SULAWESI BARAT;MAMASA;TABULAHAN;GANDANG DEWATA;35;12;20;0;3;0;0;0;0;35;0;APRIL
2080;SULAWESI BARAT;MAMASA;TABULAHAN;BURANA;97;26;65;0;4;0;1;1;0;97;0;APRIL
2081;SULAWESI BARAT;MAMASA;TABULAHAN;SALUBAKKA;101;59;40;0;0;0;0;2;0;101;0;APRIL
2082;SULAWESI BARAT;MAMASA;TABULAHAN;PANGANDARAN;135;41;90;0;4;0;0;0;0;135;0;APRIL
2083;SULAWESI BARAT;MAMASA;TABULAHAN;TALOPAK;54;16;33;0;5;0;0;0;0;54;0;APRIL
2084;SULAWESI BARAT;MAMASA;TABULAHAN;PEU';51;17;34;0;0;0;0;0;0;51;0;APRIL
2085;SULAWESI BARAT;MAMASA;TABULAHAN;TIMORO;43;12;22;0;6;1;0;2;0;43;0;APRIL
2086;SULAWESI BARAT;MAMASA;TABULAHAN;LAKAHANG UTAMA;78;28;44;0;2;0;0;3;0;77;1;APRIL
2087;SULAWESI BARAT;MAJENE;TUBO SENDANA;ONANG;327;101;57;19;115;7;14;11;0;324;3;APRIL
2088;SULAWESI BARAT;MAJENE;TUBO SENDANA;TUBO;89;16;13;35;8;12;1;4;0;89;0;APRIL
2089;SULAWESI BARAT;MAJENE;TUBO SENDANA;ONANG UTARA;99;24;23;3;32;11;4;2;0;99;0;APRIL
2090;SULAWESI BARAT;MAJENE;TUBO SENDANA;TUBO SELATAN;96;33;18;2;26;10;2;5;0;96;0;APRIL
2091;SULAWESI BARAT;MAJENE;TUBO SENDANA;BONDE BONDE;89;22;13;9;20;14;6;5;0;89;0;APRIL
2092;SULAWESI BARAT;MAJENE;TUBO SENDANA;TUBO TENGAH;96;26;25;6;15;14;1;9;0;96;0;APRIL
2093;SULAWESI BARAT;MAJENE;TUBO SENDANA;TUBO POANG;89;38;29;7;9;1;0;5;0;89;0;APRIL
2094;SULAWESI BARAT;MAMASA;MESSAWA;MESSAWA;37;9;21;0;5;0;0;2;0;37;0;APRIL
2095;SULAWESI BARAT;MAMASA;MESSAWA;RIPPUNG;137;66;61;0;10;0;0;0;0;137;0;APRIL
2096;SULAWESI BARAT;MAMASA;MESSAWA;MAKUANG;106;55;34;0;17;0;0;0;0;106;0;APRIL
2097;SULAWESI BARAT;MAMASA;MESSAWA;SEPANG;72;41;30;0;1;0;0;0;0;72;0;APRIL
2098;SULAWESI BARAT;MAMASA;MESSAWA;MALIMBONG;55;15;37;0;3;0;0;0;0;55;0;APRIL
2099;SULAWESI BARAT;MAMASA;MESSAWA;MATANDE;85;17;58;6;4;0;0;0;0;85;0;APRIL
2100;SULAWESI BARAT;MAMASA;MESSAWA;SIPAI;80;35;36;0;9;0;0;0;0;80;0;APRIL
2101;SULAWESI BARAT;MAMASA;MESSAWA;PASMA MAMBU;47;15;22;0;10;0;0;0;0;47;0;APRIL
2102;SULAWESI BARAT;MAMASA;MESSAWA;TANETE BATU;55;28;23;0;3;0;0;1;0;55;0;APRIL
2103;SULAWESI BARAT;MAMUJU;TOMMO;TOMMO;352;135;76;1;125;5;0;10;0;352;0;APRIL
2104;SULAWESI BARAT;MAMUJU;TOMMO;CAMPALOGA;300;87;127;11;64;7;0;0;0;296;4;APRIL
2105;SULAWESI BARAT;MAMUJU;TOMMO;BUANA SAKTI;213;82;47;1;82;1;0;0;0;213;0;APRIL
2106;SULAWESI BARAT;MAMUJU;TOMMO;TAMEMONGGA;229;81;110;0;33;2;0;3;0;229;0;APRIL
2107;SULAWESI BARAT;MAMUJU;TOMMO;TAMEJARRA;195;68;51;5;52;7;1;11;0;195;0;APRIL
2108;SULAWESI BARAT;MAMUJU;TOMMO;RANTEMARIO;162;66;65;3;18;5;0;5;0;162;0;APRIL
2109;SULAWESI BARAT;MAMUJU;TOMMO;MALINO;73;38;19;9;3;1;0;2;0;72;1;APRIL
2110;SULAWESI BARAT;MAMUJU;TOMMO;KAKULLASANG;367;153;142;7;51;1;0;6;2;362;5;APRIL
2111;SULAWESI BARAT;MAMUJU;TOMMO;LELING;131;38;64;0;28;0;0;1;0;131;0;APRIL
2112;SULAWESI BARAT;MAMUJU;TOMMO;KALEPU;103;56;42;1;3;1;0;0;0;103;0;APRIL
2113;SULAWESI BARAT;MAMUJU;TOMMO;SANDANA;130;49;50;1;18;2;0;9;1;130;0;APRIL
2114;SULAWESI BARAT;MAMUJU;TOMMO;LELING BARAT;208;65;85;1;46;6;0;3;0;206;2;APRIL
2115;SULAWESI BARAT;MAMUJU;TOMMO;LELING UTARA;195;81;90;0;24;0;0;0;0;195;0;APRIL
2116;SULAWESI BARAT;MAMUJU;TOMMO;SALUDENGEN;132;71;54;0;6;0;0;1;0;132;0;APRIL
2117;SULAWESI BARAT;PASANGKAYU;SARJO;SARJO;283;87;48;23;65;12;0;45;1;281;2;APRIL
2118;SULAWESI BARAT;PASANGKAYU;SARJO;MAPONU;131;44;29;0;41;10;0;4;2;130;1;APRIL
2119;SULAWESI BARAT;PASANGKAYU;SARJO;LETAWA;219;88;23;14;65;10;1;18;0;219;0;APRIL
2120;SULAWESI BARAT;PASANGKAYU;SARJO;SARUDE;240;56;42;22;81;13;0;25;0;239;1;APRIL
2121;SULAWESI BARAT;PASANGKAYU;SARUDU;SARUDU;396;227;63;1;75;13;1;14;0;394;2;APRIL
2122;SULAWESI BARAT;PASANGKAYU;SARUDU;BULU MARIO;308;104;47;14;97;28;0;18;0;308;0;APRIL
2123;SULAWESI BARAT;PASANGKAYU;SARUDU;KUMASARI;257;126;41;6;67;9;0;6;1;256;1;APRIL
2124;SULAWESI BARAT;PASANGKAYU;SARUDU;PATIKA;67;19;20;1;12;3;0;5;0;60;7;APRIL
2125;SULAWESI BARAT;PASANGKAYU;SARUDU;DODA;278;132;60;2;78;3;0;3;0;278;0;APRIL
2126;SULAWESI BARAT;MAMASA;MEHALAAN;MEHALAAN;55;22;17;1;13;0;0;2;0;55;0;APRIL
2127;SULAWESI BARAT;MAMASA;MEHALAAN;BOTTENG;69;31;16;0;20;0;1;1;0;69;0;APRIL
2128;SULAWESI BARAT;MAMASA;MEHALAAN;SALUKONTA;53;24;11;1;16;0;0;1;0;53;0;APRIL
2129;SULAWESI BARAT;MAMASA;MEHALAAN;MESAKADA;56;18;18;1;19;0;0;0;0;56;0;APRIL
2130;SULAWESI BARAT;MAMASA;MEHALAAN;MEHALAAN BARAT;92;35;24;0;30;0;0;3;0;92;0;APRIL
2131;SULAWESI BARAT;MAMASA;MEHALAAN;SALUAHOK;71;20;25;1;20;0;1;4;0;71;0;APRIL
2132;SULAWESI BARAT;MAMASA;MEHALAAN;SALUBALO;44;23;14;0;7;0;0;0;0;44;0;APRIL
2133;SULAWESI BARAT;MAMASA;MEHALAAN;PASSEMBUK;41;19;11;0;11;0;0;0;0;41;0;APRIL
2134;SULAWESI BARAT;MAMASA;MEHALAAN;KONDO;34;17;9;0;7;0;0;1;0;34;0;APRIL
2135;SULAWESI BARAT;MAMASA;MEHALAAN;LEKO SUKAMAJU;31;12;10;0;8;0;0;1;0;31;0;APRIL
2136;SULAWESI BARAT;MAMASA;MEHALAAN;ULUMEA;27;12;4;0;11;0;0;0;0;27;0;APRIL
2137;SULAWESI BARAT;POLEWALI MANDAR;ANREAPI;ANREAPI;168;40;47;6;47;11;0;14;1;166;2;APRIL
2138;SULAWESI BARAT;POLEWALI MANDAR;ANREAPI;DUAMPANUA;388;120;145;18;79;4;0;17;0;383;5;APRIL
2139;SULAWESI BARAT;POLEWALI MANDAR;ANREAPI;KELAPA DUA;271;73;120;3;55;3;2;14;0;270;1;APRIL
2140;SULAWESI BARAT;POLEWALI MANDAR;ANREAPI;PAPPANDANGAN;253;100;65;8;65;2;3;8;0;251;2;APRIL
2141;SULAWESI BARAT;POLEWALI MANDAR;ANREAPI;KUNYI;240;34;112;4;68;3;0;10;1;232;8;APRIL
2142;SULAWESI BARAT;POLEWALI MANDAR;BALANIPA;BALANIPA;192;89;37;14;35;6;0;11;0;192;0;APRIL
2143;SULAWESI BARAT;POLEWALI MANDAR;BALANIPA;TAMMAJARRA;185;125;16;24;13;4;0;3;0;185;0;APRIL
2144;SULAWESI BARAT;POLEWALI MANDAR;BALANIPA;TAMANGGALLE;107;57;17;1;29;1;0;1;1;107;0;APRIL
2145;SULAWESI BARAT;POLEWALI MANDAR;BALANIPA;MOSSO;76;51;17;5;3;0;0;0;0;76;0;APRIL
2146;SULAWESI BARAT;POLEWALI MANDAR;BALANIPA;GALUNG TULUK;203;105;46;20;20;1;0;11;0;203;0;APRIL
2147;SULAWESI BARAT;POLEWALI MANDAR;BALANIPA;SABANG SUBIK;201;116;25;9;28;3;0;20;0;201;0;APRIL
2148;SULAWESI BARAT;POLEWALI MANDAR;BALANIPA;PAMBUSUANG;422;248;71;12;27;11;0;24;1;394;28;APRIL
2149;SULAWESI BARAT;POLEWALI MANDAR;BALANIPA;BALA;328;250;28;3;19;4;0;21;0;325;3;APRIL
2150;SULAWESI BARAT;POLEWALI MANDAR;BALANIPA;LAMBANAN;18;6;3;6;3;0;0;0;0;18;0;APRIL
2151;SULAWESI BARAT;POLEWALI MANDAR;BALANIPA;LEGO;106;68;25;0;5;0;0;8;0;106;0;APRIL
2152;SULAWESI BARAT;POLEWALI MANDAR;BALANIPA;PALLIS;24;11;7;1;3;1;0;1;0;24;0;APRIL
2153;SULAWESI BARAT;PASANGKAYU;PASANGKAYU;PASANGKAYU;1510;647;381;29;147;228;24;49;0;1505;5;APRIL
2154;SULAWESI BARAT;PASANGKAYU;PASANGKAYU;MARTAJAYA;180;63;33;2;44;25;0;13;0;180;0;APRIL
2155;SULAWESI BARAT;PASANGKAYU;PASANGKAYU;PAKAVA;390;222;98;5;59;4;0;2;0;390;0;APRIL
2156;SULAWESI BARAT;PASANGKAYU;PASANGKAYU;KARYA BERSAMA;328;167;51;2;79;19;0;10;0;328;0;APRIL
2157;SULAWESI BARAT;PASANGKAYU;PASANGKAYU;AKO;432;215;72;6;75;39;0;14;0;421;11;APRIL
2158;SULAWESI BARAT;PASANGKAYU;PASANGKAYU;GUNUNG SARI;550;306;77;7;104;22;0;26;0;542;8;APRIL
2159;SULAWESI BARAT;POLEWALI MANDAR;ALLU;PETOOSANG;80;26;20;7;12;4;0;9;0;78;2;APRIL
2160;SULAWESI BARAT;POLEWALI MANDAR;ALLU;MOMBI;131;59;27;5;30;0;4;5;0;130;1;APRIL
2161;SULAWESI BARAT;POLEWALI MANDAR;ALLU;KALUMAMMANG;95;34;37;0;18;0;0;6;0;95;0;APRIL
2162;SULAWESI BARAT;POLEWALI MANDAR;ALLU;PAO-PAO;191;75;54;0;60;0;0;2;0;191;0;APRIL
2163;SULAWESI BARAT;POLEWALI MANDAR;ALLU;PUPPU URING;207;83;81;2;22;0;1;1;2;192;15;APRIL
2164;SULAWESI BARAT;POLEWALI MANDAR;ALLU;SARAGIAN;128;66;25;5;23;0;0;8;0;127;1;APRIL
2165;SULAWESI BARAT;POLEWALI MANDAR;ALLU;SAYOANG;49;22;18;0;6;1;0;2;0;49;0;APRIL
2166;SULAWESI BARAT;POLEWALI MANDAR;ALLU;ALU;121;50;38;11;19;0;0;3;0;121;0;APRIL
2167;SULAWESI BARAT;MAJENE;BANGGAE;BANGGAE;328;98;108;14;59;34;1;14;0;328;0;APRIL
2168;SULAWESI BARAT;MAJENE;BANGGAE;BARU;513;149;129;9;188;12;0;26;0;513;0;APRIL
2169;SULAWESI BARAT;MAJENE;BANGGAE;PANGALI ALI;837;308;220;12;201;59;2;32;0;834;3;APRIL
2170;SULAWESI BARAT;MAJENE;BANGGAE;TOTOLI;445;152;107;15;140;12;1;18;0;445;0;APRIL
2171;SULAWESI BARAT;MAJENE;BANGGAE;RANGAS;886;351;324;18;140;32;2;17;2;886;0;APRIL
2172;SULAWESI BARAT;MAJENE;BANGGAE;GALUNG;253;51;17;30;86;29;0;38;0;251;2;APRIL
2173;SULAWESI BARAT;MAJENE;BANGGAE;PALIPI SOREANG;238;107;43;16;55;11;0;6;0;238;0;APRIL
2174;SULAWESI BARAT;MAJENE;BANGGAE;PAMBOBORANG;227;38;73;11;76;5;0;23;0;226;1;APRIL
2175;SULAWESI BARAT;MAJENE;ULUMANDA;KABIRAAN;140;92;21;0;24;1;0;2;0;140;0;APRIL
2176;SULAWESI BARAT;MAJENE;ULUMANDA;SAMBABO;92;51;15;2;22;0;0;0;0;90;2;APRIL
2177;SULAWESI BARAT;MAJENE;ULUMANDA;TANDEALLO;124;66;43;1;6;1;0;6;0;123;1;APRIL
2178;SULAWESI BARAT;MAJENE;ULUMANDA;ULUMANDA;141;44;72;3;8;4;1;9;0;141;0;APRIL
2179;SULAWESI BARAT;MAJENE;ULUMANDA;SALUTAMBUNG;107;78;17;1;9;0;0;2;0;107;0;APRIL
2180;SULAWESI BARAT;MAJENE;ULUMANDA;POPENGA;77;62;14;0;0;0;0;1;0;77;0;APRIL
2181;SULAWESI BARAT;MAJENE;ULUMANDA;SULAI;125;54;47;4;14;0;0;5;0;124;1;APRIL
2182;SULAWESI BARAT;MAJENE;ULUMANDA;PANGGALO;102;50;36;4;8;2;0;0;0;100;2;APRIL
2183;SULAWESI BARAT;MAMASA;RANTEBULAHAN TIMUR;SALUMOKANAN;95;42;16;0;30;6;0;1;0;95;0;APRIL
2184;SULAWESI BARAT;MAMASA;RANTEBULAHAN TIMUR;SALUMOKANAN BARAT;108;43;27;0;35;0;0;0;1;106;2;APRIL
2185;SULAWESI BARAT;MAMASA;RANTEBULAHAN TIMUR;BUANGIN;92;65;16;0;10;0;0;0;0;91;1;APRIL
2186;SULAWESI BARAT;MAMASA;RANTEBULAHAN TIMUR;BAMBANG BUDA;118;31;63;1;20;1;0;2;0;118;0;APRIL
2187;SULAWESI BARAT;MAMASA;RANTEBULAHAN TIMUR;LEKO;22;6;11;0;5;0;0;0;0;22;0;APRIL
2188;SULAWESI BARAT;MAMASA;RANTEBULAHAN TIMUR;KIRAK;73;45;22;0;6;0;0;0;0;73;0;APRIL
2189;SULAWESI BARAT;MAMASA;RANTEBULAHAN TIMUR;SALUMOKANAN UTARA;114;69;7;1;35;1;0;1;0;114;0;APRIL
2190;SULAWESI BARAT;MAMASA;RANTEBULAHAN TIMUR;SAMPALE;52;15;14;0;23;0;0;0;0;52;0;APRIL
2191;SULAWESI BARAT;MAMASA;PANA;PANA;57;15;33;2;5;1;0;0;1;57;0;APRIL
2192;SULAWESI BARAT;MAMASA;PANA;MANIPI;122;63;46;3;7;1;0;1;0;121;1;APRIL
2193;SULAWESI BARAT;MAMASA;PANA;MAMULLU;63;13;38;0;10;1;0;1;0;63;0;APRIL
2194;SULAWESI BARAT;MAMASA;PANA;SAPAN;55;18;12;0;25;0;0;0;0;55;0;APRIL
2195;SULAWESI BARAT;MAMASA;PANA;DATUBARINGAN;78;25;41;2;10;0;0;0;0;78;0;APRIL
2196;SULAWESI BARAT;MAMASA;PANA;PANURA;61;16;40;0;5;0;0;0;0;61;0;APRIL
2197;SULAWESI BARAT;MAMASA;PANA;TALLANG BULAWAN;71;21;38;4;7;0;0;1;0;71;0;APRIL
2198;SULAWESI BARAT;MAMASA;PANA;KARAKA;56;23;26;0;6;0;0;1;0;56;0;APRIL
2199;SULAWESI BARAT;MAMASA;PANA;ULUSALU;49;4;44;0;0;1;0;0;0;49;0;APRIL
2200;SULAWESI BARAT;MAMASA;PANA;WERI;51;7;36;2;4;1;0;1;0;51;0;APRIL
2201;SULAWESI BARAT;MAMASA;PANA;SALUTAMBUN;45;1;44;0;0;0;0;0;0;45;0;APRIL
2202;SULAWESI BARAT;MAMASA;PANA;SALOAN;98;32;55;0;10;0;0;0;0;97;1;APRIL
2203;SULAWESI BARAT;MAMASA;PANA;ULUSALU INDAH;51;33;18;0;0;0;0;0;0;51;0;APRIL
2204;SULAWESI BARAT;PASANGKAYU;PEDONGGA;MALEI;228;109;67;1;36;13;0;2;0;228;0;APRIL
2205;SULAWESI BARAT;PASANGKAYU;PEDONGGA;PEDANDA;200;53;52;4;78;5;0;7;0;199;1;APRIL
2206;SULAWESI BARAT;PASANGKAYU;PEDONGGA;BATU OGE;142;60;27;1;46;7;0;1;0;142;0;APRIL
2207;SULAWESI BARAT;PASANGKAYU;PEDONGGA;MARTASARI;572;223;63;7;245;21;0;11;0;570;2;APRIL
2208;SULAWESI BARAT;MAMASA;SESENAPADANG;OROBUA;205;36;19;3;117;18;0;4;3;200;5;APRIL
2209;SULAWESI BARAT;MAMASA;SESENAPADANG;PALADAN;65;11;6;0;44;1;0;0;0;62;3;APRIL
2210;SULAWESI BARAT;MAMASA;SESENAPADANG;OROBUA TIMUR;40;17;6;0;14;1;0;2;0;40;0;APRIL
2211;SULAWESI BARAT;MAMASA;SESENAPADANG;RANTE PUANG;94;21;20;0;48;2;0;1;0;92;2;APRIL
2212;SULAWESI BARAT;MAMASA;SESENAPADANG;SATENETEAN;46;6;23;0;15;1;0;1;0;46;0;APRIL
2213;SULAWESI BARAT;MAMASA;SESENAPADANG;LISUAN ADA;66;31;11;0;24;0;0;0;0;66;0;APRIL
2214;SULAWESI BARAT;MAMASA;SESENAPADANG;OROBUA SELATAN;65;17;10;0;20;18;0;0;0;65;0;APRIL
2215;SULAWESI BARAT;MAMASA;SESENAPADANG;MALANGKENA PADANG;72;20;5;0;46;0;0;0;1;72;0;APRIL
2216;SULAWESI BARAT;MAMASA;SESENAPADANG;MALIMBONG;27;7;1;0;18;0;0;1;0;27;0;APRIL
2217;SULAWESI BARAT;MAMASA;SESENAPADANG;MARAMPAN OROBUA;42;15;4;1;12;9;0;0;0;41;1;APRIL
2218;SULAWESI BARAT;MAMASA;NOSU;NOSU;78;6;34;2;22;7;0;5;0;76;2;APRIL
2219;SULAWESI BARAT;MAMASA;NOSU;MINANGA;24;0;16;1;7;0;0;0;0;24;0;APRIL
2220;SULAWESI BARAT;MAMASA;NOSU;BATUPAPAN;53;18;18;1;15;1;0;0;0;53;0;APRIL
2221;SULAWESI BARAT;MAMASA;NOSU;MASEWWE;21;5;3;0;13;0;0;0;0;21;0;APRIL
2222;SULAWESI BARAT;MAMASA;NOSU;SIWI;24;11;5;1;5;1;0;1;0;24;0;APRIL
2223;SULAWESI BARAT;MAMASA;NOSU;MINANGA TIMUR;10;2;2;0;6;0;0;0;0;10;0;APRIL
2224;SULAWESI BARAT;MAMASA;NOSU;PARINDING;23;2;16;0;5;0;0;0;0;23;0;APRIL
2225;SULAWESI BARAT;MAMUJU;TAPALANG;GALUNG;259;57;107;6;40;24;0;19;2;255;4;APRIL
2226;SULAWESI BARAT;MAMUJU;TAPALANG;KASAMBANG;214;75;63;1;57;4;0;11;2;213;1;APRIL
2227;SULAWESI BARAT;MAMUJU;TAPALANG;DAYANGINNA;123;35;38;9;25;6;0;7;0;120;3;APRIL
2228;SULAWESI BARAT;MAMUJU;TAPALANG;OROBATU;89;34;25;12;6;6;0;6;0;89;0;APRIL
2229;SULAWESI BARAT;MAMUJU;TAPALANG;TAKANDEANG;196;69;36;5;63;16;1;5;1;196;0;APRIL
2230;SULAWESI BARAT;MAMUJU;TAPALANG;BELA;46;30;7;0;9;0;0;0;0;46;0;APRIL
2231;SULAWESI BARAT;MAMUJU;TAPALANG;TAAN;240;89;84;1;54;3;0;8;0;239;1;APRIL
2232;SULAWESI BARAT;MAMUJU;TAPALANG;TAMPALANG;177;82;27;1;51;4;0;11;1;177;0;APRIL
2233;SULAWESI BARAT;MAMUJU;TAPALANG;RANTEDODA;72;36;12;7;11;0;0;6;0;72;0;APRIL
2234;SULAWESI BARAT;MAMUJU;TAPALANG;KOPEANG;70;41;21;0;8;0;0;0;0;70;0;APRIL
2235;SULAWESI BARAT;POLEWALI MANDAR;MAPILLI;MAPILI;109;42;9;6;34;4;0;14;0;109;0;APRIL
2236;SULAWESI BARAT;POLEWALI MANDAR;MAPILLI;UGIBARU;179;56;16;24;32;8;0;25;0;161;18;APRIL
2237;SULAWESI BARAT;POLEWALI MANDAR;MAPILLI;RUMPA;169;89;21;4;47;4;0;4;0;169;0;APRIL
2238;SULAWESI BARAT;POLEWALI MANDAR;MAPILLI;KURMA;298;170;50;0;63;1;0;14;0;298;0;APRIL
2239;SULAWESI BARAT;POLEWALI MANDAR;MAPILLI;BUKU;233;163;33;4;25;2;0;2;0;229;4;APRIL
2240;SULAWESI BARAT;POLEWALI MANDAR;MAPILLI;BONNE BONNE;129;44;20;10;39;9;0;7;0;129;0;APRIL
2241;SULAWESI BARAT;POLEWALI MANDAR;MAPILLI;BEROANGIN;219;73;27;1;95;5;0;13;1;215;4;APRIL
2242;SULAWESI BARAT;POLEWALI MANDAR;MAPILLI;SEGERANG;165;104;31;3;20;1;0;6;0;165;0;APRIL
2243;SULAWESI BARAT;POLEWALI MANDAR;MAPILLI;BONRA;173;84;50;2;28;1;0;8;0;173;0;APRIL
2244;SULAWESI BARAT;POLEWALI MANDAR;MAPILLI;SATTOKO;70;18;7;0;41;0;0;4;0;70;0;APRIL
2245;SULAWESI BARAT;POLEWALI MANDAR;MAPILLI;RAPPANG BARAT;313;101;109;5;68;4;0;25;0;312;1;APRIL
2246;SULAWESI BARAT;POLEWALI MANDAR;MAPILLI;LANDI KANUSUANG;328;128;40;1;142;0;0;17;0;328;0;APRIL
2247;SULAWESI BARAT;MAMUJU;SAMPAGA;BUNDE;514;254;128;3;123;1;0;5;0;514;0;APRIL
2248;SULAWESI BARAT;MAMUJU;SAMPAGA;KALONDING;450;182;184;6;70;4;0;3;0;449;1;APRIL
2249;SULAWESI BARAT;MAMUJU;SAMPAGA;TARAILU;262;121;80;0;50;5;0;6;0;262;0;APRIL
2250;SULAWESI BARAT;MAMUJU;SAMPAGA;SAMPAGA;186;90;65;2;25;1;0;2;1;186;0;APRIL
2251;SULAWESI BARAT;MAMUJU;SAMPAGA;TANAMBUAH;71;25;24;1;19;0;0;2;0;71;0;APRIL
2252;SULAWESI BARAT;MAMUJU;SAMPAGA;SALUBARANA;75;34;22;1;15;1;0;2;0;75;0;APRIL
2253;SULAWESI BARAT;MAMUJU;SAMPAGA;LOSSO;127;53;24;0;49;0;0;0;0;126;1;APRIL
2254;SULAWESI BARAT;POLEWALI MANDAR;TINAMBUNG;TINAMBUNG;127;42;25;5;25;4;0;26;0;127;0;APRIL
2255;SULAWESI BARAT;POLEWALI MANDAR;TINAMBUNG;KARAMA;463;336;48;19;43;2;0;15;0;463;0;APRIL
2256;SULAWESI BARAT;POLEWALI MANDAR;TINAMBUNG;TANGNGA TANGNGA;203;145;34;2;13;1;0;8;0;203;0;APRIL
2257;SULAWESI BARAT;POLEWALI MANDAR;TINAMBUNG;LEKOPADIS;83;32;16;3;25;1;0;5;0;82;1;APRIL
2258;SULAWESI BARAT;POLEWALI MANDAR;TINAMBUNG;GALUNG LOMBOK;131;50;21;9;33;3;0;15;0;131;0;APRIL
2259;SULAWESI BARAT;POLEWALI MANDAR;TINAMBUNG;TANDUNG;116;55;23;5;16;4;0;12;0;115;1;APRIL
2260;SULAWESI BARAT;POLEWALI MANDAR;TINAMBUNG;BATULAYA;118;46;25;17;16;4;0;10;0;118;0;APRIL
2261;SULAWESI BARAT;POLEWALI MANDAR;TINAMBUNG;SEPABATU;100;34;26;9;16;2;0;13;0;100;0;APRIL
2262;SULAWESI BARAT;MAMUJU;BONEHAU;BONEHAU;161;49;75;4;22;2;0;3;0;155;6;APRIL
2263;SULAWESI BARAT;MAMUJU;BONEHAU;SALUTIWO;89;32;36;1;20;0;0;0;0;89;0;APRIL
2264;SULAWESI BARAT;MAMUJU;BONEHAU;BUTTUADA;205;11;167;3;19;1;0;2;0;203;2;APRIL
2265;SULAWESI BARAT;MAMUJU;BONEHAU;TAMALEA;47;4;34;0;8;0;0;1;0;47;0;APRIL
2266;SULAWESI BARAT;MAMUJU;BONEHAU;LUMIKA;126;39;54;2;30;1;0;0;0;126;0;APRIL
2267;SULAWESI BARAT;MAMUJU;BONEHAU;MAPPU;72;15;42;1;13;0;0;1;0;72;0;APRIL
2268;SULAWESI BARAT;MAMUJU;BONEHAU;BANUADA;99;11;81;3;3;0;0;1;0;99;0;APRIL
2269;SULAWESI BARAT;MAMUJU;BONEHAU;HINUA;99;25;27;7;33;1;0;3;1;97;2;APRIL
2270;SULAWESI BARAT;MAMUJU;BONEHAU;KINATANG;106;21;81;2;0;0;0;2;0;106;0;APRIL
2271;SULAWESI BARAT;POLEWALI MANDAR;TUTAR;TARAMANU;199;91;39;5;41;1;12;10;0;199;0;APRIL
2272;SULAWESI BARAT;POLEWALI MANDAR;TUTAR;AMBOPADANG;271;105;57;1;105;2;0;1;0;271;0;APRIL
2273;SULAWESI BARAT;POLEWALI MANDAR;TUTAR;TUBBI;130;39;69;4;7;3;0;8;0;130;0;APRIL
2274;SULAWESI BARAT;POLEWALI MANDAR;TUTAR;RATTE;180;65;68;2;42;1;1;0;1;180;0;APRIL
2275;SULAWESI BARAT;POLEWALI MANDAR;TUTAR;BESOANGIN;122;67;8;2;45;0;0;0;0;122;0;APRIL
2276;SULAWESI BARAT;POLEWALI MANDAR;TUTAR;PIRIANG TAPIKO;110;28;59;0;21;0;0;2;0;110;0;APRIL
2277;SULAWESI BARAT;POLEWALI MANDAR;TUTAR;PEBURRU;188;106;46;2;27;2;0;5;0;188;0;APRIL
2278;SULAWESI BARAT;POLEWALI MANDAR;TUTAR;TALOBA;94;33;43;0;14;0;0;3;0;93;1;APRIL
2279;SULAWESI BARAT;POLEWALI MANDAR;TUTAR;POLLEWANI;255;141;78;2;31;0;0;3;0;255;0;APRIL
2280;SULAWESI BARAT;POLEWALI MANDAR;TUTAR;ARABUA;151;89;31;0;12;0;16;3;0;151;0;APRIL
2281;SULAWESI BARAT;POLEWALI MANDAR;TUTAR;BESOANGIN UTARA;105;60;14;4;27;0;0;0;0;105;0;APRIL
2282;SULAWESI BARAT;POLEWALI MANDAR;TUTAR;PODA;116;50;47;3;12;0;1;3;0;116;0;APRIL
2283;SULAWESI BARAT;POLEWALI MANDAR;TUTAR;TARAMANU TUA;168;33;48;2;75;3;0;4;0;165;3;APRIL
2284;SULAWESI BARAT;POLEWALI MANDAR;LUYO;BATUPANGA;227;110;39;4;61;2;1;6;0;223;4;APRIL
2285;SULAWESI BARAT;POLEWALI MANDAR;LUYO;MAMBU;202;110;23;2;40;1;1;13;3;193;9;APRIL
2286;SULAWESI BARAT;POLEWALI MANDAR;LUYO;TENGGELANG;261;132;52;12;46;0;1;7;0;250;11;APRIL
2287;SULAWESI BARAT;POLEWALI MANDAR;LUYO;BARU;256;83;63;25;41;6;0;22;0;240;16;APRIL
2288;SULAWESI BARAT;POLEWALI MANDAR;LUYO;PUSSUI;175;92;32;2;41;0;1;5;1;174;1;APRIL
2289;SULAWESI BARAT;POLEWALI MANDAR;LUYO;MAPILI BARAT;185;109;38;11;17;0;0;10;0;185;0;APRIL
2290;SULAWESI BARAT;POLEWALI MANDAR;LUYO;SAMBALI WALI;257;147;40;14;39;2;0;3;0;245;12;APRIL
2291;SULAWESI BARAT;POLEWALI MANDAR;LUYO;BATUPANGA DAALA;310;149;47;3;104;0;1;5;0;309;1;APRIL
2292;SULAWESI BARAT;POLEWALI MANDAR;LUYO;LUYO;199;119;17;0;45;2;3;12;0;198;1;APRIL
2293;SULAWESI BARAT;POLEWALI MANDAR;LUYO;PUSSUI BARAT;106;49;11;3;25;13;1;3;0;105;1;APRIL
2294;SULAWESI BARAT;POLEWALI MANDAR;LUYO;PUCCADI;201;147;21;0;25;2;0;6;0;201;0;APRIL
2295;SULAWESI BARAT;POLEWALI MANDAR;MATAKALI;MATAKALI;316;140;82;16;54;12;0;12;0;316;0;APRIL
2296;SULAWESI BARAT;POLEWALI MANDAR;MATAKALI;PETAMPANUA;282;131;94;3;33;14;2;5;0;282;0;APRIL
2297;SULAWESI BARAT;POLEWALI MANDAR;MATAKALI;BARUMBUNG;204;89;60;5;41;6;0;3;0;204;0;APRIL
2298;SULAWESI BARAT;POLEWALI MANDAR;MATAKALI;PASIANG;415;148;88;12;134;10;0;19;0;411;4;APRIL
2299;SULAWESI BARAT;POLEWALI MANDAR;MATAKALI;TONROLIMA;236;122;53;2;35;4;0;10;2;228;8;APRIL
2300;SULAWESI BARAT;POLEWALI MANDAR;MATAKALI;INDOMAKKOMBONG;383;187;103;1;69;5;0;10;2;377;6;APRIL
2301;SULAWESI BARAT;POLEWALI MANDAR;MATAKALI;BUNGA-BUNGA;144;65;49;6;19;1;0;4;0;144;0;APRIL
2302;SULAWESI BARAT;MAMUJU;KEP. BALA BALAKANG;BALA BALAKANG;122;61;48;3;9;0;0;0;0;121;1;APRIL
2303;SULAWESI BARAT;MAMUJU;KEP. BALA BALAKANG;BALA-BALAKANG TIMUR;99;27;70;1;0;0;1;0;0;99;0;APRIL
2304;SULAWESI BARAT;MAMUJU TENGAH;BUDONG-BUDONG;BABANA;600;290;98;10;164;21;2;14;0;599;1;APRIL
2305;SULAWESI BARAT;MAMUJU TENGAH;BUDONG-BUDONG;LUMU;243;104;32;0;94;3;0;8;0;241;2;APRIL
2306;SULAWESI BARAT;MAMUJU TENGAH;BUDONG-BUDONG;PONTANAKAYANG;337;205;27;9;85;4;0;0;1;331;6;APRIL
2307;SULAWESI BARAT;MAMUJU TENGAH;BUDONG-BUDONG;SALOGATTA;544;203;102;12;191;11;0;7;0;526;18;APRIL
2308;SULAWESI BARAT;MAMUJU TENGAH;BUDONG-BUDONG;KIRE;190;64;37;4;82;1;0;2;0;190;0;APRIL
2309;SULAWESI BARAT;MAMUJU TENGAH;BUDONG-BUDONG;TINALI;214;101;39;0;66;1;0;7;0;214;0;APRIL
2310;SULAWESI BARAT;MAMUJU TENGAH;BUDONG-BUDONG;SALUMANURUNG;153;70;46;3;26;2;0;6;0;153;0;APRIL
2311;SULAWESI BARAT;MAMUJU TENGAH;BUDONG-BUDONG;PASAPA;174;80;50;1;30;0;0;8;0;169;5;APRIL
2312;SULAWESI BARAT;MAMUJU TENGAH;BUDONG-BUDONG;BOJO;244;106;59;1;68;6;0;4;0;244;0;APRIL
2313;SULAWESI BARAT;MAMUJU TENGAH;BUDONG-BUDONG;BARAKKANG;117;58;18;4;35;1;0;1;0;117;0;APRIL
2314;SULAWESI BARAT;MAMUJU TENGAH;BUDONG-BUDONG;LEMBAH HADA;56;29;7;0;18;1;0;1;0;56;0;APRIL
2315;SULAWESI BARAT;MAMUJU TENGAH;TOPOYO;BUDONG-BUDONG;259;105;69;7;49;7;0;11;0;248;11;APRIL
2316;SULAWESI BARAT;MAMUJU TENGAH;TOPOYO;TOPOYO;937;310;224;17;186;58;0;25;0;820;117;APRIL
2317;SULAWESI BARAT;MAMUJU TENGAH;TOPOYO;TUMBU;323;155;67;2;70;18;0;10;0;322;1;APRIL
2318;SULAWESI BARAT;MAMUJU TENGAH;TOPOYO;KABUBU;276;84;49;21;105;12;1;4;0;276;0;APRIL
2319;SULAWESI BARAT;MAMUJU TENGAH;TOPOYO;WAEPUTEH;274;145;28;13;74;6;0;4;0;270;4;APRIL
2320;SULAWESI BARAT;MAMUJU TENGAH;TOPOYO;TANGKOU;137;73;26;0;31;3;0;2;2;137;0;APRIL
2321;SULAWESI BARAT;MAMUJU TENGAH;TOPOYO;TABOLANG;446;165;94;14;101;7;1;9;3;394;52;APRIL
2322;SULAWESI BARAT;MAMUJU TENGAH;TOPOYO;PARAILI;190;104;34;2;30;15;2;3;0;190;0;APRIL
2323;SULAWESI BARAT;MAMUJU TENGAH;TOPOYO;SALUPANGKANG;477;142;62;10;251;8;0;2;1;476;1;APRIL
2324;SULAWESI BARAT;MAMUJU TENGAH;TOPOYO;SALUPANGKANG IV;60;40;3;0;15;0;0;1;0;59;1;APRIL
2325;SULAWESI BARAT;MAMUJU TENGAH;TOPOYO;TAPPILINA;154;55;32;11;35;14;0;7;0;154;0;APRIL
2326;SULAWESI BARAT;MAMUJU TENGAH;TOPOYO;BAMBAMANURUNG;157;69;11;4;66;6;0;0;1;157;0;APRIL
2327;SULAWESI BARAT;MAMUJU TENGAH;TOPOYO;SALULEKBO;391;160;89;6;132;2;0;1;0;390;1;APRIL
2328;SULAWESI BARAT;MAMUJU TENGAH;TOPOYO;PANGALLOANG;255;83;48;2;113;6;0;2;0;254;1;APRIL
2329;SULAWESI BARAT;MAMUJU TENGAH;TOPOYO;SINABATTA;117;58;34;2;13;5;0;1;0;113;4;APRIL
2330;SULAWESI BARAT;POLEWALI MANDAR;POLEWALI;POLEWALI;510;161;144;40;80;30;0;43;0;498;12;APRIL
2331;SULAWESI BARAT;POLEWALI MANDAR;POLEWALI;WATTANG;198;59;65;14;27;16;0;17;0;198;0;APRIL
2332;SULAWESI BARAT;POLEWALI MANDAR;POLEWALI;SULEWATANG;336;89;152;4;71;7;0;13;0;336;0;APRIL
2333;SULAWESI BARAT;POLEWALI MANDAR;POLEWALI;LANTORA;405;109;167;18;49;36;0;26;0;405;0;APRIL
2334;SULAWESI BARAT;POLEWALI MANDAR;POLEWALI;TAKATIDUNG;478;238;91;17;75;20;0;20;0;461;17;APRIL
2335;SULAWESI BARAT;POLEWALI MANDAR;POLEWALI;PEKKABATA;317;149;57;26;41;27;0;16;0;316;1;APRIL
2336;SULAWESI BARAT;POLEWALI MANDAR;POLEWALI;MADATE;542;197;146;71;81;18;0;29;0;542;0;APRIL
2337;SULAWESI BARAT;POLEWALI MANDAR;POLEWALI;MANDING;416;149;100;16;95;21;0;34;0;415;1;APRIL
2338;SULAWESI BARAT;POLEWALI MANDAR;POLEWALI;DARMA;499;199;128;15;112;15;0;30;0;499;0;APRIL
2339;SULAWESI BARAT;POLEWALI MANDAR;MATANGNGA;MATANGNGA;68;34;7;3;20;1;0;3;0;68;0;APRIL
2340;SULAWESI BARAT;POLEWALI MANDAR;MATANGNGA;LILLI;106;44;12;1;47;0;0;1;0;105;1;APRIL
2341;SULAWESI BARAT;POLEWALI MANDAR;MATANGNGA;RANGOAN;71;26;29;0;14;0;0;0;0;69;2;APRIL
2342;SULAWESI BARAT;POLEWALI MANDAR;MATANGNGA;TAPUA;162;73;27;7;54;0;0;1;0;162;0;APRIL
2343;SULAWESI BARAT;POLEWALI MANDAR;MATANGNGA;MAMBU TAPUA;95;31;12;1;48;0;0;3;0;95;0;APRIL
2344;SULAWESI BARAT;POLEWALI MANDAR;MATANGNGA;BA'BA TAPUA;71;30;10;0;31;0;0;0;0;71;0;APRIL
2345;SULAWESI BARAT;POLEWALI MANDAR;MATANGNGA;KATIMBANG;89;39;22;1;25;1;0;0;0;88;1;APRIL
2346;SULAWESI BARAT;POLEWALI MANDAR;TAPANGO;PELITAKAN;162;93;25;1;15;1;0;11;0;146;16;APRIL
2347;SULAWESI BARAT;POLEWALI MANDAR;TAPANGO;TAPANGO;214;119;40;3;41;5;0;6;0;214;0;APRIL
2348;SULAWESI BARAT;POLEWALI MANDAR;TAPANGO;RAPPANG;217;114;49;2;41;2;0;8;0;216;1;APRIL
2349;SULAWESI BARAT;POLEWALI MANDAR;TAPANGO;DAKKA;160;73;43;3;32;2;0;4;0;157;3;APRIL
2350;SULAWESI BARAT;POLEWALI MANDAR;TAPANGO;BATU;136;80;22;1;25;1;0;5;0;134;2;APRIL
2351;SULAWESI BARAT;POLEWALI MANDAR;TAPANGO;RISO;178;100;12;0;55;4;0;5;0;176;2;APRIL
2352;SULAWESI BARAT;POLEWALI MANDAR;TAPANGO;PALATTA;179;71;59;1;37;1;0;1;0;170;9;APRIL
2353;SULAWESI BARAT;POLEWALI MANDAR;TAPANGO;TAPANGO BARAT;146;77;34;1;22;3;0;9;0;146;0;APRIL
2354;SULAWESI BARAT;POLEWALI MANDAR;TAPANGO;KURRAK;77;40;31;0;4;1;0;1;0;77;0;APRIL
2355;SULAWESI BARAT;POLEWALI MANDAR;TAPANGO;BUSSU;146;89;32;5;16;2;0;2;0;146;0;APRIL
2356;SULAWESI BARAT;POLEWALI MANDAR;TAPANGO;TUTTULA;109;72;15;2;14;1;0;0;0;104;5;APRIL
2357;SULAWESI BARAT;POLEWALI MANDAR;TAPANGO;JAMBU MALEA;197;81;71;6;29;0;0;10;0;197;0;APRIL
2358;SULAWESI BARAT;POLEWALI MANDAR;TAPANGO;KALIMBUA;194;126;38;1;22;2;0;5;0;194;0;APRIL
2359;SULAWESI BARAT;POLEWALI MANDAR;TAPANGO;BANATO REJO;331;203;81;0;33;6;0;3;0;326;5;APRIL
2360;SULAWESI BARAT;MAMUJU;KALUMPANG;KALUMPANG;51;25;13;0;6;0;0;3;0;47;4;APRIL
2361;SULAWESI BARAT;MAMUJU;KALUMPANG;KARATAUN;180;109;34;0;34;0;0;1;0;178;2;APRIL
2362;SULAWESI BARAT;MAMUJU;KALUMPANG;KARAMA;123;54;48;0;20;0;0;1;0;123;0;APRIL
2363;SULAWESI BARAT;MAMUJU;KALUMPANG;SIRAUN;101;59;22;0;18;0;0;0;1;100;1;APRIL
2364;SULAWESI BARAT;MAMUJU;KALUMPANG;TUMOGA;73;34;12;0;20;0;0;0;0;66;7;APRIL
2365;SULAWESI BARAT;MAMUJU;KALUMPANG;SALUMAKKI;93;67;14;0;10;0;0;0;0;91;2;APRIL
2366;SULAWESI BARAT;MAMUJU;KALUMPANG;POLIO;62;31;24;0;7;0;0;0;0;62;0;APRIL
2367;SULAWESI BARAT;MAMUJU;KALUMPANG;LIMBONG;90;28;15;0;45;1;0;1;0;90;0;APRIL
2368;SULAWESI BARAT;MAMUJU;KALUMPANG;SANDAPANG;93;28;3;0;61;0;0;0;0;92;1;APRIL
2369;SULAWESI BARAT;MAMUJU;KALUMPANG;KONDO BULO;87;51;28;0;6;0;0;1;0;86;1;APRIL
2370;SULAWESI BARAT;MAMUJU;KALUMPANG;MAKKALIKI;70;35;18;0;17;0;0;0;0;70;0;APRIL
2371;SULAWESI BARAT;MAMUJU;KALUMPANG;BATU MAKKADA;80;36;36;0;7;0;0;0;0;79;1;APRIL
2372;SULAWESI BARAT;MAMUJU;KALUMPANG;LASA';116;73;26;0;13;0;0;0;1;113;3;APRIL
2373;SULAWESI BARAT;MAMUJU;MAMUJU;BINANGA;781;453;160;16;69;52;1;17;4;772;9;APRIL
2374;SULAWESI BARAT;MAMUJU;MAMUJU;MAMUNYU;605;311;164;39;47;25;1;14;0;601;4;APRIL
2375;SULAWESI BARAT;MAMUJU;MAMUJU;KAREMA;864;450;125;39;97;61;2;32;0;806;58;APRIL
2376;SULAWESI BARAT;MAMUJU;MAMUJU;RIMUKU;703;307;156;36;51;74;2;31;1;658;45;APRIL
2377;SULAWESI BARAT;MAMUJU;MAMUJU;BAMBU;387;228;77;15;47;4;0;16;0;387;0;APRIL
2378;SULAWESI BARAT;MAMUJU;MAMUJU;KARAMPUANG;478;353;67;2;29;10;0;14;0;475;3;APRIL
2379;SULAWESI BARAT;MAMUJU;MAMUJU;TADUI;496;164;218;1;56;7;0;29;3;478;18;APRIL
2380;SULAWESI BARAT;MAMUJU;MAMUJU;BATU PANNU;184;132;32;0;13;3;0;4;0;184;0;APRIL
2381;SULAWESI BARAT;MAMASA;BALLA;BALLA;169;26;28;1;88;13;0;11;1;168;1;APRIL
2382;SULAWESI BARAT;MAMASA;BALLA;BALLA BARAT;90;41;14;0;34;0;0;1;0;90;0;APRIL
2383;SULAWESI BARAT;MAMASA;BALLA;BALLA SATANETEAN;148;59;12;3;62;8;0;3;0;147;1;APRIL
2384;SULAWESI BARAT;MAMASA;BALLA;BALLA TUMUKA;114;39;34;0;39;1;0;1;0;114;0;APRIL
2385;SULAWESI BARAT;MAMASA;BALLA;SEPAKUAN;153;50;13;1;86;1;0;2;0;153;0;APRIL
2386;SULAWESI BARAT;MAMASA;BALLA;PIDARA;66;26;9;0;29;1;0;1;0;66;0;APRIL
2387;SULAWESI BARAT;MAMASA;BALLA;BAMBAPUANG;64;30;13;0;21;0;0;0;0;64;0;APRIL
2388;SULAWESI BARAT;MAMASA;BALLA;BALLA TIMUR;37;7;2;0;24;1;0;3;0;37;0;APRIL
2389;SULAWESI BARAT;MAMUJU;SIMBORO;SIMBORO;1550;617;188;71;163;245;1;67;5;1357;193;APRIL
2390;SULAWESI BARAT;MAMUJU;SIMBORO;RANGAS;552;171;151;18;120;19;3;10;0;492;60;APRIL
2391;SULAWESI BARAT;MAMUJU;SIMBORO;BOTTENG;194;116;40;1;22;2;0;12;0;193;1;APRIL
2392;SULAWESI BARAT;MAMUJU;SIMBORO;SALETTO;290;133;79;5;45;5;1;22;0;290;0;APRIL
2393;SULAWESI BARAT;MAMUJU;SIMBORO;SUMARE;222;102;82;2;25;10;0;1;0;222;0;APRIL
2394;SULAWESI BARAT;MAMUJU;SIMBORO;BOTTENG UTARA;356;148;86;1;100;4;1;0;0;340;16;APRIL
2395;SULAWESI BARAT;MAMUJU;SIMBORO;TAPANDULLU;44;28;1;0;11;0;2;2;0;44;0;APRIL
2396;SULAWESI BARAT;MAMUJU;SIMBORO;PATI'DI;190;108;43;1;34;1;0;3;0;190;0;APRIL
2397;SULAWESI BARAT;MAMASA;ARALLE;ARALLE;108;41;54;2;7;1;0;3;0;108;0;APRIL
2398;SULAWESI BARAT;MAMASA;ARALLE;RALLE ANAK;33;5;19;0;6;0;0;3;0;33;0;APRIL
2399;SULAWESI BARAT;MAMASA;ARALLE;PANETEAN;75;56;19;0;0;0;0;0;0;75;0;APRIL
2400;SULAWESI BARAT;MAMASA;ARALLE;UHAILANU;66;19;28;0;10;3;0;5;0;65;1;APRIL
2401;SULAWESI BARAT;MAMASA;ARALLE;ARALLE UTARA;66;29;36;0;1;0;0;0;0;66;0;APRIL
2402;SULAWESI BARAT;MAMASA;ARALLE;UHAIDAHO;55;8;38;3;6;0;0;0;0;55;0;APRIL
2403;SULAWESI BARAT;MAMASA;ARALLE;BARURU;91;64;25;0;1;0;0;0;1;91;0;APRIL
2404;SULAWESI BARAT;MAMASA;ARALLE;RALLEANAK UTARA;40;18;18;0;3;0;0;1;0;40;0;APRIL
2405;SULAWESI BARAT;MAMASA;ARALLE;PAMOSEANG PANGGA;36;14;19;2;1;0;0;0;0;36;0;APRIL
2406;SULAWESI BARAT;MAMASA;ARALLE;KALABE;62;21;39;0;2;0;0;0;0;62;0;APRIL
2407;SULAWESI BARAT;MAMASA;ARALLE;ARALLE SELATAN;29;10;16;0;2;0;0;1;0;29;0;APRIL
2408;SULAWESI BARAT;MAMASA;ARALLE;HAHANGAN;36;15;15;0;6;0;0;0;0;36;0;APRIL
2409;SULAWESI BARAT;POLEWALI MANDAR;LIMBORO;LIMBORO;117;38;25;14;18;3;0;9;0;107;10;APRIL
2410;SULAWESI BARAT;POLEWALI MANDAR;LIMBORO;LEMBANG LEMBANG;219;91;48;31;32;5;0;12;0;219;0;APRIL
2411;SULAWESI BARAT;POLEWALI MANDAR;LIMBORO;TANDASURA;138;72;18;11;25;2;0;8;0;136;2;APRIL
2412;SULAWESI BARAT;POLEWALI MANDAR;LIMBORO;SAMASUNDU;139;46;47;9;25;6;0;6;0;139;0;APRIL
2413;SULAWESI BARAT;POLEWALI MANDAR;LIMBORO;NAPO;159;89;23;3;35;0;0;9;0;159;0;APRIL
2414;SULAWESI BARAT;POLEWALI MANDAR;LIMBORO;TODANG TODANG;37;16;15;4;2;0;0;0;0;37;0;APRIL
2415;SULAWESI BARAT;POLEWALI MANDAR;LIMBORO;PENDULANGAN;56;33;19;0;1;0;0;3;0;56;0;APRIL
2416;SULAWESI BARAT;POLEWALI MANDAR;LIMBORO;RENGGEANG;102;34;30;5;29;0;0;4;0;102;0;APRIL
2417;SULAWESI BARAT;POLEWALI MANDAR;LIMBORO;SALARRI;52;19;15;6;11;0;0;1;0;52;0;APRIL
2418;SULAWESI BARAT;POLEWALI MANDAR;LIMBORO;TANGAN BARU;79;30;10;2;32;0;0;5;0;79;0;APRIL
2419;SULAWESI BARAT;POLEWALI MANDAR;LIMBORO;PALECE;116;28;39;30;13;4;0;2;0;116;0;APRIL
2420;SULAWESI BARAT;MAMASA;MAMASA;MAMASA;368;60;45;3;180;60;0;20;0;368;0;APRIL
2421;SULAWESI BARAT;MAMASA;MAMASA;RAMBUSARATU;256;90;82;14;53;11;0;6;0;256;0;APRIL
2422;SULAWESI BARAT;MAMASA;MAMASA;OSANGO;477;92;75;11;191;88;1;14;1;473;4;APRIL
2423;SULAWESI BARAT;MAMASA;MAMASA;LAMBANAN;223;67;54;9;78;6;0;9;0;223;0;APRIL
2424;SULAWESI BARAT;MAMASA;MAMASA;LEMBANA SALULO;90;18;15;2;45;4;0;6;0;90;0;APRIL
2425;SULAWESI BARAT;MAMASA;MAMASA;TAUPE;233;54;28;8;139;1;1;2;0;233;0;APRIL
2426;SULAWESI BARAT;MAMASA;MAMASA;BUNTU BUDA;295;75;30;8;104;28;0;5;1;251;44;APRIL
2427;SULAWESI BARAT;MAMASA;MAMASA;TONDOK BAKARU;265;90;83;14;59;10;0;8;0;264;1;APRIL
2428;SULAWESI BARAT;MAMASA;MAMASA;PEBASSIAN;93;25;23;2;39;2;0;2;0;93;0;APRIL
2429;SULAWESI BARAT;MAMASA;MAMASA;MAMBULILING;117;55;20;2;36;3;0;1;0;117;0;APRIL
2430;SULAWESI BARAT;MAMASA;MAMASA;BOMBONG LAMBE;149;43;21;2;68;14;0;1;0;149;0;APRIL
2431;SULAWESI BARAT;MAMASA;MAMASA;BUBUN BATU;129;26;7;6;78;2;0;2;0;121;8;APRIL
2432;SULAWESI BARAT;MAMUJU;PAPALANG;TOABO;654;288;157;4;190;8;0;5;1;653;1;APRIL
2433;SULAWESI BARAT;MAMUJU;PAPALANG;PAPALANG;678;317;172;7;135;3;0;5;0;639;39;APRIL
2434;SULAWESI BARAT;MAMUJU;PAPALANG;BONDA;316;178;89;1;44;1;0;2;0;315;1;APRIL
2435;SULAWESI BARAT;MAMUJU;PAPALANG;TOPORE;199;108;43;7;32;1;0;2;0;193;6;APRIL
2436;SULAWESI BARAT;MAMUJU;PAPALANG;SALUKAYU;256;131;88;0;29;2;0;6;0;256;0;APRIL
2437;SULAWESI BARAT;MAMUJU;PAPALANG;SUKADAMAI;109;58;36;1;10;0;0;4;0;109;0;APRIL
2438;SULAWESI BARAT;MAMUJU;PAPALANG;BODA-BODA;180;97;61;2;18;0;0;1;0;179;1;APRIL
2439;SULAWESI BARAT;MAMUJU;PAPALANG;SISANGO;106;32;63;0;6;3;0;1;0;105;1;APRIL
2440;SULAWESI BARAT;MAMUJU;PAPALANG;BATU AMPA;171;55;87;11;17;0;0;1;0;171;0;APRIL
2441;SULAWESI BARAT;POLEWALI MANDAR;CAMPALAGIAN;PAPPANG;150;84;13;11;8;6;0;13;1;136;14;APRIL
2442;SULAWESI BARAT;POLEWALI MANDAR;CAMPALAGIAN;LALIKO;175;113;32;3;6;3;0;18;0;175;0;APRIL
2443;SULAWESI BARAT;POLEWALI MANDAR;CAMPALAGIAN;BONDE;170;95;36;5;12;10;0;12;0;170;0;APRIL
2444;SULAWESI BARAT;POLEWALI MANDAR;CAMPALAGIAN;KATUMBANGAN LEMO;142;84;25;12;14;5;0;2;0;142;0;APRIL
2445;SULAWESI BARAT;POLEWALI MANDAR;CAMPALAGIAN;PANYAMPA;204;129;46;3;9;3;0;11;2;203;1;APRIL
2446;SULAWESI BARAT;POLEWALI MANDAR;CAMPALAGIAN;SURUANG;154;81;40;11;8;2;0;7;0;149;5;APRIL
2447;SULAWESI BARAT;POLEWALI MANDAR;CAMPALAGIAN;LAMPOKO;215;138;52;9;8;2;0;6;0;215;0;APRIL
2448;SULAWESI BARAT;POLEWALI MANDAR;CAMPALAGIAN;KATUMBANGAN;274;120;39;4;59;39;0;13;0;274;0;APRIL
2449;SULAWESI BARAT;POLEWALI MANDAR;CAMPALAGIAN;LAPEO;114;69;11;6;13;3;0;11;0;113;1;APRIL
2450;SULAWESI BARAT;POLEWALI MANDAR;CAMPALAGIAN;PARAPPE;247;149;56;3;33;3;0;1;0;245;2;APRIL
2451;SULAWESI BARAT;POLEWALI MANDAR;CAMPALAGIAN;ONGKO;91;29;12;10;32;4;0;4;0;91;0;APRIL
2452;SULAWESI BARAT;POLEWALI MANDAR;CAMPALAGIAN;KENJE;150;105;11;7;18;3;0;6;0;150;0;APRIL
2453;SULAWESI BARAT;POLEWALI MANDAR;CAMPALAGIAN;SUMARRANG;448;243;136;5;58;6;0;0;0;448;0;APRIL
2454;SULAWESI BARAT;POLEWALI MANDAR;CAMPALAGIAN;BOTTO;245;120;57;0;56;3;0;7;0;243;2;APRIL
2455;SULAWESI BARAT;POLEWALI MANDAR;CAMPALAGIAN;GATTUNGAN;164;54;17;23;44;16;0;9;0;163;1;APRIL
2456;SULAWESI BARAT;POLEWALI MANDAR;CAMPALAGIAN;PADANG TIMUR;129;64;19;4;35;2;0;5;0;129;0;APRIL
2457;SULAWESI BARAT;POLEWALI MANDAR;CAMPALAGIAN;PADANG;68;37;11;4;11;0;0;0;0;63;5;APRIL
2458;SULAWESI BARAT;POLEWALI MANDAR;CAMPALAGIAN;LAGI-AGI;207;170;13;2;14;2;0;6;0;207;0;APRIL
2459;SULAWESI BARAT;MAMUJU;KALUKKU;SINYONYOI;449;237;129;9;47;4;0;11;0;437;12;APRIL
2460;SULAWESI BARAT;MAMUJU;KALUKKU;BEBANGA;755;451;202;4;65;6;2;22;0;752;3;APRIL
2461;SULAWESI BARAT;MAMUJU;KALUKKU;KALUKKU;686;240;185;8;180;24;1;28;0;666;20;APRIL
2462;SULAWESI BARAT;MAMUJU;KALUKKU;SINYONYOI SELATAN;270;127;76;5;31;3;0;22;0;264;6;APRIL
2463;SULAWESI BARAT;MAMUJU;KALUKKU;SONDOANG;271;116;82;1;65;1;0;4;1;270;1;APRIL
2464;SULAWESI BARAT;MAMUJU;KALUKKU;BERU-BERU;555;313;95;2;131;3;0;10;1;555;0;APRIL
2465;SULAWESI BARAT;MAMUJU;KALUKKU;BELANG BELANG;387;176;121;2;74;2;0;12;0;387;0;APRIL
2466;SULAWESI BARAT;MAMUJU;KALUKKU;KABULOANG;357;138;132;2;71;1;1;8;1;354;3;APRIL
2467;SULAWESI BARAT;MAMUJU;KALUKKU;KEANG;234;68;130;1;28;1;0;4;0;232;2;APRIL
2468;SULAWESI BARAT;MAMUJU;KALUKKU;POKKANG;198;82;39;2;63;3;1;8;0;198;0;APRIL
2469;SULAWESI BARAT;MAMUJU;KALUKKU;GULILING;142;56;48;0;31;1;0;2;3;141;1;APRIL
2470;SULAWESI BARAT;MAMUJU;KALUKKU;UHAIMATE;121;79;34;1;7;0;0;0;0;121;0;APRIL
2471;SULAWESI BARAT;MAMUJU;KALUKKU;KALUKKU BARAT;477;283;65;1;122;2;0;4;0;477;0;APRIL
2472;SULAWESI BARAT;MAMUJU;KALUKKU;PAMMULUKANG;228;114;75;7;18;0;0;12;1;227;1;APRIL
2473;SULAWESI BARAT;POLEWALI MANDAR;BULO;BULO;105;22;7;2;72;2;0;0;0;105;0;APRIL
2474;SULAWESI BARAT;POLEWALI MANDAR;BULO;PULLIWA;306;101;50;3;138;3;0;10;0;305;1;APRIL
2475;SULAWESI BARAT;POLEWALI MANDAR;BULO;PATAMBANUA;142;29;102;0;8;0;0;1;0;140;2;APRIL
2476;SULAWESI BARAT;POLEWALI MANDAR;BULO;KAROMBANG;138;79;22;0;34;2;0;1;0;138;0;APRIL
2477;SULAWESI BARAT;POLEWALI MANDAR;BULO;DAALA TIMUR;124;42;60;2;19;0;0;1;0;124;0;APRIL
2478;SULAWESI BARAT;POLEWALI MANDAR;BULO;LENGGO;48;16;29;1;1;1;0;0;0;48;0;APRIL
2479;SULAWESI BARAT;POLEWALI MANDAR;BULO;SABURA;69;29;30;0;9;0;0;1;0;69;0;APRIL
2480;SULAWESI BARAT;POLEWALI MANDAR;BULO;SEPPORRAKI;97;27;24;0;44;0;0;2;0;97;0;APRIL
2481;SULAWESI BARAT;POLEWALI MANDAR;BULO;IHING;108;20;24;2;56;1;0;1;0;104;4;APRIL
2482;SULAWESI BARAT;MAMUJU;TAPALANG BARAT;DUNGKAIT;244;102;97;5;32;3;1;2;0;242;2;APRIL
2483;SULAWESI BARAT;MAMUJU;TAPALANG BARAT;LEBANI;113;37;52;0;7;0;0;4;2;102;11;APRIL
2484;SULAWESI BARAT;MAMUJU;TAPALANG BARAT;LABUANG RANO;226;115;85;0;10;4;0;2;0;216;10;APRIL
2485;SULAWESI BARAT;MAMUJU;TAPALANG BARAT;PASABU;162;45;70;7;16;8;0;13;0;159;3;APRIL
2486;SULAWESI BARAT;MAMUJU;TAPALANG BARAT;TANETE PAO;44;31;10;0;2;0;0;0;0;43;1;APRIL
2487;SULAWESI BARAT;MAMUJU;TAPALANG BARAT;PANGASAAN;57;24;19;2;6;5;0;0;0;56;1;APRIL
2488;SULAWESI BARAT;MAMUJU;TAPALANG BARAT;AHU;166;91;58;2;5;0;0;2;0;158;8;APRIL
2489;SULAWESI BARAT;POLEWALI MANDAR;BINUANG;AMASSANGAN;305;146;56;1;68;2;0;32;0;305;0;APRIL
2490;SULAWESI BARAT;POLEWALI MANDAR;BINUANG;TONYAMAN;497;199;160;5;92;12;0;12;1;481;16;APRIL
2491;SULAWESI BARAT;POLEWALI MANDAR;BINUANG;KUAJANG;379;175;70;13;105;4;1;11;0;379;0;APRIL
2492;SULAWESI BARAT;POLEWALI MANDAR;BINUANG;PAKU;157;79;38;9;19;0;1;10;1;157;0;APRIL
2493;SULAWESI BARAT;POLEWALI MANDAR;BINUANG;MIRRING;222;116;40;5;39;1;0;18;0;219;3;APRIL
2494;SULAWESI BARAT;POLEWALI MANDAR;BINUANG;BATETANGNGA;686;401;142;11;79;7;0;15;2;657;29;APRIL
2495;SULAWESI BARAT;POLEWALI MANDAR;BINUANG;MAMMI;254;85;68;8;80;3;0;9;0;253;1;APRIL
2496;SULAWESI BARAT;POLEWALI MANDAR;BINUANG;KALEOK;144;47;64;2;26;0;0;5;0;144;0;APRIL
2497;SULAWESI BARAT;POLEWALI MANDAR;BINUANG;AMOLA;150;87;22;2;36;0;1;2;0;150;0;APRIL
2498;SULAWESI BARAT;POLEWALI MANDAR;BINUANG;REA;244;101;76;9;31;1;2;18;0;238;6;APRIL
2499;SULAWESI BARAT;MAMASA;BAMBANG;MOKALLANG;40;16;19;1;3;0;0;1;0;40;0;APRIL
2500;SULAWESI BARAT;MAMASA;BAMBANG;MASOSO;45;19;13;0;13;0;0;0;0;45;0;APRIL
2501;SULAWESI BARAT;MAMASA;BAMBANG;SALUASSING;123;86;22;6;8;0;0;1;0;123;0;APRIL
2502;SULAWESI BARAT;MAMASA;BAMBANG;SALUBULO;59;27;14;0;13;1;0;0;0;55;4;APRIL
2503;SULAWESI BARAT;MAMASA;BAMBANG;SALUKADI;78;33;36;0;9;0;0;0;0;78;0;APRIL
2504;SULAWESI BARAT;MAMASA;BAMBANG;SALUKEPOPOK;110;55;17;9;27;1;0;0;0;109;1;APRIL
2505;SULAWESI BARAT;MAMASA;BAMBANG;ULUMAMBI BARAT;61;22;39;0;0;0;0;0;0;61;0;APRIL
2506;SULAWESI BARAT;MAMASA;BAMBANG;LIMBADEBATA;105;34;12;0;55;1;0;3;0;105;0;APRIL
2507;SULAWESI BARAT;MAMASA;BAMBANG;TANETE TOMBA;56;27;26;0;3;0;0;0;0;56;0;APRIL
2508;SULAWESI BARAT;MAMASA;BAMBANG;BAMBANG;132;82;18;1;24;3;0;3;0;131;1;APRIL
2509;SULAWESI BARAT;MAMASA;BAMBANG;RANTELEMO;53;11;25;0;15;2;0;0;0;53;0;APRIL
2510;SULAWESI BARAT;MAMASA;BAMBANG;SALUDENGEN;34;7;21;0;2;1;0;0;0;31;3;APRIL
2511;SULAWESI BARAT;MAMASA;BAMBANG;ULUMAMBI;61;9;44;1;0;0;0;0;0;54;7;APRIL
2512;SULAWESI BARAT;MAMASA;BAMBANG;BAMBANG TIMUR;69;44;21;0;2;1;0;1;0;69;0;APRIL
2513;SULAWESI BARAT;MAMASA;BAMBANG;MINANGA;135;52;39;0;40;0;0;4;0;135;0;APRIL
2514;SULAWESI BARAT;MAMASA;BAMBANG;SIKAMASE;56;17;38;0;1;0;0;0;0;56;0;APRIL
2515;SULAWESI BARAT;MAMASA;BAMBANG;RANTETARIMA;30;4;26;0;0;0;0;0;0;30;0;APRIL
2516;SULAWESI BARAT;MAMASA;BAMBANG;SALURURU;30;3;1;3;22;0;0;1;0;30;0;APRIL
2517;SULAWESI BARAT;MAMASA;BAMBANG;SALUTABANG;35;19;11;1;1;2;0;1;0;35;0;APRIL
2518;SULAWESI BARAT;MAMASA;BAMBANG;BALATANA;52;33;19;0;0;0;0;0;0;52;0;APRIL
2519;SULAWESI BARAT;PASANGKAYU;TIKKE RAYA;TIKKE;324;97;61;4;100;41;0;12;0;315;9;APRIL
2520;SULAWESI BARAT;PASANGKAYU;TIKKE RAYA;MAKMUR JAYA;486;193;119;4;122;25;0;19;1;483;3;APRIL
2521;SULAWESI BARAT;PASANGKAYU;TIKKE RAYA;LARIANG;451;174;84;7;156;17;0;10;0;448;3;APRIL
2522;SULAWESI BARAT;PASANGKAYU;TIKKE RAYA;PAJALELE;402;173;81;1;101;26;1;16;1;400;2;APRIL
2523;SULAWESI BARAT;PASANGKAYU;TIKKE RAYA;JENGENG RAYA;239;86;49;6;70;21;0;7;0;239;0;APRIL
2524;SULAWESI BARAT;MAMASA;BUNTUMALANGKA;BUNTUMALANGKA;130;26;68;1;25;4;0;5;0;129;1;APRIL
2525;SULAWESI BARAT;MAMASA;BUNTUMALANGKA;RANTEBERAN;122;57;59;0;5;0;0;1;0;122;0;APRIL
2526;SULAWESI BARAT;MAMASA;BUNTUMALANGKA;KEBANGA;52;9;28;0;14;0;0;0;1;52;0;APRIL
2527;SULAWESI BARAT;MAMASA;BUNTUMALANGKA;SALURINDU;54;25;20;0;7;0;0;2;0;54;0;APRIL
2528;SULAWESI BARAT;MAMASA;BUNTUMALANGKA;TAORA;50;12;34;0;2;0;0;2;0;50;0;APRIL
2529;SULAWESI BARAT;MAMASA;BUNTUMALANGKA;KABAE;79;11;63;0;4;0;0;1;0;79;0;APRIL
2530;SULAWESI BARAT;MAMASA;BUNTUMALANGKA;SALUTAMBUN BARAT;63;28;33;0;1;0;1;0;0;63;0;APRIL
2531;SULAWESI BARAT;MAMASA;BUNTUMALANGKA;PENATANGAN;121;44;46;0;22;2;1;1;1;117;4;APRIL
2532;SULAWESI BARAT;MAMASA;BUNTUMALANGKA;SALUTAMBUN TIMUR;48;13;33;0;1;0;0;1;0;48;0;APRIL
2533;SULAWESI BARAT;MAMASA;BUNTUMALANGKA;SALUTAMBUN;38;9;22;0;3;2;0;2;0;38;0;APRIL
2534;SULAWESI BARAT;MAMASA;BUNTUMALANGKA;ARALLE TIMUR;102;23;68;0;3;0;0;1;0;95;7;APRIL
2535;SULAWESI BARAT;MAMASA;MAMBI;MAMBI;78;45;22;2;8;1;0;0;0;78;0;APRIL
2536;SULAWESI BARAT;MAMASA;MAMBI;TALIPUKKI;121;90;12;3;10;2;0;3;0;120;1;APRIL
2537;SULAWESI BARAT;MAMASA;MAMBI;RANTEBULAHAN;57;17;30;0;7;1;0;1;0;56;1;APRIL
2538;SULAWESI BARAT;MAMASA;MAMBI;SONDONGLAYU;36;17;5;2;7;0;0;5;0;36;0;APRIL
2539;SULAWESI BARAT;MAMASA;MAMBI;SALUBANUA;37;15;19;0;2;0;0;0;0;36;1;APRIL
2540;SULAWESI BARAT;MAMASA;MAMBI;TAPALINA;112;73;32;6;0;0;0;0;0;111;1;APRIL
2541;SULAWESI BARAT;MAMASA;MAMBI;SENDANA;154;65;72;3;14;0;0;0;0;154;0;APRIL
2542;SULAWESI BARAT;MAMASA;MAMBI;PAMOSEAN;50;40;9;1;0;0;0;0;0;50;0;APRIL
2543;SULAWESI BARAT;MAMASA;MAMBI;SELUMAKA;125;32;93;0;0;0;0;0;0;125;0;APRIL
2544;SULAWESI BARAT;MAMASA;MAMBI;BUJUNG MANURUNG;44;23;17;1;2;1;0;0;0;44;0;APRIL
2545;SULAWESI BARAT;MAMASA;MAMBI;SALU ALO;82;24;51;0;7;0;0;0;0;82;0;APRIL
2546;SULAWESI BARAT;MAMASA;MAMBI;INDOBANUA;27;10;10;0;1;6;0;0;0;27;0;APRIL
2547;SULAWESI BARAT;MAMASA;MAMBI;SALUDURIAN;88;27;51;0;8;1;0;1;0;88;0;APRIL
2548;SULAWESI BARAT;POLEWALI MANDAR;WONOMULYO;SIDODADI;392;198;87;4;57;29;0;14;1;390;2;APRIL
2549;SULAWESI BARAT;POLEWALI MANDAR;WONOMULYO;SIDOREJO;274;156;52;12;23;13;0;16;0;272;2;APRIL
2550;SULAWESI BARAT;POLEWALI MANDAR;WONOMULYO;SUMBEREJO;480;227;78;26;102;33;0;7;1;474;6;APRIL
2551;SULAWESI BARAT;POLEWALI MANDAR;WONOMULYO;BUMIAYU;408;187;72;9;48;53;0;17;0;386;22;APRIL
2552;SULAWESI BARAT;POLEWALI MANDAR;WONOMULYO;KEBUNSARI;291;116;56;9;39;42;1;11;0;274;17;APRIL
2553;SULAWESI BARAT;POLEWALI MANDAR;WONOMULYO;BANUA BARU;184;99;28;7;19;15;0;8;0;176;8;APRIL
2554;SULAWESI BARAT;POLEWALI MANDAR;WONOMULYO;NEPO;254;154;47;1;36;8;1;4;0;251;3;APRIL
2555;SULAWESI BARAT;POLEWALI MANDAR;WONOMULYO;SUGIHWARAS;519;250;124;12;78;31;0;12;0;507;12;APRIL
2556;SULAWESI BARAT;POLEWALI MANDAR;WONOMULYO;CAMPURJO;241;113;44;7;39;19;0;18;0;240;1;APRIL
2557;SULAWESI BARAT;POLEWALI MANDAR;WONOMULYO;BUMIMULYO;197;103;52;0;29;9;0;2;0;195;2;APRIL
2558;SULAWESI BARAT;POLEWALI MANDAR;WONOMULYO;TUMPILING;230;116;55;2;34;4;0;8;0;219;11;APRIL
2559;SULAWESI BARAT;POLEWALI MANDAR;WONOMULYO;BAKKA-BAKKA;185;103;36;3;28;5;0;5;0;180;5;APRIL
2560;SULAWESI BARAT;POLEWALI MANDAR;WONOMULYO;ARJO SARI;280;151;81;5;12;18;0;7;0;274;6;APRIL
2561;SULAWESI BARAT;POLEWALI MANDAR;WONOMULYO;GALESON;239;161;31;3;27;5;0;7;0;234;5;APRIL
2562;SULAWESI BARAT;MAMUJU TENGAH;TOBADAK;MAHAHE;325;131;68;11;89;11;0;10;4;324;1;APRIL
2563;SULAWESI BARAT;MAMUJU TENGAH;TOBADAK;SALOBAJA;381;210;50;16;91;5;0;9;0;381;0;APRIL
2564;SULAWESI BARAT;MAMUJU TENGAH;TOBADAK;TOBADAK;1347;581;283;26;324;40;3;29;1;1287;60;APRIL
2565;SULAWESI BARAT;MAMUJU TENGAH;TOBADAK;PALONGAAN;282;93;85;5;79;4;0;15;0;281;1;APRIL
2566;SULAWESI BARAT;MAMUJU TENGAH;TOBADAK;BATU PARIGI;728;168;239;8;258;23;1;21;0;718;10;APRIL
2567;SULAWESI BARAT;MAMUJU TENGAH;TOBADAK;BAMBADARU;196;69;51;10;58;1;1;6;0;196;0;APRIL
2568;SULAWESI BARAT;MAMUJU TENGAH;TOBADAK;SEJATI;155;89;29;3;27;2;0;5;0;155;0;APRIL
2569;SULAWESI BARAT;MAMUJU TENGAH;TOBADAK;SALOADAK;261;120;18;1;103;10;0;7;0;259;2;APRIL
2570;SULAWESI BARAT;MAMUJU TENGAH;PANGALE;POLO PANGALE;241;58;56;7;111;4;0;3;0;239;2;APRIL
2571;SULAWESI BARAT;MAMUJU TENGAH;PANGALE;PANGALE;215;57;88;11;43;5;1;10;0;215;0;APRIL
2572;SULAWESI BARAT;MAMUJU TENGAH;PANGALE;SARTANAMAJU;84;30;19;10;18;2;0;5;0;84;0;APRIL
2573;SULAWESI BARAT;MAMUJU TENGAH;PANGALE;POLO LERENG;223;70;51;6;84;4;0;4;0;219;4;APRIL
2574;SULAWESI BARAT;MAMUJU TENGAH;PANGALE;KUO;427;208;67;2;127;13;0;8;2;427;0;APRIL
2575;SULAWESI BARAT;MAMUJU TENGAH;PANGALE;POLO CAMBA;148;50;45;11;36;1;0;2;3;148;0;APRIL
2576;SULAWESI BARAT;MAMUJU TENGAH;PANGALE;LAMBA-LAMBA;128;45;35;3;41;2;0;2;0;128;0;APRIL
2577;SULAWESI BARAT;MAMUJU TENGAH;PANGALE;KOMBILING;251;73;63;8;93;2;0;9;0;248;3;APRIL
2578;SULAWESI BARAT;MAMUJU TENGAH;PANGALE;LEMO-LEMO;131;52;39;1;36;2;1;0;0;131;0;APRIL
2579;SULAWESI BARAT;PASANGKAYU;BAMBALAMOTU;BAMBALAMOTU;384;179;74;4;77;23;0;26;0;383;1;APRIL
2580;SULAWESI BARAT;PASANGKAYU;BAMBALAMOTU;POLEWALI;448;166;146;2;88;30;0;16;0;448;0;APRIL
2581;SULAWESI BARAT;PASANGKAYU;BAMBALAMOTU;RANDOMAYANG;444;151;66;3;157;19;0;36;0;432;12;APRIL
2582;SULAWESI BARAT;PASANGKAYU;BAMBALAMOTU;PANGIANG;193;101;47;2;20;16;0;7;0;193;0;APRIL
2583;SULAWESI BARAT;PASANGKAYU;BAMBALAMOTU;KALOLA;473;124;117;0;203;16;0;13;0;473;0;APRIL
2584;SULAWESI BARAT;PASANGKAYU;BAMBALAMOTU;WULAI;253;57;72;0;99;5;0;19;0;252;1;APRIL
2585;SULAWESI BARAT;PASANGKAYU;BULU TABA;LILIMORI;290;109;38;7;81;33;0;22;0;290;0;APRIL
2586;SULAWESI BARAT;PASANGKAYU;BULU TABA;KARAVE;254;97;44;20;62;10;0;9;0;242;12;APRIL
2587;SULAWESI BARAT;PASANGKAYU;BULU TABA;BUKIT HARAPAN;146;59;38;0;34;10;1;4;0;146;0;APRIL
2588;SULAWESI BARAT;PASANGKAYU;BULU TABA;KASTABUANA;157;88;27;1;26;7;0;7;0;156;1;APRIL
2589;SULAWESI BARAT;PASANGKAYU;BULU TABA;SUMBER SARI;29;21;5;0;3;0;0;0;0;29;0;APRIL
2590;SULAWESI BARAT;PASANGKAYU;BULU TABA;LELEJAE;166;72;28;2;42;11;0;9;1;165;1;APRIL
2591;SULAWESI BARAT;PASANGKAYU;BULU TABA;OMPI;98;45;28;3;18;3;0;1;0;98;0;APRIL
2592;SULAWESI BARAT;MAMASA;MEHALAAN;MEHALAAN;55;21;17;1;13;1;0;2;0;55;0;MEI
2593;SULAWESI BARAT;MAMASA;MEHALAAN;BOTTENG;71;32;16;0;21;0;1;1;0;71;0;MEI
2594;SULAWESI BARAT;MAMASA;MEHALAAN;SALUKONTA;52;25;10;1;15;0;0;1;0;52;0;MEI
2595;SULAWESI BARAT;MAMASA;MEHALAAN;MESAKADA;57;18;19;1;19;0;0;0;0;57;0;MEI
2596;SULAWESI BARAT;MAMASA;MEHALAAN;MEHALAAN BARAT;91;33;24;0;31;0;0;3;0;91;0;MEI
2597;SULAWESI BARAT;MAMASA;MEHALAAN;SALUAHOK;71;22;24;2;19;0;0;4;0;71;0;MEI
2598;SULAWESI BARAT;MAMASA;MEHALAAN;SALUBALO;44;23;14;0;7;0;0;0;0;44;0;MEI
2599;SULAWESI BARAT;MAMASA;MEHALAAN;PASSEMBUK;41;19;11;0;11;0;0;0;0;41;0;MEI
2600;SULAWESI BARAT;MAMASA;MEHALAAN;KONDO;34;18;8;0;7;0;0;1;0;34;0;MEI
2601;SULAWESI BARAT;MAMASA;MEHALAAN;LEKO SUKAMAJU;32;13;10;0;8;0;0;1;0;32;0;MEI
2602;SULAWESI BARAT;MAMASA;MEHALAAN;ULUMEA;27;13;4;0;10;0;0;0;0;27;0;MEI
2603;SULAWESI BARAT;POLEWALI MANDAR;BALANIPA;BALANIPA;190;87;38;13;35;7;0;10;0;190;0;MEI
2604;SULAWESI BARAT;POLEWALI MANDAR;BALANIPA;TAMMAJARRA;186;124;15;26;14;4;0;3;0;186;0;MEI
2605;SULAWESI BARAT;POLEWALI MANDAR;BALANIPA;TAMANGGALLE;109;59;19;0;28;1;0;1;1;109;0;MEI
2606;SULAWESI BARAT;POLEWALI MANDAR;BALANIPA;MOSSO;80;54;17;4;4;0;0;1;0;80;0;MEI
2607;SULAWESI BARAT;POLEWALI MANDAR;BALANIPA;GALUNG TULUK;205;108;45;21;19;1;0;11;0;205;0;MEI
2608;SULAWESI BARAT;POLEWALI MANDAR;BALANIPA;SABANG SUBIK;207;116;33;11;25;4;0;18;0;207;0;MEI
2609;SULAWESI BARAT;POLEWALI MANDAR;BALANIPA;PAMBUSUANG;427;247;70;12;33;11;0;25;1;399;28;MEI
2610;SULAWESI BARAT;POLEWALI MANDAR;BALANIPA;BALA;334;254;29;3;19;4;0;22;0;331;3;MEI
2611;SULAWESI BARAT;POLEWALI MANDAR;BALANIPA;LAMBANAN;20;6;4;6;4;0;0;0;0;20;0;MEI
2612;SULAWESI BARAT;POLEWALI MANDAR;BALANIPA;LEGO;107;68;25;0;6;0;0;8;0;107;0;MEI
2613;SULAWESI BARAT;POLEWALI MANDAR;BALANIPA;PALLIS;26;11;8;1;4;1;0;1;0;26;0;MEI
2614;SULAWESI BARAT;PASANGKAYU;SARUDU;SARUDU;403;231;63;2;78;13;1;13;0;401;2;MEI
2615;SULAWESI BARAT;PASANGKAYU;SARUDU;BULU MARIO;322;100;54;23;100;27;0;18;0;322;0;MEI
2616;SULAWESI BARAT;PASANGKAYU;SARUDU;KUMASARI;264;125;48;4;70;9;0;6;1;263;1;MEI
2617;SULAWESI BARAT;PASANGKAYU;SARUDU;PATIKA;65;20;18;1;11;3;0;6;0;59;6;MEI
2618;SULAWESI BARAT;PASANGKAYU;SARUDU;DODA;278;133;58;3;78;3;0;3;0;278;0;MEI
2619;SULAWESI BARAT;PASANGKAYU;PASANGKAYU;PASANGKAYU;1502;637;379;29;150;229;24;49;0;1497;5;MEI
2620;SULAWESI BARAT;PASANGKAYU;PASANGKAYU;MARTAJAYA;180;63;33;3;43;25;0;13;0;180;0;MEI
2621;SULAWESI BARAT;PASANGKAYU;PASANGKAYU;PAKAVA;387;214;100;5;62;4;0;2;0;387;0;MEI
2622;SULAWESI BARAT;PASANGKAYU;PASANGKAYU;KARYA BERSAMA;323;161;53;2;77;20;0;10;0;323;0;MEI
2623;SULAWESI BARAT;PASANGKAYU;PASANGKAYU;AKO;435;204;87;3;75;41;0;14;0;424;11;MEI
2624;SULAWESI BARAT;PASANGKAYU;PASANGKAYU;GUNUNG SARI;548;297;81;7;106;23;0;26;0;540;8;MEI
2625;SULAWESI BARAT;MAMASA;PANA;PANA;60;16;35;2;6;1;0;0;0;60;0;MEI
2626;SULAWESI BARAT;MAMASA;PANA;MANIPI;122;61;45;3;10;1;0;1;0;121;1;MEI
2627;SULAWESI BARAT;MAMASA;PANA;MAMULLU;63;11;40;0;10;1;0;1;0;63;0;MEI
2628;SULAWESI BARAT;MAMASA;PANA;SAPAN;61;15;25;0;21;0;0;0;0;61;0;MEI
2629;SULAWESI BARAT;MAMASA;PANA;DATUBARINGAN;79;28;41;0;10;0;0;0;0;79;0;MEI
2630;SULAWESI BARAT;MAMASA;PANA;PANURA;61;16;40;0;5;0;0;0;0;61;0;MEI
2631;SULAWESI BARAT;MAMASA;PANA;TALLANG BULAWAN;71;22;37;4;7;0;0;1;0;71;0;MEI
2632;SULAWESI BARAT;MAMASA;PANA;KARAKA;64;24;33;0;6;0;0;1;0;64;0;MEI
2633;SULAWESI BARAT;MAMASA;PANA;ULUSALU;51;4;47;0;0;0;0;0;0;51;0;MEI
2634;SULAWESI BARAT;MAMASA;PANA;WERI;52;10;35;1;4;1;0;1;0;52;0;MEI
2635;SULAWESI BARAT;MAMASA;PANA;SALUTAMBUN;47;1;46;0;0;0;0;0;0;47;0;MEI
2636;SULAWESI BARAT;MAMASA;PANA;SALOAN;98;31;57;0;9;0;0;0;0;97;1;MEI
2637;SULAWESI BARAT;MAMASA;PANA;ULUSALU INDAH;53;24;29;0;0;0;0;0;0;53;0;MEI
2638;SULAWESI BARAT;MAMASA;SESENAPADANG;OROBUA;206;37;19;3;119;16;0;4;3;201;5;MEI
2639;SULAWESI BARAT;MAMASA;SESENAPADANG;PALADAN;65;10;6;0;45;1;0;0;0;62;3;MEI
2640;SULAWESI BARAT;MAMASA;SESENAPADANG;OROBUA TIMUR;38;15;7;0;14;1;0;1;0;38;0;MEI
2641;SULAWESI BARAT;MAMASA;SESENAPADANG;RANTE PUANG;94;22;20;0;47;2;0;1;0;92;2;MEI
2642;SULAWESI BARAT;MAMASA;SESENAPADANG;SATENETEAN;46;6;23;0;15;1;0;1;0;46;0;MEI
2643;SULAWESI BARAT;MAMASA;SESENAPADANG;LISUAN ADA;67;32;11;0;24;0;0;0;0;67;0;MEI
2644;SULAWESI BARAT;MAMASA;SESENAPADANG;OROBUA SELATAN;64;17;9;0;21;17;0;0;0;64;0;MEI
2645;SULAWESI BARAT;MAMASA;SESENAPADANG;MALANGKENA PADANG;71;18;6;0;46;0;0;0;1;71;0;MEI
2646;SULAWESI BARAT;MAMASA;SESENAPADANG;MALIMBONG;27;7;1;0;18;0;0;1;0;27;0;MEI
2647;SULAWESI BARAT;MAMASA;SESENAPADANG;MARAMPAN OROBUA;42;15;3;1;13;9;0;0;0;41;1;MEI
2648;SULAWESI BARAT;MAMASA;RANTEBULAHAN TIMUR;SALUMOKANAN;94;40;17;0;30;6;0;1;0;94;0;MEI
2649;SULAWESI BARAT;MAMASA;RANTEBULAHAN TIMUR;SALUMOKANAN BARAT;107;44;27;0;33;0;0;0;1;105;2;MEI
2650;SULAWESI BARAT;MAMASA;RANTEBULAHAN TIMUR;BUANGIN;94;66;18;0;9;0;0;0;0;93;1;MEI
2651;SULAWESI BARAT;MAMASA;RANTEBULAHAN TIMUR;BAMBANG BUDA;118;28;66;2;19;1;0;2;0;118;0;MEI
2652;SULAWESI BARAT;MAMASA;RANTEBULAHAN TIMUR;LEKO;22;6;11;0;5;0;0;0;0;22;0;MEI
2653;SULAWESI BARAT;MAMASA;RANTEBULAHAN TIMUR;KIRAK;73;45;22;0;6;0;0;0;0;73;0;MEI
2654;SULAWESI BARAT;MAMASA;RANTEBULAHAN TIMUR;SALUMOKANAN UTARA;114;70;7;1;34;1;0;1;0;114;0;MEI
2655;SULAWESI BARAT;MAMASA;RANTEBULAHAN TIMUR;SAMPALE;51;17;13;0;21;0;0;0;0;51;0;MEI
2656;SULAWESI BARAT;PASANGKAYU;SARJO;SARJO;291;87;54;26;65;12;0;44;1;289;2;MEI
2657;SULAWESI BARAT;PASANGKAYU;SARJO;MAPONU;134;44;29;0;44;10;0;4;2;133;1;MEI
2658;SULAWESI BARAT;PASANGKAYU;SARJO;LETAWA;221;89;23;13;67;10;1;18;0;221;0;MEI
2659;SULAWESI BARAT;PASANGKAYU;SARJO;SARUDE;242;56;43;28;77;13;0;24;0;241;1;MEI
2660;SULAWESI BARAT;MAMASA;MESSAWA;MESSAWA;36;8;19;0;7;0;0;2;0;36;0;MEI
2661;SULAWESI BARAT;MAMASA;MESSAWA;RIPPUNG;136;64;59;0;12;1;0;0;0;136;0;MEI
2662;SULAWESI BARAT;MAMASA;MESSAWA;MAKUANG;105;54;33;1;17;0;0;0;0;105;0;MEI
2663;SULAWESI BARAT;MAMASA;MESSAWA;SEPANG;72;38;33;0;1;0;0;0;0;72;0;MEI
2664;SULAWESI BARAT;MAMASA;MESSAWA;MALIMBONG;55;17;35;0;3;0;0;0;0;55;0;MEI
2665;SULAWESI BARAT;MAMASA;MESSAWA;MATANDE;85;16;56;6;6;1;0;0;0;85;0;MEI
2666;SULAWESI BARAT;MAMASA;MESSAWA;SIPAI;80;35;36;0;9;0;0;0;0;80;0;MEI
2667;SULAWESI BARAT;MAMASA;MESSAWA;PASMA MAMBU;48;15;22;0;11;0;0;0;0;48;0;MEI
2668;SULAWESI BARAT;MAMASA;MESSAWA;TANETE BATU;55;29;22;0;3;0;0;1;0;55;0;MEI
2669;SULAWESI BARAT;PASANGKAYU;PEDONGGA;MALEI;231;112;64;1;37;15;0;2;0;231;0;MEI
2670;SULAWESI BARAT;PASANGKAYU;PEDONGGA;PEDANDA;204;54;54;4;78;6;0;7;0;203;1;MEI
2671;SULAWESI BARAT;PASANGKAYU;PEDONGGA;BATU OGE;146;64;27;1;46;7;0;1;0;146;0;MEI
2672;SULAWESI BARAT;PASANGKAYU;PEDONGGA;MARTASARI;575;218;69;7;246;21;0;12;0;573;2;MEI
2673;SULAWESI BARAT;POLEWALI MANDAR;ANREAPI;ANREAPI;167;36;49;7;47;11;0;14;1;165;2;MEI
2674;SULAWESI BARAT;POLEWALI MANDAR;ANREAPI;DUAMPANUA;395;119;143;17;88;5;0;17;0;389;6;MEI
2675;SULAWESI BARAT;POLEWALI MANDAR;ANREAPI;KELAPA DUA;273;73;122;3;55;3;2;14;0;272;1;MEI
2676;SULAWESI BARAT;POLEWALI MANDAR;ANREAPI;PAPPANDANGAN;249;94;66;11;64;2;3;8;0;248;1;MEI
2677;SULAWESI BARAT;POLEWALI MANDAR;ANREAPI;KUNYI;240;35;111;4;67;4;0;11;1;233;7;MEI
2678;SULAWESI BARAT;MAJENE;MALUNDA;MALUNDA;148;50;41;15;21;12;3;6;0;148;0;MEI
2679;SULAWESI BARAT;MAJENE;MALUNDA;LAMUNGANG BATU;132;47;48;1;18;6;0;11;0;131;1;MEI
2680;SULAWESI BARAT;MAJENE;MALUNDA;BAMBANGAN;170;89;44;3;31;2;0;1;0;170;0;MEI
2681;SULAWESI BARAT;MAJENE;MALUNDA;LOMBANG;99;49;19;2;25;2;0;2;0;99;0;MEI
2682;SULAWESI BARAT;MAJENE;MALUNDA;LOMBONG;241;64;115;7;29;5;0;20;0;240;1;MEI
2683;SULAWESI BARAT;MAJENE;MALUNDA;MEKKATTA;218;104;27;10;58;5;0;8;0;212;6;MEI
2684;SULAWESI BARAT;MAJENE;MALUNDA;MALIAYA;154;69;32;8;36;3;0;6;0;154;0;MEI
2685;SULAWESI BARAT;MAJENE;MALUNDA;LOMBANG TIMUR;161;96;56;1;7;1;0;0;0;161;0;MEI
2686;SULAWESI BARAT;MAJENE;MALUNDA;SALUTAHONGAN;97;62;25;0;7;1;0;1;0;96;1;MEI
2687;SULAWESI BARAT;MAJENE;MALUNDA;LOMBONG TIMUR;101;17;31;12;3;19;0;19;0;101;0;MEI
2688;SULAWESI BARAT;MAJENE;MALUNDA;MEKKATTA SELATAN;123;40;30;4;33;7;0;7;1;122;1;MEI
2689;SULAWESI BARAT;MAJENE;MALUNDA;KAYUANGIN;186;91;40;13;13;12;0;13;0;182;4;MEI
2690;SULAWESI BARAT;MAMASA;TANDUK KALUA;MINAKE;82;26;7;1;44;2;0;2;0;82;0;MEI
2691;SULAWESI BARAT;MAMASA;TANDUK KALUA;MALABO;51;24;11;0;6;7;0;3;0;51;0;MEI
2692;SULAWESI BARAT;MAMASA;TANDUK KALUA;SINDAGAMANIK;142;79;20;1;40;1;0;1;0;142;0;MEI
2693;SULAWESI BARAT;MAMASA;TANDUK KALUA;PARONDOBULAWAN;107;71;10;1;21;1;0;3;0;107;0;MEI
2694;SULAWESI BARAT;MAMASA;TANDUK KALUA;TAMALANTIK;156;64;54;0;30;4;0;1;1;154;2;MEI
2695;SULAWESI BARAT;MAMASA;TANDUK KALUA;MANNABABA;69;28;2;0;39;0;0;0;0;69;0;MEI
2696;SULAWESI BARAT;MAMASA;TANDUK KALUA;MESAKADA;123;52;28;0;43;0;0;0;0;123;0;MEI
2697;SULAWESI BARAT;MAMASA;TANDUK KALUA;BALLABATU;144;21;15;0;105;2;0;1;0;144;0;MEI
2698;SULAWESI BARAT;MAMASA;TANDUK KALUA;PAMBE;85;22;18;1;41;2;1;0;0;85;0;MEI
2699;SULAWESI BARAT;MAMASA;TANDUK KALUA;SALURANO;72;30;13;0;28;1;0;0;0;72;0;MEI
2700;SULAWESI BARAT;MAMASA;TANDUK KALUA;TALIMBUNG;91;47;38;0;5;0;0;1;0;91;0;MEI
2701;SULAWESI BARAT;MAMASA;TANDUK KALUA;KANAN;114;43;25;0;35;8;0;1;0;112;2;MEI
2702;SULAWESI BARAT;MAJENE;BANGGAE TIMUR;BAURUNG;521;238;74;27;161;11;1;8;1;521;0;MEI
2703;SULAWESI BARAT;MAJENE;BANGGAE TIMUR;BARUGA;189;52;21;42;41;13;0;8;0;177;12;MEI
2704;SULAWESI BARAT;MAJENE;BANGGAE TIMUR;BARUGA DHUA;178;60;39;36;39;2;0;1;0;177;1;MEI
2705;SULAWESI BARAT;MAJENE;BANGGAE TIMUR;LABUANG;282;57;59;31;106;15;1;13;0;282;0;MEI
2706;SULAWESI BARAT;MAJENE;BANGGAE TIMUR;TANDE;129;22;31;25;38;4;0;4;0;124;5;MEI
2707;SULAWESI BARAT;MAJENE;BANGGAE TIMUR;LEMBANG;716;291;161;119;108;25;0;12;0;716;0;MEI
2708;SULAWESI BARAT;MAJENE;BANGGAE TIMUR;LABUANG UTARA;306;84;79;18;66;33;1;23;0;304;2;MEI
2709;SULAWESI BARAT;MAJENE;BANGGAE TIMUR;TANDE TIMUR;128;44;18;12;33;9;0;12;0;128;0;MEI
2710;SULAWESI BARAT;MAJENE;BANGGAE TIMUR;BUTTU BARUGA;80;24;9;3;42;0;0;1;0;79;1;MEI
2711;SULAWESI BARAT;MAMASA;TAWALIAN;TAWALIAN;247;114;41;0;74;8;0;8;0;245;2;MEI
2712;SULAWESI BARAT;MAMASA;TAWALIAN;TAWALIAN TIMUR;169;69;48;2;47;1;0;1;0;168;1;MEI
2713;SULAWESI BARAT;MAMASA;TAWALIAN;KARIANGO;205;77;52;0;76;0;0;0;0;205;0;MEI
2714;SULAWESI BARAT;MAMASA;TAWALIAN;RANTETANGNGA;145;23;40;5;69;4;0;3;0;144;1;MEI
2715;SULAWESI BARAT;MAJENE;SENDANA;MOSSO;335;149;88;5;60;20;1;10;1;334;1;MEI
2716;SULAWESI BARAT;MAJENE;SENDANA;MOSSO DHUA;89;25;24;5;9;11;2;5;0;81;8;MEI
2717;SULAWESI BARAT;MAJENE;SENDANA;TOTOLISI SENDANA;116;33;41;4;21;8;1;6;0;114;2;MEI
2718;SULAWESI BARAT;MAJENE;SENDANA;TALLUBANUA;134;45;29;11;12;19;1;7;0;124;10;MEI
2719;SULAWESI BARAT;MAJENE;SENDANA;LALATEDZONG;95;29;17;6;18;16;0;5;2;93;2;MEI
2720;SULAWESI BARAT;MAJENE;SENDANA;BINANGA;70;31;12;6;11;7;1;2;0;70;0;MEI
2721;SULAWESI BARAT;MAJENE;SENDANA;PUTTADA;76;42;22;0;9;1;1;1;0;76;0;MEI
2722;SULAWESI BARAT;MAJENE;SENDANA;PAMINGGALAN;39;29;10;0;0;0;0;0;0;39;0;MEI
2723;SULAWESI BARAT;MAJENE;SENDANA;LEPPANGANG;56;27;15;0;8;2;0;4;0;56;0;MEI
2724;SULAWESI BARAT;MAJENE;SENDANA;PUNDAU;65;6;27;5;22;3;0;2;0;65;0;MEI
2725;SULAWESI BARAT;MAJENE;SENDANA;SENDANA;76;39;22;1;0;6;1;7;0;76;0;MEI
2726;SULAWESI BARAT;MAJENE;SENDANA;BANUA SENDANA;104;63;11;4;1;20;0;5;0;104;0;MEI
2727;SULAWESI BARAT;MAJENE;SENDANA;TALLUBANUA UTARA;153;68;45;2;5;29;0;4;0;153;0;MEI
2728;SULAWESI BARAT;MAJENE;SENDANA;LIMBORO RAMBU-RAMBU;96;18;34;2;35;4;0;0;0;93;3;MEI
2729;SULAWESI BARAT;MAJENE;SENDANA;LIMBUA;89;35;18;1;20;12;0;3;0;89;0;MEI
2730;SULAWESI BARAT;MAJENE;SENDANA;BUKIT SAMANG;115;37;25;6;23;14;4;6;0;115;0;MEI
2731;SULAWESI BARAT;MAMUJU TENGAH;KAROSSA;KAROSSA;630;308;119;6;166;13;1;16;1;630;0;MEI
2732;SULAWESI BARAT;MAMUJU TENGAH;KAROSSA;TASOKKO;434;164;112;7;116;9;0;26;0;434;0;MEI
2733;SULAWESI BARAT;MAMUJU TENGAH;KAROSSA;LARA;121;37;14;2;60;4;1;3;0;121;0;MEI
2734;SULAWESI BARAT;MAMUJU TENGAH;KAROSSA;KADAILA;154;48;28;2;72;3;0;1;0;154;0;MEI
2735;SULAWESI BARAT;MAMUJU TENGAH;KAROSSA;KAYU CALLA;76;27;15;2;31;1;0;0;0;76;0;MEI
2736;SULAWESI BARAT;MAMUJU TENGAH;KAROSSA;LEMBAH HOPO;150;43;19;9;68;1;0;10;0;150;0;MEI
2737;SULAWESI BARAT;MAMUJU TENGAH;KAROSSA;BENGGAULU;270;123;67;1;61;9;0;8;0;269;1;MEI
2738;SULAWESI BARAT;MAMUJU TENGAH;KAROSSA;SUKA MAJU;101;37;35;1;22;2;0;1;0;98;3;MEI
2739;SULAWESI BARAT;MAMUJU TENGAH;KAROSSA;KAMBUNONG;286;150;67;2;47;7;0;12;0;285;1;MEI
2740;SULAWESI BARAT;MAMUJU TENGAH;KAROSSA;SALUBIRO;159;82;33;1;34;0;0;9;0;159;0;MEI
2741;SULAWESI BARAT;MAMUJU TENGAH;KAROSSA;SANJANGO;147;47;35;2;55;1;4;3;0;147;0;MEI
2742;SULAWESI BARAT;MAJENE;PAMBOANG;LALAMPANUA;158;31;31;27;44;11;0;12;1;157;1;MEI
2743;SULAWESI BARAT;MAJENE;PAMBOANG;SIRINDU;139;28;20;1;66;10;0;14;0;139;0;MEI
2744;SULAWESI BARAT;MAJENE;PAMBOANG;ADOLANG;104;23;6;3;63;4;0;5;0;104;0;MEI
2745;SULAWESI BARAT;MAJENE;PAMBOANG;BABABULO;192;99;27;9;44;5;1;7;0;192;0;MEI
2746;SULAWESI BARAT;MAJENE;PAMBOANG;BONDE;261;157;56;5;15;9;1;16;0;259;2;MEI
2747;SULAWESI BARAT;MAJENE;PAMBOANG;BETTENG;105;60;10;0;31;1;0;3;0;105;0;MEI
2748;SULAWESI BARAT;MAJENE;PAMBOANG;SIMBANG;64;17;12;7;19;3;1;5;0;64;0;MEI
2749;SULAWESI BARAT;MAJENE;PAMBOANG;BONDE UTARA;373;240;44;5;42;10;2;15;0;358;15;MEI
2750;SULAWESI BARAT;MAJENE;PAMBOANG;BABABULO UTARA;112;62;18;10;12;3;0;7;0;112;0;MEI
2751;SULAWESI BARAT;MAJENE;PAMBOANG;BUTTU PAMBOANG;110;51;21;3;24;5;0;6;0;110;0;MEI
2752;SULAWESI BARAT;MAJENE;PAMBOANG;BANUA ADOLANG;110;33;35;0;33;6;0;3;0;110;0;MEI
2753;SULAWESI BARAT;MAJENE;PAMBOANG;ADOLANG DHUA;106;40;9;2;43;0;1;9;0;104;2;MEI
2754;SULAWESI BARAT;MAJENE;PAMBOANG;TINAMBUNG;189;44;48;18;52;5;0;22;0;189;0;MEI
2755;SULAWESI BARAT;MAJENE;PAMBOANG;PESULOANG;117;38;15;13;37;1;3;10;0;117;0;MEI
2756;SULAWESI BARAT;MAJENE;PAMBOANG;BALOMBONG;117;34;15;2;56;7;0;3;0;117;0;MEI
2757;SULAWESI BARAT;PASANGKAYU;DAPURANG;DAPURANG;411;225;65;5;80;20;1;6;0;402;9;MEI
2758;SULAWESI BARAT;PASANGKAYU;DAPURANG;BENGGAULU;284;119;76;0;69;6;0;14;0;284;0;MEI
2759;SULAWESI BARAT;PASANGKAYU;DAPURANG;TIRTABUANA;147;87;15;2;36;2;0;5;0;147;0;MEI
2760;SULAWESI BARAT;PASANGKAYU;DAPURANG;BULU BONGGU;251;72;42;3;118;6;0;4;0;245;6;MEI
2761;SULAWESI BARAT;PASANGKAYU;DAPURANG;SARASA;192;111;50;1;20;6;0;4;0;192;0;MEI
2762;SULAWESI BARAT;MAJENE;TAMMERODO SENDANA;SEPPONG;141;77;36;4;12;6;0;5;1;141;0;MEI
2763;SULAWESI BARAT;MAJENE;TAMMERODO SENDANA;TAMMERODO;156;73;32;2;13;21;3;10;0;154;2;MEI
2764;SULAWESI BARAT;MAJENE;TAMMERODO SENDANA;ULIDANG;179;99;32;3;21;8;2;14;0;179;0;MEI
2765;SULAWESI BARAT;MAJENE;TAMMERODO SENDANA;TALLAMBALAO;194;104;58;3;6;3;1;19;0;194;0;MEI
2766;SULAWESI BARAT;MAJENE;TAMMERODO SENDANA;TAMMERODO UTARA;194;95;44;7;13;25;0;9;1;194;0;MEI
2767;SULAWESI BARAT;MAJENE;TAMMERODO SENDANA;MANYAMBA;174;111;29;0;24;5;0;4;0;173;1;MEI
2768;SULAWESI BARAT;MAJENE;TAMMERODO SENDANA;AWO;159;94;29;0;7;9;6;10;0;155;4;MEI
2769;SULAWESI BARAT;PASANGKAYU;DURIPOKU;TAMMARUNANG;215;82;47;15;53;6;0;12;0;215;0;MEI
2770;SULAWESI BARAT;PASANGKAYU;DURIPOKU;SAPTANAJAYA;204;113;39;1;37;10;0;4;0;204;0;MEI
2771;SULAWESI BARAT;PASANGKAYU;DURIPOKU;TARANGGI;92;16;22;5;39;9;0;1;0;92;0;MEI
2772;SULAWESI BARAT;PASANGKAYU;DURIPOKU;SIPAKAINGA;79;41;24;1;10;2;0;1;0;79;0;MEI
2773;SULAWESI BARAT;MAMASA;TABULAHAN;LAKAHANG;271;90;157;2;11;3;1;7;0;271;0;MEI
2774;SULAWESI BARAT;MAMASA;TABULAHAN;PERIANGAN;67;18;47;0;2;0;0;0;0;67;0;MEI
2775;SULAWESI BARAT;MAMASA;TABULAHAN;MALATIRO;142;54;81;0;2;0;0;2;0;139;3;MEI
2776;SULAWESI BARAT;MAMASA;TABULAHAN;TABULAHAN;58;18;36;0;1;1;0;2;0;58;0;MEI
2777;SULAWESI BARAT;MAMASA;TABULAHAN;SALULEANG;35;12;22;0;1;0;0;0;0;35;0;MEI
2778;SULAWESI BARAT;MAMASA;TABULAHAN;TAMPAK KURRA;178;51;120;1;4;0;1;1;0;178;0;MEI
2779;SULAWESI BARAT;MAMASA;TABULAHAN;GANDANG DEWATA;36;13;19;0;4;0;0;0;0;36;0;MEI
2780;SULAWESI BARAT;MAMASA;TABULAHAN;BURANA;99;26;67;0;4;0;1;1;0;99;0;MEI
2781;SULAWESI BARAT;MAMASA;TABULAHAN;SALUBAKKA;101;59;40;0;0;0;0;2;0;101;0;MEI
2782;SULAWESI BARAT;MAMASA;TABULAHAN;PANGANDARAN;136;45;87;0;4;0;0;0;0;136;0;MEI
2783;SULAWESI BARAT;MAMASA;TABULAHAN;TALOPAK;54;16;32;0;6;0;0;0;0;54;0;MEI
2784;SULAWESI BARAT;MAMASA;TABULAHAN;PEU';50;17;33;0;0;0;0;0;0;50;0;MEI
2785;SULAWESI BARAT;MAMASA;TABULAHAN;TIMORO;43;11;22;0;7;1;0;2;0;43;0;MEI
2786;SULAWESI BARAT;MAMASA;TABULAHAN;LAKAHANG UTAMA;77;27;44;0;2;0;0;3;0;76;1;MEI
2787;SULAWESI BARAT;MAMASA;TABANG;TABANG;87;32;24;1;9;20;0;1;0;87;0;MEI
2788;SULAWESI BARAT;MAMASA;TABANG;TADOKALUA;92;36;27;1;19;1;0;3;0;87;5;MEI
2789;SULAWESI BARAT;MAMASA;TABANG;TABANG BARAT;164;71;52;1;37;2;0;0;1;164;0;MEI
2790;SULAWESI BARAT;MAMASA;TABANG;MASUPU;79;12;63;0;3;0;0;0;1;79;0;MEI
2791;SULAWESI BARAT;MAMASA;TABANG;KALAMA;69;11;24;0;20;3;0;1;0;59;10;MEI
2792;SULAWESI BARAT;MAMASA;TABANG;BAKADISURA;100;23;61;0;14;1;0;1;0;100;0;MEI
2793;SULAWESI BARAT;MAMASA;TABANG;SALUKONA;98;43;46;0;8;1;0;0;0;98;0;MEI
2794;SULAWESI BARAT;MAJENE;ULUMANDA;KABIRAAN;143;92;18;1;27;1;0;4;0;143;0;MEI
2795;SULAWESI BARAT;MAJENE;ULUMANDA;SAMBABO;93;48;15;2;25;0;0;1;0;91;2;MEI
2796;SULAWESI BARAT;MAJENE;ULUMANDA;TANDEALLO;129;65;39;1;6;1;2;14;0;128;1;MEI
2797;SULAWESI BARAT;MAJENE;ULUMANDA;ULUMANDA;142;44;71;3;8;4;1;11;0;142;0;MEI
2798;SULAWESI BARAT;MAJENE;ULUMANDA;SALUTAMBUNG;113;77;22;1;10;0;0;3;0;113;0;MEI
2799;SULAWESI BARAT;MAJENE;ULUMANDA;POPENGA;78;60;15;0;0;0;0;3;0;78;0;MEI
2800;SULAWESI BARAT;MAJENE;ULUMANDA;SULAI;126;53;48;4;14;0;0;6;0;125;1;MEI
2801;SULAWESI BARAT;MAJENE;ULUMANDA;PANGGALO;102;50;35;4;8;2;0;1;0;100;2;MEI
2802;SULAWESI BARAT;POLEWALI MANDAR;ALLU;PETOOSANG;81;26;20;7;14;3;0;9;0;79;2;MEI
2803;SULAWESI BARAT;POLEWALI MANDAR;ALLU;MOMBI;134;60;26;6;31;0;4;5;1;133;1;MEI
2804;SULAWESI BARAT;POLEWALI MANDAR;ALLU;KALUMAMMANG;98;36;38;0;18;0;0;6;0;98;0;MEI
2805;SULAWESI BARAT;POLEWALI MANDAR;ALLU;PAO-PAO;195;75;56;0;62;0;0;2;0;195;0;MEI
2806;SULAWESI BARAT;POLEWALI MANDAR;ALLU;PUPPU URING;210;85;82;2;22;0;1;1;2;195;15;MEI
2807;SULAWESI BARAT;POLEWALI MANDAR;ALLU;SARAGIAN;134;73;25;6;21;0;0;8;0;133;1;MEI
2808;SULAWESI BARAT;POLEWALI MANDAR;ALLU;SAYOANG;49;22;18;0;6;1;0;2;0;49;0;MEI
2809;SULAWESI BARAT;POLEWALI MANDAR;ALLU;ALU;120;50;38;12;18;0;0;2;0;120;0;MEI
2810;SULAWESI BARAT;MAJENE;BANGGAE;BANGGAE;329;96;108;13;63;34;1;14;0;329;0;MEI
2811;SULAWESI BARAT;MAJENE;BANGGAE;BARU;521;146;140;10;187;12;0;26;0;521;0;MEI
2812;SULAWESI BARAT;MAJENE;BANGGAE;PANGALI ALI;835;304;216;12;207;59;2;32;0;832;3;MEI
2813;SULAWESI BARAT;MAJENE;BANGGAE;TOTOLI;450;154;108;15;142;12;1;18;0;450;0;MEI
2814;SULAWESI BARAT;MAJENE;BANGGAE;RANGAS;891;356;320;17;145;34;1;16;2;891;0;MEI
2815;SULAWESI BARAT;MAJENE;BANGGAE;GALUNG;257;52;17;30;89;29;0;38;0;255;2;MEI
2816;SULAWESI BARAT;MAJENE;BANGGAE;PALIPI SOREANG;238;106;41;18;56;11;0;6;0;238;0;MEI
2817;SULAWESI BARAT;MAJENE;BANGGAE;PAMBOBORANG;231;37;74;13;79;5;0;22;0;230;1;MEI
2818;SULAWESI BARAT;MAMUJU;TOMMO;TOMMO;351;133;75;1;126;6;0;10;0;351;0;MEI
2819;SULAWESI BARAT;MAMUJU;TOMMO;CAMPALOGA;295;84;123;12;65;7;0;0;0;291;4;MEI
2820;SULAWESI BARAT;MAMUJU;TOMMO;BUANA SAKTI;213;82;47;1;82;1;0;0;0;213;0;MEI
2821;SULAWESI BARAT;MAMUJU;TOMMO;TAMEMONGGA;229;81;110;0;33;2;0;3;0;229;0;MEI
2822;SULAWESI BARAT;MAMUJU;TOMMO;TAMEJARRA;198;68;55;5;51;7;1;11;0;198;0;MEI
2823;SULAWESI BARAT;MAMUJU;TOMMO;RANTEMARIO;162;66;64;3;18;6;0;5;0;162;0;MEI
2824;SULAWESI BARAT;MAMUJU;TOMMO;MALINO;74;41;19;6;4;1;0;2;0;73;1;MEI
2825;SULAWESI BARAT;MAMUJU;TOMMO;KAKULLASANG;366;152;140;7;53;1;0;6;2;361;5;MEI
2826;SULAWESI BARAT;MAMUJU;TOMMO;LELING;131;36;65;0;28;0;0;2;0;131;0;MEI
2827;SULAWESI BARAT;MAMUJU;TOMMO;KALEPU;110;48;56;1;4;1;0;0;0;110;0;MEI
2828;SULAWESI BARAT;MAMUJU;TOMMO;SANDANA;130;50;49;1;18;2;0;9;1;130;0;MEI
2829;SULAWESI BARAT;MAMUJU;TOMMO;LELING BARAT;205;64;83;1;47;6;0;3;0;204;1;MEI
2830;SULAWESI BARAT;MAMUJU;TOMMO;LELING UTARA;191;78;90;0;23;0;0;0;0;191;0;MEI
2831;SULAWESI BARAT;MAMUJU;TOMMO;SALUDENGEN;132;67;58;0;6;0;0;1;0;132;0;MEI
2832;SULAWESI BARAT;POLEWALI MANDAR;WONOMULYO;SIDODADI;391;198;87;3;57;29;0;14;1;389;2;MEI
2833;SULAWESI BARAT;POLEWALI MANDAR;WONOMULYO;SIDOREJO;274;153;56;10;23;14;0;16;0;272;2;MEI
2834;SULAWESI BARAT;POLEWALI MANDAR;WONOMULYO;SUMBEREJO;479;231;82;26;96;31;0;6;1;473;6;MEI
2835;SULAWESI BARAT;POLEWALI MANDAR;WONOMULYO;BUMIAYU;406;184;73;9;49;52;0;17;0;384;22;MEI
2836;SULAWESI BARAT;POLEWALI MANDAR;WONOMULYO;KEBUNSARI;297;120;57;11;37;42;1;13;0;281;16;MEI
2837;SULAWESI BARAT;POLEWALI MANDAR;WONOMULYO;BANUA BARU;183;98;28;7;19;15;0;8;0;175;8;MEI
2838;SULAWESI BARAT;POLEWALI MANDAR;WONOMULYO;NEPO;252;150;48;1;36;9;1;4;0;249;3;MEI
2839;SULAWESI BARAT;POLEWALI MANDAR;WONOMULYO;SUGIHWARAS;535;255;128;17;80;31;0;12;0;523;12;MEI
2840;SULAWESI BARAT;POLEWALI MANDAR;WONOMULYO;CAMPURJO;242;113;44;6;39;19;0;20;0;241;1;MEI
2841;SULAWESI BARAT;POLEWALI MANDAR;WONOMULYO;BUMIMULYO;200;105;51;0;31;9;0;2;0;198;2;MEI
2842;SULAWESI BARAT;POLEWALI MANDAR;WONOMULYO;TUMPILING;224;116;52;2;31;3;0;8;0;212;12;MEI
2843;SULAWESI BARAT;POLEWALI MANDAR;WONOMULYO;BAKKA-BAKKA;186;103;35;3;28;6;0;6;0;181;5;MEI
2844;SULAWESI BARAT;POLEWALI MANDAR;WONOMULYO;ARJO SARI;279;149;81;6;12;18;0;7;0;273;6;MEI
2845;SULAWESI BARAT;POLEWALI MANDAR;WONOMULYO;GALESON;232;155;30;3;27;5;0;7;0;227;5;MEI
2846;SULAWESI BARAT;MAMASA;MAMASA;MAMASA;368;60;45;3;179;61;0;20;0;368;0;MEI
2847;SULAWESI BARAT;MAMASA;MAMASA;RAMBUSARATU;254;89;81;14;53;11;0;6;0;254;0;MEI
2848;SULAWESI BARAT;MAMASA;MAMASA;OSANGO;476;90;78;13;189;87;0;14;1;472;4;MEI
2849;SULAWESI BARAT;MAMASA;MAMASA;LAMBANAN;224;68;53;9;78;7;0;9;0;224;0;MEI
2850;SULAWESI BARAT;MAMASA;MAMASA;LEMBANA SALULO;90;18;15;2;44;5;0;6;0;90;0;MEI
2851;SULAWESI BARAT;MAMASA;MAMASA;TAUPE;233;53;27;9;140;1;1;2;0;233;0;MEI
2852;SULAWESI BARAT;MAMASA;MAMASA;BUNTU BUDA;297;75;33;9;104;26;0;5;1;253;44;MEI
2853;SULAWESI BARAT;MAMASA;MAMASA;TONDOK BAKARU;266;85;84;16;62;10;0;8;0;265;1;MEI
2854;SULAWESI BARAT;MAMASA;MAMASA;PEBASSIAN;94;26;23;2;39;2;0;2;0;94;0;MEI
2855;SULAWESI BARAT;MAMASA;MAMASA;MAMBULILING;118;56;20;2;36;3;0;1;0;118;0;MEI
2856;SULAWESI BARAT;MAMASA;MAMASA;BOMBONG LAMBE;152;45;21;3;68;14;0;1;0;152;0;MEI
2857;SULAWESI BARAT;MAMASA;MAMASA;BUBUN BATU;129;26;8;6;77;2;0;2;0;121;8;MEI
2858;SULAWESI BARAT;POLEWALI MANDAR;CAMPALAGIAN;PAPPANG;150;83;13;12;8;6;0;13;1;136;14;MEI
2859;SULAWESI BARAT;POLEWALI MANDAR;CAMPALAGIAN;LALIKO;182;110;44;3;6;3;0;16;0;182;0;MEI
2860;SULAWESI BARAT;POLEWALI MANDAR;CAMPALAGIAN;BONDE;170;95;35;5;13;10;0;12;0;170;0;MEI
2861;SULAWESI BARAT;POLEWALI MANDAR;CAMPALAGIAN;KATUMBANGAN LEMO;156;84;37;13;15;5;0;2;0;156;0;MEI
2862;SULAWESI BARAT;POLEWALI MANDAR;CAMPALAGIAN;PANYAMPA;217;126;58;5;11;3;0;11;2;216;1;MEI
2863;SULAWESI BARAT;POLEWALI MANDAR;CAMPALAGIAN;SURUANG;159;84;42;12;8;1;0;7;0;154;5;MEI
2864;SULAWESI BARAT;POLEWALI MANDAR;CAMPALAGIAN;LAMPOKO;243;146;71;10;8;2;0;6;0;243;0;MEI
2865;SULAWESI BARAT;POLEWALI MANDAR;CAMPALAGIAN;KATUMBANGAN;279;120;38;4;65;39;0;13;0;279;0;MEI
2866;SULAWESI BARAT;POLEWALI MANDAR;CAMPALAGIAN;LAPEO;133;72;26;7;13;3;0;11;0;132;1;MEI
2867;SULAWESI BARAT;POLEWALI MANDAR;CAMPALAGIAN;PARAPPE;262;154;63;4;34;3;0;2;0;260;2;MEI
2868;SULAWESI BARAT;POLEWALI MANDAR;CAMPALAGIAN;ONGKO;93;27;13;9;34;6;0;4;0;93;0;MEI
2869;SULAWESI BARAT;POLEWALI MANDAR;CAMPALAGIAN;KENJE;150;105;11;7;18;3;0;6;0;150;0;MEI
2870;SULAWESI BARAT;POLEWALI MANDAR;CAMPALAGIAN;SUMARRANG;453;251;133;5;58;6;0;0;0;453;0;MEI
2871;SULAWESI BARAT;POLEWALI MANDAR;CAMPALAGIAN;BOTTO;244;117;59;0;56;3;0;7;0;242;2;MEI
2872;SULAWESI BARAT;POLEWALI MANDAR;CAMPALAGIAN;GATTUNGAN;161;49;21;18;47;16;0;9;0;160;1;MEI
2873;SULAWESI BARAT;POLEWALI MANDAR;CAMPALAGIAN;PADANG TIMUR;137;64;26;3;37;2;0;5;0;137;0;MEI
2874;SULAWESI BARAT;POLEWALI MANDAR;CAMPALAGIAN;PADANG;75;43;11;4;12;0;0;0;0;70;5;MEI
2875;SULAWESI BARAT;POLEWALI MANDAR;CAMPALAGIAN;LAGI-AGI;227;165;31;2;17;2;0;10;0;227;0;MEI
2876;SULAWESI BARAT;MAMUJU;PAPALANG;TOABO;659;287;151;4;202;8;0;5;1;658;1;MEI
2877;SULAWESI BARAT;MAMUJU;PAPALANG;PAPALANG;690;327;174;7;138;3;0;5;0;654;36;MEI
2878;SULAWESI BARAT;MAMUJU;PAPALANG;BONDA;316;174;89;2;48;1;0;1;0;315;1;MEI
2879;SULAWESI BARAT;MAMUJU;PAPALANG;TOPORE;202;108;43;7;35;1;0;2;0;196;6;MEI
2880;SULAWESI BARAT;MAMUJU;PAPALANG;SALUKAYU;256;128;87;0;33;2;0;6;0;256;0;MEI
2881;SULAWESI BARAT;MAMUJU;PAPALANG;SUKADAMAI;109;54;37;1;13;0;0;4;0;109;0;MEI
2882;SULAWESI BARAT;MAMUJU;PAPALANG;BODA-BODA;180;99;59;1;19;0;0;1;0;179;1;MEI
2883;SULAWESI BARAT;MAMUJU;PAPALANG;SISANGO;107;33;62;0;7;3;0;1;0;106;1;MEI
2884;SULAWESI BARAT;MAMUJU;PAPALANG;BATU AMPA;170;53;90;9;18;0;0;0;0;170;0;MEI
2885;SULAWESI BARAT;MAMASA;ARALLE;ARALLE;107;41;53;2;7;1;0;3;0;107;0;MEI
2886;SULAWESI BARAT;MAMASA;ARALLE;RALLE ANAK;30;6;18;0;4;0;0;2;0;30;0;MEI
2887;SULAWESI BARAT;MAMASA;ARALLE;PANETEAN;68;50;17;1;0;0;0;0;0;68;0;MEI
2888;SULAWESI BARAT;MAMASA;ARALLE;UHAILANU;68;20;28;0;11;3;0;5;0;67;1;MEI
2889;SULAWESI BARAT;MAMASA;ARALLE;ARALLE UTARA;67;27;37;0;3;0;0;0;0;67;0;MEI
2890;SULAWESI BARAT;MAMASA;ARALLE;UHAIDAHO;54;8;37;3;6;0;0;0;0;54;0;MEI
2891;SULAWESI BARAT;MAMASA;ARALLE;BARURU;90;63;25;0;1;0;0;0;1;90;0;MEI
2892;SULAWESI BARAT;MAMASA;ARALLE;RALLEANAK UTARA;40;18;18;0;3;0;0;1;0;40;0;MEI
2893;SULAWESI BARAT;MAMASA;ARALLE;PAMOSEANG PANGGA;36;14;19;2;1;0;0;0;0;36;0;MEI
2894;SULAWESI BARAT;MAMASA;ARALLE;KALABE;63;22;39;0;2;0;0;0;0;63;0;MEI
2895;SULAWESI BARAT;MAMASA;ARALLE;ARALLE SELATAN;31;10;18;0;2;0;0;1;0;31;0;MEI
2896;SULAWESI BARAT;MAMASA;ARALLE;HAHANGAN;36;16;14;0;6;0;0;0;0;36;0;MEI
2897;SULAWESI BARAT;MAMASA;BALLA;BALLA;168;25;29;1;87;13;0;11;1;167;1;MEI
2898;SULAWESI BARAT;MAMASA;BALLA;BALLA BARAT;89;40;15;0;33;0;0;1;0;89;0;MEI
2899;SULAWESI BARAT;MAMASA;BALLA;BALLA SATANETEAN;147;59;12;3;61;8;0;3;0;146;1;MEI
2900;SULAWESI BARAT;MAMASA;BALLA;BALLA TUMUKA;113;38;34;0;39;1;0;1;0;113;0;MEI
2901;SULAWESI BARAT;MAMASA;BALLA;SEPAKUAN;157;54;14;1;85;1;0;2;0;157;0;MEI
2902;SULAWESI BARAT;MAMASA;BALLA;PIDARA;65;25;9;0;29;1;0;1;0;65;0;MEI
2903;SULAWESI BARAT;MAMASA;BALLA;BAMBAPUANG;63;30;13;0;20;0;0;0;0;63;0;MEI
2904;SULAWESI BARAT;MAMASA;BALLA;BALLA TIMUR;36;8;2;0;23;1;0;2;0;36;0;MEI
2905;SULAWESI BARAT;POLEWALI MANDAR;LIMBORO;LIMBORO;122;37;28;15;20;3;0;9;0;112;10;MEI
2906;SULAWESI BARAT;POLEWALI MANDAR;LIMBORO;LEMBANG LEMBANG;221;94;45;31;34;5;0;12;0;221;0;MEI
2907;SULAWESI BARAT;POLEWALI MANDAR;LIMBORO;TANDASURA;136;70;18;10;25;3;0;8;0;134;2;MEI
2908;SULAWESI BARAT;POLEWALI MANDAR;LIMBORO;SAMASUNDU;141;47;47;9;25;6;0;7;0;141;0;MEI
2909;SULAWESI BARAT;POLEWALI MANDAR;LIMBORO;NAPO;154;83;18;3;41;0;0;9;0;154;0;MEI
2910;SULAWESI BARAT;POLEWALI MANDAR;LIMBORO;TODANG TODANG;37;16;15;4;2;0;0;0;0;37;0;MEI
2911;SULAWESI BARAT;POLEWALI MANDAR;LIMBORO;PENDULANGAN;57;34;19;0;1;0;0;3;0;57;0;MEI
2912;SULAWESI BARAT;POLEWALI MANDAR;LIMBORO;RENGGEANG;103;34;31;5;29;0;0;4;0;103;0;MEI
2913;SULAWESI BARAT;POLEWALI MANDAR;LIMBORO;SALARRI;54;22;15;5;11;0;0;1;0;54;0;MEI
2914;SULAWESI BARAT;POLEWALI MANDAR;LIMBORO;TANGAN BARU;80;30;10;1;34;0;0;5;0;80;0;MEI
2915;SULAWESI BARAT;POLEWALI MANDAR;LIMBORO;PALECE;117;28;44;27;12;4;0;2;0;117;0;MEI
2916;SULAWESI BARAT;MAMASA;BUNTUMALANGKA;BUNTUMALANGKA;132;26;69;2;25;4;0;5;0;131;1;MEI
2917;SULAWESI BARAT;MAMASA;BUNTUMALANGKA;RANTEBERAN;123;58;59;0;5;0;0;1;0;123;0;MEI
2918;SULAWESI BARAT;MAMASA;BUNTUMALANGKA;KEBANGA;54;10;28;0;15;0;0;0;1;54;0;MEI
2919;SULAWESI BARAT;MAMASA;BUNTUMALANGKA;SALURINDU;54;27;17;1;7;0;0;2;0;54;0;MEI
2920;SULAWESI BARAT;MAMASA;BUNTUMALANGKA;TAORA;49;12;33;0;2;0;0;2;0;49;0;MEI
2921;SULAWESI BARAT;MAMASA;BUNTUMALANGKA;KABAE;79;10;64;0;4;0;0;1;0;79;0;MEI
2922;SULAWESI BARAT;MAMASA;BUNTUMALANGKA;SALUTAMBUN BARAT;65;26;37;1;1;0;0;0;0;65;0;MEI
2923;SULAWESI BARAT;MAMASA;BUNTUMALANGKA;PENATANGAN;122;46;47;0;20;2;1;1;1;118;4;MEI
2924;SULAWESI BARAT;MAMASA;BUNTUMALANGKA;SALUTAMBUN TIMUR;48;16;30;0;1;0;0;1;0;48;0;MEI
2925;SULAWESI BARAT;MAMASA;BUNTUMALANGKA;SALUTAMBUN;37;9;22;0;2;2;0;2;0;37;0;MEI
2926;SULAWESI BARAT;MAMASA;BUNTUMALANGKA;ARALLE TIMUR;104;28;66;0;3;0;0;1;0;98;6;MEI
2927;SULAWESI BARAT;PASANGKAYU;TIKKE RAYA;TIKKE;324;97;61;4;100;41;0;12;0;315;9;MEI
2928;SULAWESI BARAT;PASANGKAYU;TIKKE RAYA;MAKMUR JAYA;487;189;119;4;126;26;0;19;1;484;3;MEI
2929;SULAWESI BARAT;PASANGKAYU;TIKKE RAYA;LARIANG;457;175;88;3;161;17;0;10;0;454;3;MEI
2930;SULAWESI BARAT;PASANGKAYU;TIKKE RAYA;PAJALELE;400;170;78;1;108;24;1;15;1;398;2;MEI
2931;SULAWESI BARAT;PASANGKAYU;TIKKE RAYA;JENGENG RAYA;235;82;52;5;68;21;0;7;0;235;0;MEI
2932;SULAWESI BARAT;MAMASA;BAMBANG;MOKALLANG;41;19;17;0;4;0;0;1;0;41;0;MEI
2933;SULAWESI BARAT;MAMASA;BAMBANG;MASOSO;45;19;13;0;13;0;0;0;0;45;0;MEI
2934;SULAWESI BARAT;MAMASA;BAMBANG;SALUASSING;125;91;22;3;8;0;0;1;0;125;0;MEI
2935;SULAWESI BARAT;MAMASA;BAMBANG;SALUBULO;60;26;15;0;14;1;0;0;0;56;4;MEI
2936;SULAWESI BARAT;MAMASA;BAMBANG;SALUKADI;77;34;34;0;9;0;0;0;0;77;0;MEI
2937;SULAWESI BARAT;MAMASA;BAMBANG;SALUKEPOPOK;112;61;17;7;25;1;0;0;0;111;1;MEI
2938;SULAWESI BARAT;MAMASA;BAMBANG;ULUMAMBI BARAT;63;28;35;0;0;0;0;0;0;63;0;MEI
2939;SULAWESI BARAT;MAMASA;BAMBANG;LIMBADEBATA;107;35;11;0;57;1;0;3;0;107;0;MEI
2940;SULAWESI BARAT;MAMASA;BAMBANG;TANETE TOMBA;56;27;26;0;3;0;0;0;0;56;0;MEI
2941;SULAWESI BARAT;MAMASA;BAMBANG;BAMBANG;134;84;18;0;25;3;0;3;0;133;1;MEI
2942;SULAWESI BARAT;MAMASA;BAMBANG;RANTELEMO;53;11;24;0;16;2;0;0;0;53;0;MEI
2943;SULAWESI BARAT;MAMASA;BAMBANG;SALUDENGEN;39;7;26;0;2;1;0;0;0;36;3;MEI
2944;SULAWESI BARAT;MAMASA;BAMBANG;ULUMAMBI;61;9;44;1;0;0;0;0;0;54;7;MEI
2945;SULAWESI BARAT;MAMASA;BAMBANG;BAMBANG TIMUR;72;46;22;0;2;1;0;1;0;72;0;MEI
2946;SULAWESI BARAT;MAMASA;BAMBANG;MINANGA;135;42;50;0;38;1;0;4;0;135;0;MEI
2947;SULAWESI BARAT;MAMASA;BAMBANG;SIKAMASE;56;17;38;0;1;0;0;0;0;56;0;MEI
2948;SULAWESI BARAT;MAMASA;BAMBANG;RANTETARIMA;32;4;28;0;0;0;0;0;0;32;0;MEI
2949;SULAWESI BARAT;MAMASA;BAMBANG;SALURURU;30;3;1;3;22;0;0;1;0;30;0;MEI
2950;SULAWESI BARAT;MAMASA;BAMBANG;SALUTABANG;35;19;11;1;1;2;0;1;0;35;0;MEI
2951;SULAWESI BARAT;MAMASA;BAMBANG;BALATANA;52;32;20;0;0;0;0;0;0;52;0;MEI
2952;SULAWESI BARAT;MAMASA;MAMBI;MAMBI;78;44;22;2;9;1;0;0;0;78;0;MEI
2953;SULAWESI BARAT;MAMASA;MAMBI;TALIPUKKI;122;92;11;3;10;2;0;3;0;121;1;MEI
2954;SULAWESI BARAT;MAMASA;MAMBI;RANTEBULAHAN;57;17;30;0;7;1;0;1;0;56;1;MEI
2955;SULAWESI BARAT;MAMASA;MAMBI;SONDONGLAYU;36;16;5;3;7;0;0;5;0;36;0;MEI
2956;SULAWESI BARAT;MAMASA;MAMBI;SALUBANUA;37;15;19;0;2;0;0;0;0;36;1;MEI
2957;SULAWESI BARAT;MAMASA;MAMBI;TAPALINA;110;72;31;6;0;0;0;0;0;109;1;MEI
2958;SULAWESI BARAT;MAMASA;MAMBI;SENDANA;153;63;71;3;16;0;0;0;0;153;0;MEI
2959;SULAWESI BARAT;MAMASA;MAMBI;PAMOSEAN;50;40;9;1;0;0;0;0;0;50;0;MEI
2960;SULAWESI BARAT;MAMASA;MAMBI;SELUMAKA;125;33;92;0;0;0;0;0;0;125;0;MEI
2961;SULAWESI BARAT;MAMASA;MAMBI;BUJUNG MANURUNG;43;22;17;1;2;1;0;0;0;43;0;MEI
2962;SULAWESI BARAT;MAMASA;MAMBI;SALU ALO;84;26;51;0;7;0;0;0;0;84;0;MEI
2963;SULAWESI BARAT;MAMASA;MAMBI;INDOBANUA;27;10;10;0;1;6;0;0;0;27;0;MEI
2964;SULAWESI BARAT;MAMASA;MAMBI;SALUDURIAN;91;29;52;0;8;1;0;1;0;91;0;MEI
2965;SULAWESI BARAT;POLEWALI MANDAR;BULO;BULO;103;16;9;2;74;2;0;0;0;103;0;MEI
2966;SULAWESI BARAT;POLEWALI MANDAR;BULO;PULLIWA;308;101;51;3;139;3;0;10;0;307;1;MEI
2967;SULAWESI BARAT;POLEWALI MANDAR;BULO;PATAMBANUA;145;26;109;0;7;0;0;1;0;143;2;MEI
2968;SULAWESI BARAT;POLEWALI MANDAR;BULO;KAROMBANG;139;80;22;0;34;2;0;1;0;139;0;MEI
2969;SULAWESI BARAT;POLEWALI MANDAR;BULO;DAALA TIMUR;126;42;59;2;22;0;0;1;0;126;0;MEI
2970;SULAWESI BARAT;POLEWALI MANDAR;BULO;LENGGO;49;16;29;1;2;1;0;0;0;49;0;MEI
2971;SULAWESI BARAT;POLEWALI MANDAR;BULO;SABURA;70;28;32;0;9;0;0;1;0;70;0;MEI
2972;SULAWESI BARAT;POLEWALI MANDAR;BULO;SEPPORRAKI;102;28;26;0;46;0;0;2;0;102;0;MEI
2973;SULAWESI BARAT;POLEWALI MANDAR;BULO;IHING;110;23;23;2;57;1;0;1;0;107;3;MEI
2974;SULAWESI BARAT;POLEWALI MANDAR;BINUANG;AMASSANGAN;307;145;56;2;70;2;0;32;0;307;0;MEI
2975;SULAWESI BARAT;POLEWALI MANDAR;BINUANG;TONYAMAN;496;202;156;5;91;12;0;13;1;480;16;MEI
2976;SULAWESI BARAT;POLEWALI MANDAR;BINUANG;KUAJANG;388;183;74;12;103;4;1;11;0;388;0;MEI
2977;SULAWESI BARAT;POLEWALI MANDAR;BINUANG;PAKU;157;79;38;9;19;0;1;10;1;157;0;MEI
2978;SULAWESI BARAT;POLEWALI MANDAR;BINUANG;MIRRING;224;116;42;5;39;1;0;18;0;221;3;MEI
2979;SULAWESI BARAT;POLEWALI MANDAR;BINUANG;BATETANGNGA;688;400;142;10;82;8;0;15;2;659;29;MEI
2980;SULAWESI BARAT;POLEWALI MANDAR;BINUANG;MAMMI;258;88;66;9;82;3;0;9;0;257;1;MEI
2981;SULAWESI BARAT;POLEWALI MANDAR;BINUANG;KALEOK;144;47;64;2;26;0;0;5;0;144;0;MEI
2982;SULAWESI BARAT;POLEWALI MANDAR;BINUANG;AMOLA;150;87;22;2;36;0;1;2;0;150;0;MEI
2983;SULAWESI BARAT;POLEWALI MANDAR;BINUANG;REA;240;99;75;9;30;1;2;18;0;234;6;MEI
2984;SULAWESI BARAT;MAMUJU;TAPALANG BARAT;DUNGKAIT;244;99;97;5;35;3;1;2;0;242;2;MEI
2985;SULAWESI BARAT;MAMUJU;TAPALANG BARAT;LEBANI;116;37;55;0;7;0;0;4;2;105;11;MEI
2986;SULAWESI BARAT;MAMUJU;TAPALANG BARAT;LABUANG RANO;230;121;83;0;10;4;0;2;0;220;10;MEI
2987;SULAWESI BARAT;MAMUJU;TAPALANG BARAT;PASABU;167;46;69;7;19;8;0;13;2;164;3;MEI
2988;SULAWESI BARAT;MAMUJU;TAPALANG BARAT;TANETE PAO;44;31;10;0;2;0;0;0;0;43;1;MEI
2989;SULAWESI BARAT;MAMUJU;TAPALANG BARAT;PANGASAAN;57;24;19;2;6;5;0;0;0;56;1;MEI
2990;SULAWESI BARAT;MAMUJU;TAPALANG BARAT;AHU;172;90;63;2;7;0;0;2;0;164;8;MEI
2991;SULAWESI BARAT;MAMUJU;SIMBORO;SIMBORO;1555;617;188;71;167;247;1;68;5;1364;191;MEI
2992;SULAWESI BARAT;MAMUJU;SIMBORO;RANGAS;552;170;150;18;121;19;3;11;0;492;60;MEI
2993;SULAWESI BARAT;MAMUJU;SIMBORO;BOTTENG;197;115;44;1;22;2;0;12;0;196;1;MEI
2994;SULAWESI BARAT;MAMUJU;SIMBORO;SALETTO;292;133;81;5;45;5;1;22;0;292;0;MEI
2995;SULAWESI BARAT;MAMUJU;SIMBORO;SUMARE;221;104;80;2;25;10;0;0;0;221;0;MEI
2996;SULAWESI BARAT;MAMUJU;SIMBORO;BOTTENG UTARA;359;147;91;1;98;5;1;0;0;343;16;MEI
2997;SULAWESI BARAT;MAMUJU;SIMBORO;TAPANDULLU;44;28;1;0;11;0;2;2;0;44;0;MEI
2998;SULAWESI BARAT;MAMUJU;SIMBORO;PATI'DI;188;107;41;1;35;1;0;3;0;188;0;MEI
2999;SULAWESI BARAT;MAMUJU;MAMUJU;BINANGA;786;456;163;16;69;52;1;17;3;777;9;MEI
3000;SULAWESI BARAT;MAMUJU;MAMUJU;MAMUNYU;603;309;163;39;47;26;1;14;0;599;4;MEI
3001;SULAWESI BARAT;MAMUJU;MAMUJU;KAREMA;867;453;124;40;98;62;2;32;0;811;56;MEI
3002;SULAWESI BARAT;MAMUJU;MAMUJU;RIMUKU;701;306;153;34;52;76;2;32;1;656;45;MEI
3003;SULAWESI BARAT;MAMUJU;MAMUJU;BAMBU;367;213;74;15;45;4;0;16;0;367;0;MEI
3004;SULAWESI BARAT;MAMUJU;MAMUJU;KARAMPUANG;483;352;70;3;31;10;0;14;0;480;3;MEI
3005;SULAWESI BARAT;MAMUJU;MAMUJU;TADUI;498;169;212;1;59;8;0;28;3;480;18;MEI
3006;SULAWESI BARAT;MAMUJU;MAMUJU;BATU PANNU;183;130;34;0;12;3;0;4;0;183;0;MEI
3007;SULAWESI BARAT;MAMUJU;KALUKKU;SINYONYOI;452;235;132;10;47;5;0;11;0;440;12;MEI
3008;SULAWESI BARAT;MAMUJU;KALUKKU;BEBANGA;755;451;201;4;65;6;2;23;0;752;3;MEI
3009;SULAWESI BARAT;MAMUJU;KALUKKU;KALUKKU;689;243;186;8;180;23;1;28;0;669;20;MEI
3010;SULAWESI BARAT;MAMUJU;KALUKKU;SINYONYOI SELATAN;270;128;74;5;31;3;0;23;0;264;6;MEI
3011;SULAWESI BARAT;MAMUJU;KALUKKU;SONDOANG;270;116;83;1;63;1;0;4;1;269;1;MEI
3012;SULAWESI BARAT;MAMUJU;KALUKKU;BERU-BERU;557;320;91;2;130;3;0;10;1;557;0;MEI
3013;SULAWESI BARAT;MAMUJU;KALUKKU;BELANG BELANG;393;175;122;3;78;3;0;12;0;393;0;MEI
3014;SULAWESI BARAT;MAMUJU;KALUKKU;KABULOANG;358;137;130;3;71;1;1;10;1;354;4;MEI
3015;SULAWESI BARAT;MAMUJU;KALUKKU;KEANG;233;69;129;1;28;1;0;4;0;232;1;MEI
3016;SULAWESI BARAT;MAMUJU;KALUKKU;POKKANG;207;89;42;2;62;3;1;8;0;207;0;MEI
3017;SULAWESI BARAT;MAMUJU;KALUKKU;GULILING;147;43;62;0;37;0;0;2;2;146;1;MEI
3018;SULAWESI BARAT;MAMUJU;KALUKKU;UHAIMATE;121;78;35;1;7;0;0;0;0;121;0;MEI
3019;SULAWESI BARAT;MAMUJU;KALUKKU;KALUKKU BARAT;475;281;65;1;122;2;0;4;0;475;0;MEI
3020;SULAWESI BARAT;MAMUJU;KALUKKU;PAMMULUKANG;230;115;76;7;18;0;0;12;1;229;1;MEI
3021;SULAWESI BARAT;MAMUJU;BONEHAU;BONEHAU;160;42;79;4;23;2;0;4;0;154;6;MEI
3022;SULAWESI BARAT;MAMUJU;BONEHAU;SALUTIWO;90;32;38;1;19;0;0;0;0;90;0;MEI
3023;SULAWESI BARAT;MAMUJU;BONEHAU;BUTTUADA;206;9;170;3;19;1;0;2;0;204;2;MEI
3024;SULAWESI BARAT;MAMUJU;BONEHAU;TAMALEA;47;4;34;0;8;0;0;1;0;47;0;MEI
3025;SULAWESI BARAT;MAMUJU;BONEHAU;LUMIKA;129;39;55;2;32;1;0;0;0;129;0;MEI
3026;SULAWESI BARAT;MAMUJU;BONEHAU;MAPPU;72;15;42;0;14;0;0;1;0;72;0;MEI
3027;SULAWESI BARAT;MAMUJU;BONEHAU;BANUADA;97;11;79;3;3;0;0;1;0;97;0;MEI
3028;SULAWESI BARAT;MAMUJU;BONEHAU;HINUA;100;26;26;7;34;1;0;3;1;98;2;MEI
3029;SULAWESI BARAT;MAMUJU;BONEHAU;KINATANG;106;19;83;2;0;0;0;2;0;106;0;MEI
3030;SULAWESI BARAT;POLEWALI MANDAR;TUTAR;TARAMANU;200;93;36;6;42;1;12;10;0;200;0;MEI
3031;SULAWESI BARAT;POLEWALI MANDAR;TUTAR;AMBOPADANG;270;105;56;1;104;2;0;2;0;270;0;MEI
3032;SULAWESI BARAT;POLEWALI MANDAR;TUTAR;TUBBI;130;39;69;4;7;3;0;8;0;130;0;MEI
3033;SULAWESI BARAT;POLEWALI MANDAR;TUTAR;RATTE;183;73;66;2;39;1;1;0;1;183;0;MEI
3034;SULAWESI BARAT;POLEWALI MANDAR;TUTAR;BESOANGIN;122;66;8;3;45;0;0;0;0;122;0;MEI
3035;SULAWESI BARAT;POLEWALI MANDAR;TUTAR;PIRIANG TAPIKO;112;32;58;0;20;0;0;2;0;112;0;MEI
3036;SULAWESI BARAT;POLEWALI MANDAR;TUTAR;PEBURRU;190;108;46;2;27;2;0;5;0;190;0;MEI
3037;SULAWESI BARAT;POLEWALI MANDAR;TUTAR;TALOBA;95;36;39;0;16;0;0;3;0;94;1;MEI
3038;SULAWESI BARAT;POLEWALI MANDAR;TUTAR;POLLEWANI;262;134;90;2;33;0;0;3;0;262;0;MEI
3039;SULAWESI BARAT;POLEWALI MANDAR;TUTAR;ARABUA;149;84;35;0;12;0;15;3;0;149;0;MEI
3040;SULAWESI BARAT;POLEWALI MANDAR;TUTAR;BESOANGIN UTARA;105;57;17;3;27;0;0;1;0;105;0;MEI
3041;SULAWESI BARAT;POLEWALI MANDAR;TUTAR;PODA;117;51;46;4;12;0;1;3;0;117;0;MEI
3042;SULAWESI BARAT;POLEWALI MANDAR;TUTAR;TARAMANU TUA;169;31;54;2;72;3;0;4;0;166;3;MEI
3043;SULAWESI BARAT;POLEWALI MANDAR;TINAMBUNG;TINAMBUNG;127;41;27;5;24;4;0;26;0;127;0;MEI
3044;SULAWESI BARAT;POLEWALI MANDAR;TINAMBUNG;KARAMA;462;336;46;19;43;2;0;16;0;462;0;MEI
3045;SULAWESI BARAT;POLEWALI MANDAR;TINAMBUNG;TANGNGA TANGNGA;205;148;33;2;13;1;0;8;0;205;0;MEI
3046;SULAWESI BARAT;POLEWALI MANDAR;TINAMBUNG;LEKOPADIS;87;32;16;5;26;1;0;6;0;86;1;MEI
3047;SULAWESI BARAT;POLEWALI MANDAR;TINAMBUNG;GALUNG LOMBOK;134;54;18;17;29;3;0;13;0;134;0;MEI
3048;SULAWESI BARAT;POLEWALI MANDAR;TINAMBUNG;TANDUNG;119;56;23;7;18;4;0;10;0;118;1;MEI
3049;SULAWESI BARAT;POLEWALI MANDAR;TINAMBUNG;BATULAYA;119;47;25;17;16;4;0;10;0;119;0;MEI
3050;SULAWESI BARAT;POLEWALI MANDAR;TINAMBUNG;SEPABATU;100;35;25;9;16;2;0;13;0;100;0;MEI
3051;SULAWESI BARAT;MAMUJU;SAMPAGA;BUNDE;512;254;127;3;122;1;0;5;0;512;0;MEI
3052;SULAWESI BARAT;MAMUJU;SAMPAGA;KALONDING;451;178;181;9;75;4;0;3;0;450;1;MEI
3053;SULAWESI BARAT;MAMUJU;SAMPAGA;TARAILU;261;121;80;0;48;5;0;7;0;261;0;MEI
3054;SULAWESI BARAT;MAMUJU;SAMPAGA;SAMPAGA;186;90;65;2;25;1;0;2;1;186;0;MEI
3055;SULAWESI BARAT;MAMUJU;SAMPAGA;TANAMBUAH;73;25;26;1;19;0;0;2;0;73;0;MEI
3056;SULAWESI BARAT;MAMUJU;SAMPAGA;SALUBARANA;75;34;20;1;17;1;0;2;0;75;0;MEI
3057;SULAWESI BARAT;MAMUJU;SAMPAGA;LOSSO;128;47;30;0;50;0;0;0;0;127;1;MEI
3058;SULAWESI BARAT;MAMUJU;TAPALANG;GALUNG;263;61;107;6;40;24;0;19;2;259;4;MEI
3059;SULAWESI BARAT;MAMUJU;TAPALANG;KASAMBANG;217;83;57;1;58;4;0;11;2;216;1;MEI
3060;SULAWESI BARAT;MAMUJU;TAPALANG;DAYANGINNA;123;35;39;9;24;6;0;7;0;120;3;MEI
3061;SULAWESI BARAT;MAMUJU;TAPALANG;OROBATU;89;34;25;12;6;6;0;6;0;89;0;MEI
3062;SULAWESI BARAT;MAMUJU;TAPALANG;TAKANDEANG;196;72;35;5;62;16;1;4;1;196;0;MEI
3063;SULAWESI BARAT;MAMUJU;TAPALANG;BELA;46;30;7;0;9;0;0;0;0;46;0;MEI
3064;SULAWESI BARAT;MAMUJU;TAPALANG;TAAN;245;94;82;1;56;3;0;8;0;244;1;MEI
3065;SULAWESI BARAT;MAMUJU;TAPALANG;TAMPALANG;179;82;29;1;51;4;0;11;1;179;0;MEI
3066;SULAWESI BARAT;MAMUJU;TAPALANG;RANTEDODA;78;38;13;9;12;0;0;6;0;78;0;MEI
3067;SULAWESI BARAT;MAMUJU;TAPALANG;KOPEANG;70;40;22;0;8;0;0;0;0;70;0;MEI
3068;SULAWESI BARAT;POLEWALI MANDAR;MAPILLI;MAPILI;110;42;9;6;34;4;0;15;0;110;0;MEI
3069;SULAWESI BARAT;POLEWALI MANDAR;MAPILLI;UGIBARU;241;57;53;46;34;8;0;25;0;223;18;MEI
3070;SULAWESI BARAT;POLEWALI MANDAR;MAPILLI;RUMPA;169;90;20;4;47;4;0;4;0;169;0;MEI
3071;SULAWESI BARAT;POLEWALI MANDAR;MAPILLI;KURMA;300;170;48;0;67;1;0;14;0;300;0;MEI
3072;SULAWESI BARAT;POLEWALI MANDAR;MAPILLI;BUKU;233;160;34;5;26;2;0;2;0;229;4;MEI
3073;SULAWESI BARAT;POLEWALI MANDAR;MAPILLI;BONNE BONNE;130;44;20;10;40;9;0;7;0;130;0;MEI
3074;SULAWESI BARAT;POLEWALI MANDAR;MAPILLI;BEROANGIN;220;69;30;1;96;5;0;14;1;216;4;MEI
3075;SULAWESI BARAT;POLEWALI MANDAR;MAPILLI;SEGERANG;162;98;33;4;20;1;0;6;0;162;0;MEI
3076;SULAWESI BARAT;POLEWALI MANDAR;MAPILLI;BONRA;172;83;50;2;28;1;0;8;0;172;0;MEI
3077;SULAWESI BARAT;POLEWALI MANDAR;MAPILLI;SATTOKO;86;20;9;0;51;1;0;5;0;86;0;MEI
3078;SULAWESI BARAT;POLEWALI MANDAR;MAPILLI;RAPPANG BARAT;311;100;109;3;68;5;0;25;0;310;1;MEI
3079;SULAWESI BARAT;POLEWALI MANDAR;MAPILLI;LANDI KANUSUANG;328;129;40;1;141;0;0;17;0;328;0;MEI
3080;SULAWESI BARAT;POLEWALI MANDAR;LUYO;BATUPANGA;230;112;39;4;62;2;1;6;0;226;4;MEI
3081;SULAWESI BARAT;POLEWALI MANDAR;LUYO;MAMBU;204;110;26;2;39;1;1;13;3;195;9;MEI
3082;SULAWESI BARAT;POLEWALI MANDAR;LUYO;TENGGELANG;264;132;55;12;46;0;1;7;0;253;11;MEI
3083;SULAWESI BARAT;POLEWALI MANDAR;LUYO;BARU;268;86;68;27;42;6;0;23;0;252;16;MEI
3084;SULAWESI BARAT;POLEWALI MANDAR;LUYO;PUSSUI;177;96;30;2;41;0;1;5;1;176;1;MEI
3085;SULAWESI BARAT;POLEWALI MANDAR;LUYO;MAPILI BARAT;191;112;40;13;16;0;0;10;0;191;0;MEI
3086;SULAWESI BARAT;POLEWALI MANDAR;LUYO;SAMBALI WALI;258;150;39;14;39;2;0;3;0;247;11;MEI
3087;SULAWESI BARAT;POLEWALI MANDAR;LUYO;BATUPANGA DAALA;311;151;47;3;103;0;1;5;0;310;1;MEI
3088;SULAWESI BARAT;POLEWALI MANDAR;LUYO;LUYO;204;107;22;2;52;2;3;15;0;203;1;MEI
3089;SULAWESI BARAT;POLEWALI MANDAR;LUYO;PUSSUI BARAT;107;50;11;3;25;13;1;3;0;106;1;MEI
3090;SULAWESI BARAT;POLEWALI MANDAR;LUYO;PUCCADI;202;149;20;0;24;2;0;7;0;202;0;MEI
3091;SULAWESI BARAT;POLEWALI MANDAR;MATANGNGA;MATANGNGA;70;35;6;3;22;1;0;3;0;70;0;MEI
3092;SULAWESI BARAT;POLEWALI MANDAR;MATANGNGA;LILLI;109;43;12;1;51;0;0;1;0;108;1;MEI
3093;SULAWESI BARAT;POLEWALI MANDAR;MATANGNGA;RANGOAN;72;26;30;0;14;0;0;0;0;70;2;MEI
3094;SULAWESI BARAT;POLEWALI MANDAR;MATANGNGA;TAPUA;163;74;27;7;54;0;0;1;0;163;0;MEI
3095;SULAWESI BARAT;POLEWALI MANDAR;MATANGNGA;MAMBU TAPUA;96;31;13;1;48;0;0;3;0;96;0;MEI
3096;SULAWESI BARAT;POLEWALI MANDAR;MATANGNGA;BA'BA TAPUA;71;30;10;0;31;0;0;0;0;71;0;MEI
3097;SULAWESI BARAT;POLEWALI MANDAR;MATANGNGA;KATIMBANG;88;40;23;1;22;1;0;0;0;87;1;MEI
3098;SULAWESI BARAT;POLEWALI MANDAR;POLEWALI;POLEWALI;517;161;150;39;80;31;0;45;0;506;11;MEI
3099;SULAWESI BARAT;POLEWALI MANDAR;POLEWALI;WATTANG;201;60;67;14;27;16;0;17;0;201;0;MEI
3100;SULAWESI BARAT;POLEWALI MANDAR;POLEWALI;SULEWATANG;337;91;151;4;71;7;0;13;0;337;0;MEI
3101;SULAWESI BARAT;POLEWALI MANDAR;POLEWALI;LANTORA;404;109;164;19;49;36;0;27;0;404;0;MEI
3102;SULAWESI BARAT;POLEWALI MANDAR;POLEWALI;TAKATIDUNG;468;232;88;17;74;19;0;20;0;450;18;MEI
3103;SULAWESI BARAT;POLEWALI MANDAR;POLEWALI;PEKKABATA;319;145;62;27;41;27;0;16;0;318;1;MEI
3104;SULAWESI BARAT;POLEWALI MANDAR;POLEWALI;MADATE;568;195;155;78;86;22;0;31;0;567;1;MEI
3105;SULAWESI BARAT;POLEWALI MANDAR;POLEWALI;MANDING;424;149;106;16;95;21;0;36;0;423;1;MEI
3106;SULAWESI BARAT;POLEWALI MANDAR;POLEWALI;DARMA;539;199;156;25;114;15;0;30;0;539;0;MEI
3107;SULAWESI BARAT;MAMUJU;KALUMPANG;KALUMPANG;51;25;13;0;6;0;0;3;0;47;4;MEI
3108;SULAWESI BARAT;MAMUJU;KALUMPANG;KARATAUN;178;105;36;0;34;0;0;1;0;176;2;MEI
3109;SULAWESI BARAT;MAMUJU;KALUMPANG;KARAMA;122;53;48;0;20;0;0;1;0;122;0;MEI
3110;SULAWESI BARAT;MAMUJU;KALUMPANG;SIRAUN;101;59;22;0;18;0;0;0;1;100;1;MEI
3111;SULAWESI BARAT;MAMUJU;KALUMPANG;TUMOGA;74;34;12;0;21;0;0;0;0;67;7;MEI
3112;SULAWESI BARAT;MAMUJU;KALUMPANG;SALUMAKKI;94;67;14;0;11;0;0;0;0;92;2;MEI
3113;SULAWESI BARAT;MAMUJU;KALUMPANG;POLIO;63;31;24;0;8;0;0;0;0;63;0;MEI
3114;SULAWESI BARAT;MAMUJU;KALUMPANG;LIMBONG;90;28;15;0;45;1;0;1;0;90;0;MEI
3115;SULAWESI BARAT;MAMUJU;KALUMPANG;SANDAPANG;93;31;1;0;59;0;0;1;0;92;1;MEI
3116;SULAWESI BARAT;MAMUJU;KALUMPANG;KONDO BULO;87;51;28;0;6;0;0;1;0;86;1;MEI
3117;SULAWESI BARAT;MAMUJU;KALUMPANG;MAKKALIKI;70;35;18;0;17;0;0;0;0;70;0;MEI
3118;SULAWESI BARAT;MAMUJU;KALUMPANG;BATU MAKKADA;79;35;36;0;7;0;0;0;0;78;1;MEI
3119;SULAWESI BARAT;MAMUJU;KALUMPANG;LASA';114;72;25;0;13;0;0;0;1;111;3;MEI
3120;SULAWESI BARAT;POLEWALI MANDAR;TAPANGO;PELITAKAN;163;88;31;1;15;1;0;11;0;147;16;MEI
3121;SULAWESI BARAT;POLEWALI MANDAR;TAPANGO;TAPANGO;217;122;40;3;41;5;0;6;0;217;0;MEI
3122;SULAWESI BARAT;POLEWALI MANDAR;TAPANGO;RAPPANG;223;121;49;2;39;3;0;8;0;222;1;MEI
3123;SULAWESI BARAT;POLEWALI MANDAR;TAPANGO;DAKKA;163;71;46;3;34;2;0;4;0;160;3;MEI
3124;SULAWESI BARAT;POLEWALI MANDAR;TAPANGO;BATU;136;79;25;1;23;1;0;5;0;134;2;MEI
3125;SULAWESI BARAT;POLEWALI MANDAR;TAPANGO;RISO;178;100;12;0;55;4;0;5;0;176;2;MEI
3126;SULAWESI BARAT;POLEWALI MANDAR;TAPANGO;PALATTA;179;70;59;1;38;1;0;1;0;170;9;MEI
3127;SULAWESI BARAT;POLEWALI MANDAR;TAPANGO;TAPANGO BARAT;151;82;34;1;23;3;0;8;0;151;0;MEI
3128;SULAWESI BARAT;POLEWALI MANDAR;TAPANGO;KURRAK;74;41;28;0;3;1;0;1;0;74;0;MEI
3129;SULAWESI BARAT;POLEWALI MANDAR;TAPANGO;BUSSU;148;90;33;6;15;2;0;2;0;148;0;MEI
3130;SULAWESI BARAT;POLEWALI MANDAR;TAPANGO;TUTTULA;111;75;15;2;14;1;0;0;0;107;4;MEI
3131;SULAWESI BARAT;POLEWALI MANDAR;TAPANGO;JAMBU MALEA;196;77;74;6;29;0;0;10;0;196;0;MEI
3132;SULAWESI BARAT;POLEWALI MANDAR;TAPANGO;KALIMBUA;189;120;40;1;22;1;0;5;0;189;0;MEI
3133;SULAWESI BARAT;POLEWALI MANDAR;TAPANGO;BANATO REJO;328;201;79;0;34;6;0;3;0;323;5;MEI
3134;SULAWESI BARAT;PASANGKAYU;LARIANG;PARABU;136;29;22;9;38;21;0;9;0;128;8;MEI
3135;SULAWESI BARAT;PASANGKAYU;LARIANG;KENANGAN;53;12;6;2;19;7;0;5;0;51;2;MEI
3136;SULAWESI BARAT;PASANGKAYU;LARIANG;BAJAWALI;127;28;25;3;47;12;0;12;0;127;0;MEI
3137;SULAWESI BARAT;PASANGKAYU;LARIANG;SINGGANI;185;75;54;0;35;9;0;9;0;182;3;MEI
3138;SULAWESI BARAT;PASANGKAYU;LARIANG;KULU;105;33;36;0;25;9;0;1;0;104;1;MEI
3139;SULAWESI BARAT;PASANGKAYU;LARIANG;BATU MATORU;94;33;21;0;23;7;0;10;0;94;0;MEI
3140;SULAWESI BARAT;PASANGKAYU;LARIANG;BAMBAKORO;152;57;32;1;42;11;0;9;0;152;0;MEI
3141;SULAWESI BARAT;MAJENE;TUBO SENDANA;ONANG;328;98;58;18;119;8;14;11;0;326;2;MEI
3142;SULAWESI BARAT;MAJENE;TUBO SENDANA;TUBO;89;16;13;34;8;13;1;4;0;89;0;MEI
3143;SULAWESI BARAT;MAJENE;TUBO SENDANA;ONANG UTARA;99;25;21;3;33;11;4;2;0;99;0;MEI
3144;SULAWESI BARAT;MAJENE;TUBO SENDANA;TUBO SELATAN;103;36;18;1;28;13;2;5;0;103;0;MEI
3145;SULAWESI BARAT;MAJENE;TUBO SENDANA;BONDE BONDE;90;23;13;8;21;14;6;5;0;90;0;MEI
3146;SULAWESI BARAT;MAJENE;TUBO SENDANA;TUBO TENGAH;96;26;25;6;15;14;1;9;0;96;0;MEI
3147;SULAWESI BARAT;MAJENE;TUBO SENDANA;TUBO POANG;89;36;30;9;8;1;0;5;0;89;0;MEI
3148;SULAWESI BARAT;MAMASA;SUMARORONG;SUMARORONG;146;48;39;6;33;7;0;11;0;144;2;MEI
3149;SULAWESI BARAT;MAMASA;SUMARORONG;TABONE;94;28;33;0;32;0;0;1;0;94;0;MEI
3150;SULAWESI BARAT;MAMASA;SUMARORONG;BATANG URU;99;31;50;0;15;2;0;1;0;99;0;MEI
3151;SULAWESI BARAT;MAMASA;SUMARORONG;SASAKAN;159;50;88;1;12;7;0;0;0;158;1;MEI
3152;SULAWESI BARAT;MAMASA;SUMARORONG;TADISI;54;12;35;0;7;0;0;0;0;54;0;MEI
3153;SULAWESI BARAT;MAMASA;SUMARORONG;SIBANAWA;99;29;48;0;20;0;0;2;0;99;0;MEI
3154;SULAWESI BARAT;MAMASA;SUMARORONG;BATANGNGURU TIMUR;108;32;70;0;6;0;0;0;0;108;0;MEI
3155;SULAWESI BARAT;MAMASA;SUMARORONG;SALUBALO;122;51;44;0;25;0;0;2;0;122;0;MEI
3156;SULAWESI BARAT;MAMASA;SUMARORONG;BANEA;68;23;34;0;8;1;0;2;0;68;0;MEI
3157;SULAWESI BARAT;MAMASA;SUMARORONG;RANTE KAMASE;163;77;30;4;39;5;0;7;0;162;1;MEI
3158;SULAWESI BARAT;MAMASA;NOSU;NOSU;79;6;37;1;22;6;0;5;0;77;2;MEI
3159;SULAWESI BARAT;MAMASA;NOSU;MINANGA;26;4;14;1;7;0;0;0;0;26;0;MEI
3160;SULAWESI BARAT;MAMASA;NOSU;BATUPAPAN;53;18;18;1;15;1;0;0;0;53;0;MEI
3161;SULAWESI BARAT;MAMASA;NOSU;MASEWWE;21;5;3;0;13;0;0;0;0;21;0;MEI
3162;SULAWESI BARAT;MAMASA;NOSU;SIWI;24;10;5;1;6;1;0;1;0;24;0;MEI
3163;SULAWESI BARAT;MAMASA;NOSU;MINANGA TIMUR;10;2;2;0;6;0;0;0;0;10;0;MEI
3164;SULAWESI BARAT;MAMASA;NOSU;PARINDING;23;2;16;0;5;0;0;0;0;23;0;MEI
3165;SULAWESI BARAT;MAMUJU TENGAH;BUDONG-BUDONG;BABANA;622;298;97;14;174;22;2;14;0;621;1;MEI
3166;SULAWESI BARAT;MAMUJU TENGAH;BUDONG-BUDONG;LUMU;247;106;32;0;95;4;0;8;0;245;2;MEI
3167;SULAWESI BARAT;MAMUJU TENGAH;BUDONG-BUDONG;PONTANAKAYANG;336;205;25;8;85;5;0;1;1;330;6;MEI
3168;SULAWESI BARAT;MAMUJU TENGAH;BUDONG-BUDONG;SALOGATTA;547;206;100;13;192;11;0;7;0;529;18;MEI
3169;SULAWESI BARAT;MAMUJU TENGAH;BUDONG-BUDONG;KIRE;188;63;35;4;83;1;0;2;0;188;0;MEI
3170;SULAWESI BARAT;MAMUJU TENGAH;BUDONG-BUDONG;TINALI;217;104;38;0;68;1;0;6;0;217;0;MEI
3171;SULAWESI BARAT;MAMUJU TENGAH;BUDONG-BUDONG;SALUMANURUNG;154;71;46;3;25;3;0;6;0;154;0;MEI
3172;SULAWESI BARAT;MAMUJU TENGAH;BUDONG-BUDONG;PASAPA;167;79;45;1;30;0;0;7;0;162;5;MEI
3173;SULAWESI BARAT;MAMUJU TENGAH;BUDONG-BUDONG;BOJO;245;105;57;1;70;6;0;6;0;245;0;MEI
3174;SULAWESI BARAT;MAMUJU TENGAH;BUDONG-BUDONG;BARAKKANG;119;58;17;4;38;1;0;1;0;119;0;MEI
3175;SULAWESI BARAT;MAMUJU TENGAH;BUDONG-BUDONG;LEMBAH HADA;57;28;10;0;17;1;0;1;0;57;0;MEI
3176;SULAWESI BARAT;MAMUJU TENGAH;TOPOYO;BUDONG-BUDONG;260;106;70;7;49;7;0;11;0;250;10;MEI
3177;SULAWESI BARAT;MAMUJU TENGAH;TOPOYO;TOPOYO;937;311;218;18;187;59;0;27;0;820;117;MEI
3178;SULAWESI BARAT;MAMUJU TENGAH;TOPOYO;TUMBU;331;152;66;2;74;21;0;14;0;329;2;MEI
3179;SULAWESI BARAT;MAMUJU TENGAH;TOPOYO;KABUBU;276;84;49;21;105;12;1;4;0;276;0;MEI
3180;SULAWESI BARAT;MAMUJU TENGAH;TOPOYO;WAEPUTEH;276;150;28;13;71;6;0;4;0;272;4;MEI
3181;SULAWESI BARAT;MAMUJU TENGAH;TOPOYO;TANGKOU;136;72;26;0;31;3;0;2;2;136;0;MEI
3182;SULAWESI BARAT;MAMUJU TENGAH;TOPOYO;TABOLANG;448;166;98;14;100;8;1;9;2;398;50;MEI
3183;SULAWESI BARAT;MAMUJU TENGAH;TOPOYO;PARAILI;196;109;35;2;31;14;2;3;0;196;0;MEI
3184;SULAWESI BARAT;MAMUJU TENGAH;TOPOYO;SALUPANGKANG;476;145;63;10;246;8;0;2;1;475;1;MEI
3185;SULAWESI BARAT;MAMUJU TENGAH;TOPOYO;SALUPANGKANG IV;62;42;3;0;15;0;0;1;0;61;1;MEI
3186;SULAWESI BARAT;MAMUJU TENGAH;TOPOYO;TAPPILINA;156;50;34;11;39;15;0;7;0;156;0;MEI
3187;SULAWESI BARAT;MAMUJU TENGAH;TOPOYO;BAMBAMANURUNG;156;68;11;4;66;6;0;0;1;156;0;MEI
3188;SULAWESI BARAT;MAMUJU TENGAH;TOPOYO;SALULEKBO;393;159;89;6;135;2;0;1;0;392;1;MEI
3189;SULAWESI BARAT;MAMUJU TENGAH;TOPOYO;PANGALLOANG;256;82;51;2;112;6;0;2;0;255;1;MEI
3190;SULAWESI BARAT;MAMUJU TENGAH;TOPOYO;SINABATTA;116;55;34;2;14;5;0;2;0;112;4;MEI
3191;SULAWESI BARAT;POLEWALI MANDAR;MATAKALI;MATAKALI;331;155;85;15;53;11;0;12;0;331;0;MEI
3192;SULAWESI BARAT;POLEWALI MANDAR;MATAKALI;PETAMPANUA;282;133;90;3;34;15;2;5;0;282;0;MEI
3193;SULAWESI BARAT;POLEWALI MANDAR;MATAKALI;BARUMBUNG;208;92;60;5;41;6;0;4;0;208;0;MEI
3194;SULAWESI BARAT;POLEWALI MANDAR;MATAKALI;PASIANG;414;148;86;12;134;11;0;19;0;410;4;MEI
3195;SULAWESI BARAT;POLEWALI MANDAR;MATAKALI;TONROLIMA;234;122;52;2;34;4;0;10;2;226;8;MEI
3196;SULAWESI BARAT;POLEWALI MANDAR;MATAKALI;INDOMAKKOMBONG;385;189;102;1;70;5;0;10;2;379;6;MEI
3197;SULAWESI BARAT;POLEWALI MANDAR;MATAKALI;BUNGA-BUNGA;144;65;49;6;19;1;0;4;0;144;0;MEI
3198;SULAWESI BARAT;MAMUJU;KEP. BALA BALAKANG;BALA BALAKANG;123;61;49;3;9;0;0;0;0;122;1;MEI
3199;SULAWESI BARAT;MAMUJU;KEP. BALA BALAKANG;BALA-BALAKANG TIMUR;99;28;69;1;0;0;1;0;0;99;0;MEI
3200;SULAWESI BARAT;MAMUJU TENGAH;PANGALE;POLO PANGALE;240;57;59;7;108;4;0;3;0;238;2;MEI
3201;SULAWESI BARAT;MAMUJU TENGAH;PANGALE;PANGALE;215;55;89;11;43;6;1;10;0;215;0;MEI
3202;SULAWESI BARAT;MAMUJU TENGAH;PANGALE;SARTANAMAJU;86;33;19;11;16;2;0;5;0;86;0;MEI
3203;SULAWESI BARAT;MAMUJU TENGAH;PANGALE;POLO LERENG;224;68;54;6;84;4;0;4;0;220;4;MEI
3204;SULAWESI BARAT;MAMUJU TENGAH;PANGALE;KUO;425;207;65;3;127;13;0;8;2;425;0;MEI
3205;SULAWESI BARAT;MAMUJU TENGAH;PANGALE;POLO CAMBA;147;49;46;10;36;1;0;2;3;147;0;MEI
3206;SULAWESI BARAT;MAMUJU TENGAH;PANGALE;LAMBA-LAMBA;129;46;34;4;41;2;0;2;0;129;0;MEI
3207;SULAWESI BARAT;MAMUJU TENGAH;PANGALE;KOMBILING;255;77;62;8;93;3;0;9;0;252;3;MEI
3208;SULAWESI BARAT;MAMUJU TENGAH;PANGALE;LEMO-LEMO;133;52;39;1;38;2;1;0;0;133;0;MEI
3209;SULAWESI BARAT;PASANGKAYU;BAMBAIRA;BAMBAIRA;271;73;41;8;123;10;0;13;0;268;3;MEI
3210;SULAWESI BARAT;PASANGKAYU;BAMBAIRA;KASOLOANG;174;68;19;0;66;11;0;10;0;174;0;MEI
3211;SULAWESI BARAT;PASANGKAYU;BAMBAIRA;TAMPAURE;239;102;53;2;58;6;0;12;0;233;6;MEI
3212;SULAWESI BARAT;PASANGKAYU;BAMBAIRA;KALUKU NANGKA;295;142;66;3;67;5;0;12;0;295;0;MEI
3213;SULAWESI BARAT;MAMUJU TENGAH;TOBADAK;MAHAHE;330;133;68;11;90;13;0;10;4;329;1;MEI
3214;SULAWESI BARAT;MAMUJU TENGAH;TOBADAK;SALOBAJA;381;206;50;16;95;5;0;9;0;381;0;MEI
3215;SULAWESI BARAT;MAMUJU TENGAH;TOBADAK;TOBADAK;1344;579;280;25;322;45;3;29;1;1284;60;MEI
3216;SULAWESI BARAT;MAMUJU TENGAH;TOBADAK;PALONGAAN;284;97;86;6;74;4;0;16;0;283;1;MEI
3217;SULAWESI BARAT;MAMUJU TENGAH;TOBADAK;BATU PARIGI;734;163;248;10;255;24;1;23;0;724;10;MEI
3218;SULAWESI BARAT;MAMUJU TENGAH;TOBADAK;BAMBADARU;196;69;50;10;59;1;1;6;0;196;0;MEI
3219;SULAWESI BARAT;MAMUJU TENGAH;TOBADAK;SEJATI;153;85;30;3;28;2;0;5;0;153;0;MEI
3220;SULAWESI BARAT;MAMUJU TENGAH;TOBADAK;SALOADAK;263;123;20;1;100;10;0;7;0;261;2;MEI
3221;SULAWESI BARAT;PASANGKAYU;BAMBALAMOTU;BAMBALAMOTU;385;178;75;4;79;22;0;26;0;384;1;MEI
3222;SULAWESI BARAT;PASANGKAYU;BAMBALAMOTU;POLEWALI;451;165;145;2;93;30;0;16;0;451;0;MEI
3223;SULAWESI BARAT;PASANGKAYU;BAMBALAMOTU;RANDOMAYANG;449;150;68;3;162;19;0;36;0;438;11;MEI
3224;SULAWESI BARAT;PASANGKAYU;BAMBALAMOTU;PANGIANG;193;101;46;2;20;16;0;8;0;193;0;MEI
3225;SULAWESI BARAT;PASANGKAYU;BAMBALAMOTU;KALOLA;475;124;117;0;203;18;0;13;0;475;0;MEI
3226;SULAWESI BARAT;PASANGKAYU;BAMBALAMOTU;WULAI;253;57;70;0;101;5;0;19;0;252;1;MEI
3227;SULAWESI BARAT;PASANGKAYU;BULU TABA;LILIMORI;288;108;38;7;81;33;0;21;0;288;0;MEI
3228;SULAWESI BARAT;PASANGKAYU;BULU TABA;KARAVE;255;96;44;20;64;10;0;9;0;243;12;MEI
3229;SULAWESI BARAT;PASANGKAYU;BULU TABA;BUKIT HARAPAN;146;59;38;0;34;10;1;4;0;146;0;MEI
3230;SULAWESI BARAT;PASANGKAYU;BULU TABA;KASTABUANA;162;93;26;1;27;7;0;7;0;161;1;MEI
3231;SULAWESI BARAT;PASANGKAYU;BULU TABA;SUMBER SARI;31;23;5;0;3;0;0;0;0;31;0;MEI
3232;SULAWESI BARAT;PASANGKAYU;BULU TABA;LELEJAE;163;71;26;2;42;11;0;10;1;163;0;MEI
3233;SULAWESI BARAT;PASANGKAYU;BULU TABA;OMPI;100;45;30;3;18;3;0;1;0;100;0;MEI
3234;SULAWESI BARAT;PASANGKAYU;BARAS;BARAS;280;95;34;2;96;38;0;14;1;280;0;MEI
3235;SULAWESI BARAT;PASANGKAYU;BARAS;BALANTI;362;189;75;2;76;9;0;8;0;359;3;MEI
3236;SULAWESI BARAT;PASANGKAYU;BARAS;MOTU;579;212;132;11;123;65;0;33;0;576;3;MEI
3237;SULAWESI BARAT;PASANGKAYU;BARAS;BULU PARIGI;177;69;11;3;90;3;0;1;0;177;0;MEI
3238;SULAWESI BARAT;PASANGKAYU;BARAS;TOWONI;176;45;48;2;69;6;0;6;0;176;0;MEI
3239;SULAWESI BARAT;PASANGKAYU;BARAS;KASANO;281;176;31;0;63;9;0;2;0;281;0;MEI
3240;SULAWESI BARAT;PASANGKAYU;BARAS;BARAS;284;98;34;2;96;39;0;14;1;284;0;JUNI
3241;SULAWESI BARAT;PASANGKAYU;BARAS;BALANTI;361;181;73;2;84;10;0;8;0;358;3;JUNI
3242;SULAWESI BARAT;PASANGKAYU;BARAS;MOTU;580;209;131;11;127;66;0;33;0;577;3;JUNI
3243;SULAWESI BARAT;PASANGKAYU;BARAS;BULU PARIGI;173;66;11;3;86;6;0;1;0;173;0;JUNI
3244;SULAWESI BARAT;PASANGKAYU;BARAS;TOWONI;176;44;47;2;70;7;0;6;0;176;0;JUNI
3245;SULAWESI BARAT;PASANGKAYU;BARAS;KASANO;283;174;31;0;67;9;0;2;0;283;0;JUNI
3246;SULAWESI BARAT;PASANGKAYU;BULU TABA;LILIMORI;287;108;38;7;80;33;0;21;0;287;0;JUNI
3247;SULAWESI BARAT;PASANGKAYU;BULU TABA;KARAVE;258;97;42;21;67;10;0;9;0;246;12;JUNI
3248;SULAWESI BARAT;PASANGKAYU;BULU TABA;BUKIT HARAPAN;146;59;38;0;34;10;1;4;0;146;0;JUNI
3249;SULAWESI BARAT;PASANGKAYU;BULU TABA;KASTABUANA;161;93;25;1;27;7;0;7;0;160;1;JUNI
3250;SULAWESI BARAT;PASANGKAYU;BULU TABA;SUMBER SARI;31;23;5;0;3;0;0;0;0;31;0;JUNI
3251;SULAWESI BARAT;PASANGKAYU;BULU TABA;LELEJAE;164;70;27;2;42;11;0;11;1;164;0;JUNI
3252;SULAWESI BARAT;PASANGKAYU;BULU TABA;OMPI;100;44;30;3;18;3;0;2;0;100;0;JUNI
3253;SULAWESI BARAT;MAMUJU TENGAH;TOBADAK;MAHAHE;334;134;70;11;89;15;0;11;3;333;1;JUNI
3254;SULAWESI BARAT;MAMUJU TENGAH;TOBADAK;SALOBAJA;381;206;48;17;96;5;0;9;0;381;0;JUNI
3255;SULAWESI BARAT;MAMUJU TENGAH;TOBADAK;TOBADAK;1345;578;277;25;327;44;3;30;1;1285;60;JUNI
3256;SULAWESI BARAT;MAMUJU TENGAH;TOBADAK;PALONGAAN;284;98;89;6;70;4;0;16;0;283;1;JUNI
3257;SULAWESI BARAT;MAMUJU TENGAH;TOBADAK;BATU PARIGI;745;163;250;13;261;24;1;23;0;735;10;JUNI
3258;SULAWESI BARAT;MAMUJU TENGAH;TOBADAK;BAMBADARU;195;68;48;11;59;2;1;6;0;195;0;JUNI
3259;SULAWESI BARAT;MAMUJU TENGAH;TOBADAK;SEJATI;154;84;29;3;31;2;0;5;0;154;0;JUNI
3260;SULAWESI BARAT;MAMUJU TENGAH;TOBADAK;SALOADAK;263;124;18;1;100;10;0;8;0;261;2;JUNI
3261;SULAWESI BARAT;PASANGKAYU;BAMBAIRA;BAMBAIRA;261;72;40;7;116;10;0;13;0;258;3;JUNI
3262;SULAWESI BARAT;PASANGKAYU;BAMBAIRA;KASOLOANG;174;67;20;0;66;11;0;10;0;174;0;JUNI
3263;SULAWESI BARAT;PASANGKAYU;BAMBAIRA;TAMPAURE;233;96;55;2;57;5;0;12;0;227;6;JUNI
3264;SULAWESI BARAT;PASANGKAYU;BAMBAIRA;KALUKU NANGKA;291;141;65;3;65;5;0;12;0;291;0;JUNI
3265;SULAWESI BARAT;PASANGKAYU;BAMBALAMOTU;BAMBALAMOTU;387;178;75;4;81;23;0;25;0;386;1;JUNI
3266;SULAWESI BARAT;PASANGKAYU;BAMBALAMOTU;POLEWALI;447;160;143;2;96;30;0;16;0;447;0;JUNI
3267;SULAWESI BARAT;PASANGKAYU;BAMBALAMOTU;RANDOMAYANG;449;152;67;4;161;19;0;36;0;439;10;JUNI
3268;SULAWESI BARAT;PASANGKAYU;BAMBALAMOTU;PANGIANG;194;99;49;1;22;14;0;9;0;194;0;JUNI
3269;SULAWESI BARAT;PASANGKAYU;BAMBALAMOTU;KALOLA;478;130;111;0;206;18;0;13;0;478;0;JUNI
3270;SULAWESI BARAT;PASANGKAYU;BAMBALAMOTU;WULAI;258;57;71;0;105;5;0;19;0;257;1;JUNI
3271;SULAWESI BARAT;MAMUJU TENGAH;BUDONG-BUDONG;BABANA;620;299;95;13;175;21;2;14;0;619;1;JUNI
3272;SULAWESI BARAT;MAMUJU TENGAH;BUDONG-BUDONG;LUMU;247;106;32;0;95;4;0;8;0;245;2;JUNI
3273;SULAWESI BARAT;MAMUJU TENGAH;BUDONG-BUDONG;PONTANAKAYANG;330;197;25;7;87;6;0;1;1;324;6;JUNI
3274;SULAWESI BARAT;MAMUJU TENGAH;BUDONG-BUDONG;SALOGATTA;547;207;96;14;193;12;0;7;0;529;18;JUNI
3275;SULAWESI BARAT;MAMUJU TENGAH;BUDONG-BUDONG;KIRE;187;62;35;3;85;1;0;1;0;187;0;JUNI
3276;SULAWESI BARAT;MAMUJU TENGAH;BUDONG-BUDONG;TINALI;218;109;36;0;66;1;0;6;0;218;0;JUNI
3277;SULAWESI BARAT;MAMUJU TENGAH;BUDONG-BUDONG;SALUMANURUNG;162;72;50;4;27;3;0;6;0;162;0;JUNI
3278;SULAWESI BARAT;MAMUJU TENGAH;BUDONG-BUDONG;PASAPA;169;76;44;1;36;0;0;7;0;164;5;JUNI
3279;SULAWESI BARAT;MAMUJU TENGAH;BUDONG-BUDONG;BOJO;244;105;53;1;74;6;0;5;0;244;0;JUNI
3280;SULAWESI BARAT;MAMUJU TENGAH;BUDONG-BUDONG;BARAKKANG;119;56;17;4;38;1;0;3;0;119;0;JUNI
3281;SULAWESI BARAT;MAMUJU TENGAH;BUDONG-BUDONG;LEMBAH HADA;57;27;10;0;18;1;0;1;0;57;0;JUNI
3282;SULAWESI BARAT;MAMUJU;KEP. BALA BALAKANG;BALA BALAKANG;122;61;49;2;9;0;0;0;0;121;1;JUNI
3283;SULAWESI BARAT;MAMUJU;KEP. BALA BALAKANG;BALA-BALAKANG TIMUR;99;28;69;1;0;0;1;0;0;99;0;JUNI
3284;SULAWESI BARAT;POLEWALI MANDAR;MATAKALI;MATAKALI;331;156;85;14;53;11;0;12;0;331;0;JUNI
3285;SULAWESI BARAT;POLEWALI MANDAR;MATAKALI;PETAMPANUA;283;131;88;3;39;15;2;5;0;283;0;JUNI
3286;SULAWESI BARAT;POLEWALI MANDAR;MATAKALI;BARUMBUNG;206;90;60;5;41;6;0;4;0;206;0;JUNI
3287;SULAWESI BARAT;POLEWALI MANDAR;MATAKALI;PASIANG;412;144;84;12;138;11;0;19;0;408;4;JUNI
3288;SULAWESI BARAT;POLEWALI MANDAR;MATAKALI;TONROLIMA;231;123;48;2;34;5;0;10;2;224;7;JUNI
3289;SULAWESI BARAT;POLEWALI MANDAR;MATAKALI;INDOMAKKOMBONG;386;189;102;1;70;5;0;11;2;380;6;JUNI
3290;SULAWESI BARAT;POLEWALI MANDAR;MATAKALI;BUNGA-BUNGA;144;68;47;6;18;1;0;4;0;144;0;JUNI
3291;SULAWESI BARAT;POLEWALI MANDAR;MATANGNGA;MATANGNGA;70;35;6;3;22;1;0;3;0;70;0;JUNI
3292;SULAWESI BARAT;POLEWALI MANDAR;MATANGNGA;LILLI;110;42;12;1;53;0;0;1;0;109;1;JUNI
3293;SULAWESI BARAT;POLEWALI MANDAR;MATANGNGA;RANGOAN;70;26;29;0;13;0;0;0;0;68;2;JUNI
3294;SULAWESI BARAT;POLEWALI MANDAR;MATANGNGA;TAPUA;163;70;27;7;58;0;0;1;0;163;0;JUNI
3295;SULAWESI BARAT;POLEWALI MANDAR;MATANGNGA;MAMBU TAPUA;96;32;13;1;47;0;0;3;0;96;0;JUNI
3296;SULAWESI BARAT;POLEWALI MANDAR;MATANGNGA;BA'BA TAPUA;71;30;10;0;31;0;0;0;0;71;0;JUNI
3297;SULAWESI BARAT;POLEWALI MANDAR;MATANGNGA;KATIMBANG;88;39;23;1;23;1;0;0;0;87;1;JUNI
3298;SULAWESI BARAT;POLEWALI MANDAR;TUTAR;TARAMANU;200;94;34;6;43;1;12;10;0;200;0;JUNI
3299;SULAWESI BARAT;POLEWALI MANDAR;TUTAR;AMBOPADANG;274;102;56;0;112;2;0;2;0;274;0;JUNI
3300;SULAWESI BARAT;POLEWALI MANDAR;TUTAR;TUBBI;131;41;68;4;7;3;0;8;0;131;0;JUNI
3301;SULAWESI BARAT;POLEWALI MANDAR;TUTAR;RATTE;185;77;64;2;39;1;1;0;1;185;0;JUNI
3302;SULAWESI BARAT;POLEWALI MANDAR;TUTAR;BESOANGIN;122;66;8;3;45;0;0;0;0;122;0;JUNI
3303;SULAWESI BARAT;POLEWALI MANDAR;TUTAR;PIRIANG TAPIKO;112;32;58;0;20;0;0;2;0;112;0;JUNI
3304;SULAWESI BARAT;POLEWALI MANDAR;TUTAR;PEBURRU;190;108;45;2;28;2;0;5;0;190;0;JUNI
3305;SULAWESI BARAT;POLEWALI MANDAR;TUTAR;TALOBA;96;38;36;0;18;0;0;3;0;95;1;JUNI
3306;SULAWESI BARAT;POLEWALI MANDAR;TUTAR;POLLEWANI;261;134;89;2;33;0;0;3;0;261;0;JUNI
3307;SULAWESI BARAT;POLEWALI MANDAR;TUTAR;ARABUA;157;91;36;0;12;0;15;3;0;157;0;JUNI
3308;SULAWESI BARAT;POLEWALI MANDAR;TUTAR;BESOANGIN UTARA;107;52;24;2;28;0;0;1;0;107;0;JUNI
3309;SULAWESI BARAT;POLEWALI MANDAR;TUTAR;PODA;119;51;48;4;12;0;1;3;0;119;0;JUNI
3310;SULAWESI BARAT;POLEWALI MANDAR;TUTAR;TARAMANU TUA;170;34;55;2;69;3;0;4;0;167;3;JUNI
3311;SULAWESI BARAT;POLEWALI MANDAR;POLEWALI;POLEWALI;517;162;149;39;79;31;0;46;0;506;11;JUNI
3312;SULAWESI BARAT;POLEWALI MANDAR;POLEWALI;WATTANG;200;61;66;13;27;16;0;17;0;200;0;JUNI
3313;SULAWESI BARAT;POLEWALI MANDAR;POLEWALI;SULEWATANG;336;83;158;5;71;6;0;13;0;336;0;JUNI
3314;SULAWESI BARAT;POLEWALI MANDAR;POLEWALI;LANTORA;406;111;160;19;52;37;0;27;0;406;0;JUNI
3315;SULAWESI BARAT;POLEWALI MANDAR;POLEWALI;TAKATIDUNG;492;237;99;21;76;20;0;22;0;475;17;JUNI
3316;SULAWESI BARAT;POLEWALI MANDAR;POLEWALI;PEKKABATA;321;145;62;27;41;27;0;18;0;320;1;JUNI
3317;SULAWESI BARAT;POLEWALI MANDAR;POLEWALI;MADATE;570;195;154;80;87;22;0;31;0;569;1;JUNI
3318;SULAWESI BARAT;POLEWALI MANDAR;POLEWALI;MANDING;422;148;105;16;94;22;0;36;0;421;1;JUNI
3319;SULAWESI BARAT;POLEWALI MANDAR;POLEWALI;DARMA;557;189;173;31;119;15;0;30;0;557;0;JUNI
3320;SULAWESI BARAT;POLEWALI MANDAR;TINAMBUNG;TINAMBUNG;126;41;27;4;24;4;0;26;0;126;0;JUNI
3321;SULAWESI BARAT;POLEWALI MANDAR;TINAMBUNG;KARAMA;465;335;44;21;47;2;0;15;0;464;1;JUNI
3322;SULAWESI BARAT;POLEWALI MANDAR;TINAMBUNG;TANGNGA TANGNGA;200;145;32;2;12;1;0;8;0;200;0;JUNI
3323;SULAWESI BARAT;POLEWALI MANDAR;TINAMBUNG;LEKOPADIS;87;31;15;6;27;1;0;6;0;86;1;JUNI
3324;SULAWESI BARAT;POLEWALI MANDAR;TINAMBUNG;GALUNG LOMBOK;133;52;15;16;33;3;0;14;0;133;0;JUNI
3325;SULAWESI BARAT;POLEWALI MANDAR;TINAMBUNG;TANDUNG;122;55;25;7;18;4;0;11;0;120;2;JUNI
3326;SULAWESI BARAT;POLEWALI MANDAR;TINAMBUNG;BATULAYA;119;48;25;16;15;4;1;10;0;119;0;JUNI
3327;SULAWESI BARAT;POLEWALI MANDAR;TINAMBUNG;SEPABATU;100;35;24;9;17;2;0;13;0;100;0;JUNI
3328;SULAWESI BARAT;MAMUJU;BONEHAU;BONEHAU;162;42;81;4;23;2;0;4;0;156;6;JUNI
3329;SULAWESI BARAT;MAMUJU;BONEHAU;SALUTIWO;92;33;37;3;19;0;0;0;0;92;0;JUNI
3330;SULAWESI BARAT;MAMUJU;BONEHAU;BUTTUADA;205;9;171;3;17;1;0;2;0;203;2;JUNI
3331;SULAWESI BARAT;MAMUJU;BONEHAU;TAMALEA;49;4;37;0;7;0;0;1;0;49;0;JUNI
3332;SULAWESI BARAT;MAMUJU;BONEHAU;LUMIKA;129;39;54;2;33;1;0;0;0;129;0;JUNI
3333;SULAWESI BARAT;MAMUJU;BONEHAU;MAPPU;72;15;43;0;13;0;0;1;0;72;0;JUNI
3334;SULAWESI BARAT;MAMUJU;BONEHAU;BANUADA;98;11;80;3;3;0;0;1;0;98;0;JUNI
3335;SULAWESI BARAT;MAMUJU;BONEHAU;HINUA;102;26;30;5;34;1;0;3;1;100;2;JUNI
3336;SULAWESI BARAT;MAMUJU;BONEHAU;KINATANG;103;17;83;1;0;0;0;2;0;103;0;JUNI
3337;SULAWESI BARAT;MAMUJU;KALUKKU;SINYONYOI;454;238;132;10;47;5;0;11;0;443;11;JUNI
3338;SULAWESI BARAT;MAMUJU;KALUKKU;BEBANGA;757;449;203;4;67;6;2;23;0;754;3;JUNI
3339;SULAWESI BARAT;MAMUJU;KALUKKU;KALUKKU;693;246;186;8;181;23;1;28;0;673;20;JUNI
3340;SULAWESI BARAT;MAMUJU;KALUKKU;SINYONYOI SELATAN;269;128;73;5;31;3;0;23;0;263;6;JUNI
3341;SULAWESI BARAT;MAMUJU;KALUKKU;SONDOANG;274;117;85;1;63;1;0;5;1;273;1;JUNI
3342;SULAWESI BARAT;MAMUJU;KALUKKU;BERU-BERU;556;320;90;2;130;2;0;11;1;556;0;JUNI
3343;SULAWESI BARAT;MAMUJU;KALUKKU;BELANG BELANG;390;176;121;3;77;2;0;11;0;390;0;JUNI
3344;SULAWESI BARAT;MAMUJU;KALUKKU;KABULOANG;356;137;128;3;71;1;1;10;1;352;4;JUNI
3345;SULAWESI BARAT;MAMUJU;KALUKKU;KEANG;232;68;127;1;27;1;0;7;0;231;1;JUNI
3346;SULAWESI BARAT;MAMUJU;KALUKKU;POKKANG;204;85;41;2;64;3;1;8;0;204;0;JUNI
3347;SULAWESI BARAT;MAMUJU;KALUKKU;GULILING;149;46;61;0;37;0;0;2;2;148;1;JUNI
3348;SULAWESI BARAT;MAMUJU;KALUKKU;UHAIMATE;122;79;35;1;7;0;0;0;0;122;0;JUNI
3349;SULAWESI BARAT;MAMUJU;KALUKKU;KALUKKU BARAT;476;281;65;1;123;2;0;4;0;476;0;JUNI
3350;SULAWESI BARAT;MAMUJU;KALUKKU;PAMMULUKANG;230;116;75;7;18;0;0;12;1;229;1;JUNI
3351;SULAWESI BARAT;MAMUJU;KALUMPANG;KALUMPANG;51;25;13;0;6;0;0;3;0;47;4;JUNI
3352;SULAWESI BARAT;MAMUJU;KALUMPANG;KARATAUN;178;100;38;0;37;0;0;1;0;176;2;JUNI
3353;SULAWESI BARAT;MAMUJU;KALUMPANG;KARAMA;124;51;50;0;22;0;0;1;0;124;0;JUNI
3354;SULAWESI BARAT;MAMUJU;KALUMPANG;SIRAUN;101;59;22;0;18;0;0;0;1;100;1;JUNI
3355;SULAWESI BARAT;MAMUJU;KALUMPANG;TUMOGA;73;35;10;0;22;0;0;0;0;67;6;JUNI
3356;SULAWESI BARAT;MAMUJU;KALUMPANG;SALUMAKKI;94;66;14;0;12;0;0;0;0;92;2;JUNI
3357;SULAWESI BARAT;MAMUJU;KALUMPANG;POLIO;63;31;24;0;8;0;0;0;0;63;0;JUNI
3358;SULAWESI BARAT;MAMUJU;KALUMPANG;LIMBONG;90;28;15;0;45;1;0;1;0;90;0;JUNI
3359;SULAWESI BARAT;MAMUJU;KALUMPANG;SANDAPANG;93;31;1;0;59;0;0;1;0;92;1;JUNI
3360;SULAWESI BARAT;MAMUJU;KALUMPANG;KONDO BULO;87;51;28;0;6;0;0;1;0;86;1;JUNI
3361;SULAWESI BARAT;MAMUJU;KALUMPANG;MAKKALIKI;70;35;18;0;17;0;0;0;0;70;0;JUNI
3362;SULAWESI BARAT;MAMUJU;KALUMPANG;BATU MAKKADA;79;35;36;0;7;0;0;0;0;78;1;JUNI
3363;SULAWESI BARAT;MAMUJU;KALUMPANG;LASA';117;72;25;0;16;0;0;0;1;114;3;JUNI
3364;SULAWESI BARAT;POLEWALI MANDAR;TAPANGO;PELITAKAN;162;89;29;1;15;1;0;11;0;146;16;JUNI
3365;SULAWESI BARAT;POLEWALI MANDAR;TAPANGO;TAPANGO;216;122;39;3;41;5;0;6;0;216;0;JUNI
3366;SULAWESI BARAT;POLEWALI MANDAR;TAPANGO;RAPPANG;223;121;49;2;39;3;0;8;0;222;1;JUNI
3367;SULAWESI BARAT;POLEWALI MANDAR;TAPANGO;DAKKA;163;71;46;3;34;2;0;4;0;160;3;JUNI
3368;SULAWESI BARAT;POLEWALI MANDAR;TAPANGO;BATU;137;72;31;3;22;1;0;6;0;135;2;JUNI
3369;SULAWESI BARAT;POLEWALI MANDAR;TAPANGO;RISO;178;101;11;0;55;4;0;5;0;176;2;JUNI
3370;SULAWESI BARAT;POLEWALI MANDAR;TAPANGO;PALATTA;180;67;61;1;41;0;0;1;0;171;9;JUNI
3371;SULAWESI BARAT;POLEWALI MANDAR;TAPANGO;TAPANGO BARAT;151;82;34;1;23;3;0;8;0;151;0;JUNI
3372;SULAWESI BARAT;POLEWALI MANDAR;TAPANGO;KURRAK;74;42;25;0;5;1;0;1;0;74;0;JUNI
3373;SULAWESI BARAT;POLEWALI MANDAR;TAPANGO;BUSSU;149;86;39;4;16;2;0;2;0;149;0;JUNI
3374;SULAWESI BARAT;POLEWALI MANDAR;TAPANGO;TUTTULA;111;75;15;2;14;1;0;0;0;107;4;JUNI
3375;SULAWESI BARAT;POLEWALI MANDAR;TAPANGO;JAMBU MALEA;201;78;77;7;29;0;0;10;0;201;0;JUNI
3376;SULAWESI BARAT;POLEWALI MANDAR;TAPANGO;KALIMBUA;187;120;39;1;21;1;0;5;0;187;0;JUNI
3377;SULAWESI BARAT;POLEWALI MANDAR;TAPANGO;BANATO REJO;328;202;78;0;34;6;0;3;0;323;5;JUNI
3378;SULAWESI BARAT;POLEWALI MANDAR;LUYO;BATUPANGA;230;111;40;4;62;2;1;6;0;226;4;JUNI
3379;SULAWESI BARAT;POLEWALI MANDAR;LUYO;MAMBU;203;110;27;2;37;1;1;13;3;194;9;JUNI
3380;SULAWESI BARAT;POLEWALI MANDAR;LUYO;TENGGELANG;265;132;55;11;48;0;1;7;0;254;11;JUNI
3381;SULAWESI BARAT;POLEWALI MANDAR;LUYO;BARU;275;88;72;28;42;7;0;23;0;260;15;JUNI
3382;SULAWESI BARAT;POLEWALI MANDAR;LUYO;PUSSUI;180;99;30;2;41;0;1;5;1;179;1;JUNI
3383;SULAWESI BARAT;POLEWALI MANDAR;LUYO;MAPILI BARAT;192;111;41;13;17;0;0;10;0;192;0;JUNI
3384;SULAWESI BARAT;POLEWALI MANDAR;LUYO;SAMBALI WALI;272;158;46;14;38;3;0;3;0;262;10;JUNI
3385;SULAWESI BARAT;POLEWALI MANDAR;LUYO;BATUPANGA DAALA;316;150;51;3;105;0;1;5;0;315;1;JUNI
3386;SULAWESI BARAT;POLEWALI MANDAR;LUYO;LUYO;204;108;22;2;51;2;3;15;0;203;1;JUNI
3387;SULAWESI BARAT;POLEWALI MANDAR;LUYO;PUSSUI BARAT;111;50;12;3;28;13;1;3;0;110;1;JUNI
3388;SULAWESI BARAT;POLEWALI MANDAR;LUYO;PUCCADI;204;148;22;0;24;3;0;7;0;204;0;JUNI
3389;SULAWESI BARAT;POLEWALI MANDAR;MAPILLI;MAPILI;109;40;10;6;36;4;0;13;0;109;0;JUNI
3390;SULAWESI BARAT;POLEWALI MANDAR;MAPILLI;UGIBARU;239;59;51;44;34;8;0;25;0;221;18;JUNI
3391;SULAWESI BARAT;POLEWALI MANDAR;MAPILLI;RUMPA;169;90;19;4;48;4;0;4;0;169;0;JUNI
3392;SULAWESI BARAT;POLEWALI MANDAR;MAPILLI;KURMA;304;168;49;0;70;3;0;14;0;304;0;JUNI
3393;SULAWESI BARAT;POLEWALI MANDAR;MAPILLI;BUKU;231;159;33;5;26;2;0;2;0;227;4;JUNI
3394;SULAWESI BARAT;POLEWALI MANDAR;MAPILLI;BONNE BONNE;130;44;19;10;41;9;0;7;0;130;0;JUNI
3395;SULAWESI BARAT;POLEWALI MANDAR;MAPILLI;BEROANGIN;224;69;30;1;100;5;0;14;1;220;4;JUNI
3396;SULAWESI BARAT;POLEWALI MANDAR;MAPILLI;SEGERANG;162;98;33;4;20;1;0;6;0;162;0;JUNI
3397;SULAWESI BARAT;POLEWALI MANDAR;MAPILLI;BONRA;178;85;53;2;29;1;0;8;0;178;0;JUNI
3398;SULAWESI BARAT;POLEWALI MANDAR;MAPILLI;SATTOKO;88;21;10;0;50;1;0;6;0;88;0;JUNI
3399;SULAWESI BARAT;POLEWALI MANDAR;MAPILLI;RAPPANG BARAT;310;99;111;2;68;4;0;25;0;309;1;JUNI
3400;SULAWESI BARAT;POLEWALI MANDAR;MAPILLI;LANDI KANUSUANG;327;129;39;1;142;0;0;16;0;327;0;JUNI
3401;SULAWESI BARAT;MAMUJU;SAMPAGA;BUNDE;514;250;128;3;127;1;0;5;0;514;0;JUNI
3402;SULAWESI BARAT;MAMUJU;SAMPAGA;KALONDING;452;180;180;9;75;4;0;3;0;451;1;JUNI
3403;SULAWESI BARAT;MAMUJU;SAMPAGA;TARAILU;261;120;80;0;49;5;0;7;0;261;0;JUNI
3404;SULAWESI BARAT;MAMUJU;SAMPAGA;SAMPAGA;185;88;65;2;26;1;0;2;1;185;0;JUNI
3405;SULAWESI BARAT;MAMUJU;SAMPAGA;TANAMBUAH;72;24;26;1;19;0;0;2;0;72;0;JUNI
3406;SULAWESI BARAT;MAMUJU;SAMPAGA;SALUBARANA;74;33;21;1;16;1;0;2;0;74;0;JUNI
3407;SULAWESI BARAT;MAMUJU;SAMPAGA;LOSSO;130;47;30;0;52;0;0;0;0;129;1;JUNI
3408;SULAWESI BARAT;MAMUJU;TAPALANG;GALUNG;260;60;107;5;40;25;0;19;1;257;3;JUNI
3409;SULAWESI BARAT;MAMUJU;TAPALANG;KASAMBANG;212;80;56;1;57;4;0;11;2;211;1;JUNI
3410;SULAWESI BARAT;MAMUJU;TAPALANG;DAYANGINNA;122;34;40;8;24;6;0;7;0;119;3;JUNI
3411;SULAWESI BARAT;MAMUJU;TAPALANG;OROBATU;87;34;25;10;6;6;0;6;0;87;0;JUNI
3412;SULAWESI BARAT;MAMUJU;TAPALANG;TAKANDEANG;196;72;35;7;60;17;1;4;0;196;0;JUNI
3413;SULAWESI BARAT;MAMUJU;TAPALANG;BELA;46;30;7;0;9;0;0;0;0;46;0;JUNI
3414;SULAWESI BARAT;MAMUJU;TAPALANG;TAAN;236;94;76;2;52;3;0;8;0;235;1;JUNI
3415;SULAWESI BARAT;MAMUJU;TAPALANG;TAMPALANG;171;77;31;2;45;4;0;11;1;171;0;JUNI
3416;SULAWESI BARAT;MAMUJU;TAPALANG;RANTEDODA;76;37;13;8;13;0;0;5;0;76;0;JUNI
3417;SULAWESI BARAT;MAMUJU;TAPALANG;KOPEANG;70;41;21;0;8;0;0;0;0;70;0;JUNI
3418;SULAWESI BARAT;POLEWALI MANDAR;WONOMULYO;SIDODADI;398;203;88;3;57;30;0;14;1;396;2;JUNI
3419;SULAWESI BARAT;POLEWALI MANDAR;WONOMULYO;SIDOREJO;283;157;61;11;22;14;0;16;0;281;2;JUNI
3420;SULAWESI BARAT;POLEWALI MANDAR;WONOMULYO;SUMBEREJO;485;233;80;27;100;32;0;6;1;479;6;JUNI
3421;SULAWESI BARAT;POLEWALI MANDAR;WONOMULYO;BUMIAYU;410;184;75;9;50;53;0;17;0;388;22;JUNI
3422;SULAWESI BARAT;POLEWALI MANDAR;WONOMULYO;KEBUNSARI;295;119;57;11;37;41;1;13;0;279;16;JUNI
3423;SULAWESI BARAT;POLEWALI MANDAR;WONOMULYO;BANUA BARU;183;98;28;7;19;15;0;8;0;175;8;JUNI
3424;SULAWESI BARAT;POLEWALI MANDAR;WONOMULYO;NEPO;254;151;48;1;37;9;1;4;0;251;3;JUNI
3425;SULAWESI BARAT;POLEWALI MANDAR;WONOMULYO;SUGIHWARAS;534;252;129;17;81;31;0;12;0;522;12;JUNI
3426;SULAWESI BARAT;POLEWALI MANDAR;WONOMULYO;CAMPURJO;242;113;44;6;39;19;0;20;0;241;1;JUNI
3427;SULAWESI BARAT;POLEWALI MANDAR;WONOMULYO;BUMIMULYO;200;105;51;0;31;9;0;2;0;198;2;JUNI
3428;SULAWESI BARAT;POLEWALI MANDAR;WONOMULYO;TUMPILING;225;116;53;2;31;3;0;8;0;213;12;JUNI
3429;SULAWESI BARAT;POLEWALI MANDAR;WONOMULYO;BAKKA-BAKKA;191;104;35;3;31;7;0;6;0;186;5;JUNI
3430;SULAWESI BARAT;POLEWALI MANDAR;WONOMULYO;ARJO SARI;277;147;83;4;11;18;0;8;0;271;6;JUNI
3431;SULAWESI BARAT;POLEWALI MANDAR;WONOMULYO;GALESON;238;162;29;3;27;5;0;7;0;233;5;JUNI
3432;SULAWESI BARAT;MAMASA;MAMASA;MAMASA;368;61;46;3;178;60;0;20;0;368;0;JUNI
3433;SULAWESI BARAT;MAMASA;MAMASA;RAMBUSARATU;253;86;81;16;54;10;0;6;0;253;0;JUNI
3434;SULAWESI BARAT;MAMASA;MAMASA;OSANGO;468;88;73;11;190;87;0;14;1;464;4;JUNI
3435;SULAWESI BARAT;MAMASA;MAMASA;LAMBANAN;224;68;52;9;79;7;0;9;0;224;0;JUNI
3436;SULAWESI BARAT;MAMASA;MAMASA;LEMBANA SALULO;89;19;14;2;44;4;0;6;0;89;0;JUNI
3437;SULAWESI BARAT;MAMASA;MAMASA;TAUPE;233;52;31;7;139;1;1;2;0;233;0;JUNI
3438;SULAWESI BARAT;MAMASA;MAMASA;BUNTU BUDA;296;75;33;9;103;26;0;5;1;252;44;JUNI
3439;SULAWESI BARAT;MAMASA;MAMASA;TONDOK BAKARU;263;86;81;16;61;10;0;8;0;262;1;JUNI
3440;SULAWESI BARAT;MAMASA;MAMASA;PEBASSIAN;94;27;22;2;39;2;0;2;0;94;0;JUNI
3441;SULAWESI BARAT;MAMASA;MAMASA;MAMBULILING;120;54;22;2;37;4;0;1;0;120;0;JUNI
3442;SULAWESI BARAT;MAMASA;MAMASA;BOMBONG LAMBE;152;50;19;3;65;14;0;1;0;152;0;JUNI
3443;SULAWESI BARAT;MAMASA;MAMASA;BUBUN BATU;129;26;9;6;76;2;0;2;0;121;8;JUNI
3444;SULAWESI BARAT;POLEWALI MANDAR;BULO;BULO;104;18;9;2;73;2;0;0;0;104;0;JUNI
3445;SULAWESI BARAT;POLEWALI MANDAR;BULO;PULLIWA;307;99;52;3;139;3;0;10;0;306;1;JUNI
3446;SULAWESI BARAT;POLEWALI MANDAR;BULO;PATAMBANUA;144;26;108;0;7;0;0;1;0;142;2;JUNI
3447;SULAWESI BARAT;POLEWALI MANDAR;BULO;KAROMBANG;139;81;21;0;34;2;0;1;0;139;0;JUNI
3448;SULAWESI BARAT;POLEWALI MANDAR;BULO;DAALA TIMUR;126;42;60;2;21;0;0;1;0;126;0;JUNI
3449;SULAWESI BARAT;POLEWALI MANDAR;BULO;LENGGO;49;16;29;1;2;1;0;0;0;49;0;JUNI
3450;SULAWESI BARAT;POLEWALI MANDAR;BULO;SABURA;70;29;31;0;9;0;0;1;0;70;0;JUNI
3451;SULAWESI BARAT;POLEWALI MANDAR;BULO;SEPPORRAKI;100;27;25;0;46;0;0;2;0;100;0;JUNI
3452;SULAWESI BARAT;POLEWALI MANDAR;BULO;IHING;110;23;23;2;57;1;0;1;0;107;3;JUNI
3453;SULAWESI BARAT;MAMUJU;TAPALANG BARAT;DUNGKAIT;245;100;97;5;35;3;1;2;0;243;2;JUNI
3454;SULAWESI BARAT;MAMUJU;TAPALANG BARAT;LEBANI;116;37;55;0;7;0;0;4;2;105;11;JUNI
3455;SULAWESI BARAT;MAMUJU;TAPALANG BARAT;LABUANG RANO;230;121;83;0;10;4;0;2;0;220;10;JUNI
3456;SULAWESI BARAT;MAMUJU;TAPALANG BARAT;PASABU;167;46;69;7;19;8;0;13;2;164;3;JUNI
3457;SULAWESI BARAT;MAMUJU;TAPALANG BARAT;TANETE PAO;44;31;10;0;2;0;0;0;0;43;1;JUNI
3458;SULAWESI BARAT;MAMUJU;TAPALANG BARAT;PANGASAAN;57;25;18;2;6;5;0;0;0;56;1;JUNI
3459;SULAWESI BARAT;MAMUJU;TAPALANG BARAT;AHU;172;91;62;2;7;0;0;2;0;164;8;JUNI
3460;SULAWESI BARAT;MAMUJU;MAMUJU;BINANGA;792;460;162;15;70;55;1;17;3;783;9;JUNI
3461;SULAWESI BARAT;MAMUJU;MAMUJU;MAMUNYU;606;305;163;39;52;28;1;14;0;602;4;JUNI
3462;SULAWESI BARAT;MAMUJU;MAMUJU;KAREMA;866;454;120;38;101;63;2;32;0;810;56;JUNI
3463;SULAWESI BARAT;MAMUJU;MAMUJU;RIMUKU;691;300;149;33;51;78;2;32;1;646;45;JUNI
3464;SULAWESI BARAT;MAMUJU;MAMUJU;BAMBU;366;206;74;15;49;6;0;16;0;366;0;JUNI
3465;SULAWESI BARAT;MAMUJU;MAMUJU;KARAMPUANG;481;352;69;2;31;10;0;14;0;478;3;JUNI
3466;SULAWESI BARAT;MAMUJU;MAMUJU;TADUI;496;166;211;1;64;7;0;27;2;478;18;JUNI
3467;SULAWESI BARAT;MAMUJU;MAMUJU;BATU PANNU;180;128;34;0;11;3;0;4;0;180;0;JUNI
3468;SULAWESI BARAT;MAMUJU;SIMBORO;SIMBORO;1556;617;187;70;167;250;1;68;5;1365;191;JUNI
3469;SULAWESI BARAT;MAMUJU;SIMBORO;RANGAS;552;170;151;18;120;19;3;11;0;492;60;JUNI
3470;SULAWESI BARAT;MAMUJU;SIMBORO;BOTTENG;198;114;44;1;23;2;0;13;0;197;1;JUNI
3471;SULAWESI BARAT;MAMUJU;SIMBORO;SALETTO;291;132;81;5;45;5;1;22;0;291;0;JUNI
3472;SULAWESI BARAT;MAMUJU;SIMBORO;SUMARE;223;107;79;2;25;10;0;0;0;223;0;JUNI
3473;SULAWESI BARAT;MAMUJU;SIMBORO;BOTTENG UTARA;359;143;91;1;102;5;1;0;0;343;16;JUNI
3474;SULAWESI BARAT;MAMUJU;SIMBORO;TAPANDULLU;46;28;0;0;14;0;2;2;0;46;0;JUNI
3475;SULAWESI BARAT;MAMUJU;SIMBORO;PATI'DI;189;105;42;1;37;1;0;3;0;189;0;JUNI
3476;SULAWESI BARAT;POLEWALI MANDAR;BINUANG;AMASSANGAN;304;140;55;1;74;2;0;32;0;304;0;JUNI
3477;SULAWESI BARAT;POLEWALI MANDAR;BINUANG;TONYAMAN;504;207;160;5;90;12;0;13;2;489;15;JUNI
3478;SULAWESI BARAT;POLEWALI MANDAR;BINUANG;KUAJANG;387;177;72;15;107;4;1;11;0;387;0;JUNI
3479;SULAWESI BARAT;POLEWALI MANDAR;BINUANG;PAKU;160;76;38;12;22;0;1;10;1;160;0;JUNI
3480;SULAWESI BARAT;POLEWALI MANDAR;BINUANG;MIRRING;218;112;39;5;40;1;0;18;0;215;3;JUNI
3481;SULAWESI BARAT;POLEWALI MANDAR;BINUANG;BATETANGNGA;693;405;141;11;82;5;0;18;2;664;29;JUNI
3482;SULAWESI BARAT;POLEWALI MANDAR;BINUANG;MAMMI;262;89;65;8;87;3;0;9;0;261;1;JUNI
3483;SULAWESI BARAT;POLEWALI MANDAR;BINUANG;KALEOK;145;46;64;2;28;0;0;5;0;145;0;JUNI
3484;SULAWESI BARAT;POLEWALI MANDAR;BINUANG;AMOLA;150;87;22;2;36;0;1;2;0;150;0;JUNI
3485;SULAWESI BARAT;POLEWALI MANDAR;BINUANG;REA;251;106;79;9;30;1;2;18;0;245;6;JUNI
3486;SULAWESI BARAT;MAMASA;BALLA;BALLA;167;27;28;2;85;13;0;11;0;166;1;JUNI
3487;SULAWESI BARAT;MAMASA;BALLA;BALLA BARAT;89;39;14;0;35;0;0;1;0;89;0;JUNI
3488;SULAWESI BARAT;MAMASA;BALLA;BALLA SATANETEAN;147;57;13;3;62;8;0;3;0;146;1;JUNI
3489;SULAWESI BARAT;MAMASA;BALLA;BALLA TUMUKA;116;39;35;0;40;1;0;1;0;116;0;JUNI
3490;SULAWESI BARAT;MAMASA;BALLA;SEPAKUAN;157;53;14;2;85;1;0;2;0;157;0;JUNI
3491;SULAWESI BARAT;MAMASA;BALLA;PIDARA;65;27;7;0;29;1;0;1;0;65;0;JUNI
3492;SULAWESI BARAT;MAMASA;BALLA;BAMBAPUANG;63;29;15;0;19;0;0;0;0;63;0;JUNI
3493;SULAWESI BARAT;MAMASA;BALLA;BALLA TIMUR;35;7;3;0;22;1;0;2;0;35;0;JUNI
3494;SULAWESI BARAT;POLEWALI MANDAR;LIMBORO;LIMBORO;122;37;27;15;21;3;0;9;0;112;10;JUNI
3495;SULAWESI BARAT;POLEWALI MANDAR;LIMBORO;LEMBANG LEMBANG;222;95;44;30;35;5;0;13;0;222;0;JUNI
3496;SULAWESI BARAT;POLEWALI MANDAR;LIMBORO;TANDASURA;136;70;15;11;26;4;0;8;0;134;2;JUNI
3497;SULAWESI BARAT;POLEWALI MANDAR;LIMBORO;SAMASUNDU;142;47;48;9;25;6;0;7;0;142;0;JUNI
3498;SULAWESI BARAT;POLEWALI MANDAR;LIMBORO;NAPO;157;83;19;3;43;0;0;9;0;157;0;JUNI
3499;SULAWESI BARAT;POLEWALI MANDAR;LIMBORO;TODANG TODANG;37;16;15;4;2;0;0;0;0;37;0;JUNI
3500;SULAWESI BARAT;POLEWALI MANDAR;LIMBORO;PENDULANGAN;58;35;19;0;1;0;0;3;0;58;0;JUNI
3501;SULAWESI BARAT;POLEWALI MANDAR;LIMBORO;RENGGEANG;106;34;31;8;29;0;0;4;0;106;0;JUNI
3502;SULAWESI BARAT;POLEWALI MANDAR;LIMBORO;SALARRI;56;23;15;5;12;0;0;1;0;56;0;JUNI
3503;SULAWESI BARAT;POLEWALI MANDAR;LIMBORO;TANGAN BARU;80;29;11;1;34;0;0;5;0;80;0;JUNI
3504;SULAWESI BARAT;POLEWALI MANDAR;LIMBORO;PALECE;118;29;44;27;12;4;0;2;0;118;0;JUNI
3505;SULAWESI BARAT;MAMASA;ARALLE;ARALLE;108;42;53;2;7;1;0;3;0;108;0;JUNI
3506;SULAWESI BARAT;MAMASA;ARALLE;RALLE ANAK;35;7;19;0;6;0;0;3;0;35;0;JUNI
3507;SULAWESI BARAT;MAMASA;ARALLE;PANETEAN;70;49;19;1;1;0;0;0;0;70;0;JUNI
3508;SULAWESI BARAT;MAMASA;ARALLE;UHAILANU;68;18;29;0;12;3;0;5;0;67;1;JUNI
3509;SULAWESI BARAT;MAMASA;ARALLE;ARALLE UTARA;68;27;39;0;2;0;0;0;0;68;0;JUNI
3510;SULAWESI BARAT;MAMASA;ARALLE;UHAIDAHO;54;10;37;2;5;0;0;0;0;54;0;JUNI
3511;SULAWESI BARAT;MAMASA;ARALLE;BARURU;92;64;26;0;1;0;0;0;1;92;0;JUNI
3512;SULAWESI BARAT;MAMASA;ARALLE;RALLEANAK UTARA;40;17;19;0;3;0;0;1;0;40;0;JUNI
3513;SULAWESI BARAT;MAMASA;ARALLE;PAMOSEANG PANGGA;38;17;18;2;1;0;0;0;0;38;0;JUNI
3514;SULAWESI BARAT;MAMASA;ARALLE;KALABE;64;24;38;0;2;0;0;0;0;64;0;JUNI
3515;SULAWESI BARAT;MAMASA;ARALLE;ARALLE SELATAN;31;10;18;0;2;0;0;1;0;31;0;JUNI
3516;SULAWESI BARAT;MAMASA;ARALLE;HAHANGAN;36;15;15;0;6;0;0;0;0;36;0;JUNI
3517;SULAWESI BARAT;POLEWALI MANDAR;CAMPALAGIAN;PAPPANG;151;83;14;12;8;6;0;13;1;137;14;JUNI
3518;SULAWESI BARAT;POLEWALI MANDAR;CAMPALAGIAN;LALIKO;178;109;40;4;6;3;0;16;0;178;0;JUNI
3519;SULAWESI BARAT;POLEWALI MANDAR;CAMPALAGIAN;BONDE;170;95;35;5;12;11;0;12;0;170;0;JUNI
3520;SULAWESI BARAT;POLEWALI MANDAR;CAMPALAGIAN;KATUMBANGAN LEMO;157;86;38;12;15;4;0;2;0;157;0;JUNI
3521;SULAWESI BARAT;POLEWALI MANDAR;CAMPALAGIAN;PANYAMPA;217;126;57;5;12;3;0;11;2;216;1;JUNI
3522;SULAWESI BARAT;POLEWALI MANDAR;CAMPALAGIAN;SURUANG;163;85;42;12;11;1;0;7;0;158;5;JUNI
3523;SULAWESI BARAT;POLEWALI MANDAR;CAMPALAGIAN;LAMPOKO;244;147;69;11;8;2;0;7;0;244;0;JUNI
3524;SULAWESI BARAT;POLEWALI MANDAR;CAMPALAGIAN;KATUMBANGAN;284;120;38;10;64;39;0;13;0;284;0;JUNI
3525;SULAWESI BARAT;POLEWALI MANDAR;CAMPALAGIAN;LAPEO;121;71;19;5;12;2;0;11;0;120;1;JUNI
3526;SULAWESI BARAT;POLEWALI MANDAR;CAMPALAGIAN;PARAPPE;267;157;63;4;36;3;0;2;0;265;2;JUNI
3527;SULAWESI BARAT;POLEWALI MANDAR;CAMPALAGIAN;ONGKO;92;26;13;9;34;7;0;3;0;92;0;JUNI
3528;SULAWESI BARAT;POLEWALI MANDAR;CAMPALAGIAN;KENJE;151;104;11;8;19;3;0;6;0;151;0;JUNI
3529;SULAWESI BARAT;POLEWALI MANDAR;CAMPALAGIAN;SUMARRANG;449;244;130;5;64;6;0;0;0;449;0;JUNI
3530;SULAWESI BARAT;POLEWALI MANDAR;CAMPALAGIAN;BOTTO;245;117;58;0;58;3;0;7;0;243;2;JUNI
3531;SULAWESI BARAT;POLEWALI MANDAR;CAMPALAGIAN;GATTUNGAN;164;52;25;17;45;15;0;9;0;163;1;JUNI
3532;SULAWESI BARAT;POLEWALI MANDAR;CAMPALAGIAN;PADANG TIMUR;135;62;26;3;37;2;0;5;0;135;0;JUNI
3533;SULAWESI BARAT;POLEWALI MANDAR;CAMPALAGIAN;PADANG;77;44;10;4;13;0;0;1;0;72;5;JUNI
3534;SULAWESI BARAT;POLEWALI MANDAR;CAMPALAGIAN;LAGI-AGI;226;161;29;3;21;2;0;10;0;226;0;JUNI
3535;SULAWESI BARAT;MAMUJU;PAPALANG;TOABO;655;284;151;4;201;8;0;5;1;654;1;JUNI
3536;SULAWESI BARAT;MAMUJU;PAPALANG;PAPALANG;697;324;180;8;141;3;0;5;0;661;36;JUNI
3537;SULAWESI BARAT;MAMUJU;PAPALANG;BONDA;316;173;89;2;49;1;0;1;0;315;1;JUNI
3538;SULAWESI BARAT;MAMUJU;PAPALANG;TOPORE;201;107;43;7;35;1;0;2;0;195;6;JUNI
3539;SULAWESI BARAT;MAMUJU;PAPALANG;SALUKAYU;256;128;86;2;31;3;0;6;0;256;0;JUNI
3540;SULAWESI BARAT;MAMUJU;PAPALANG;SUKADAMAI;109;55;37;0;13;0;0;4;0;109;0;JUNI
3541;SULAWESI BARAT;MAMUJU;PAPALANG;BODA-BODA;187;104;61;1;18;1;0;1;0;186;1;JUNI
3542;SULAWESI BARAT;MAMUJU;PAPALANG;SISANGO;108;37;60;0;5;3;0;2;0;107;1;JUNI
3543;SULAWESI BARAT;MAMUJU;PAPALANG;BATU AMPA;158;48;82;12;16;0;0;0;0;158;0;JUNI
3544;SULAWESI BARAT;PASANGKAYU;TIKKE RAYA;TIKKE;317;93;54;4;103;41;0;12;0;307;10;JUNI
3545;SULAWESI BARAT;PASANGKAYU;TIKKE RAYA;MAKMUR JAYA;478;187;117;5;122;24;0;19;1;475;3;JUNI
3546;SULAWESI BARAT;PASANGKAYU;TIKKE RAYA;LARIANG;445;175;76;3;162;16;0;10;0;442;3;JUNI
3547;SULAWESI BARAT;PASANGKAYU;TIKKE RAYA;PAJALELE;399;168;77;1;108;24;1;16;1;396;3;JUNI
3548;SULAWESI BARAT;PASANGKAYU;TIKKE RAYA;JENGENG RAYA;217;75;46;7;63;19;0;7;0;217;0;JUNI
3549;SULAWESI BARAT;MAMASA;BAMBANG;MOKALLANG;41;16;21;0;3;0;0;1;0;41;0;JUNI
3550;SULAWESI BARAT;MAMASA;BAMBANG;MASOSO;44;19;12;0;13;0;0;0;0;44;0;JUNI
3551;SULAWESI BARAT;MAMASA;BAMBANG;SALUASSING;125;91;21;4;8;0;0;1;0;125;0;JUNI
3552;SULAWESI BARAT;MAMASA;BAMBANG;SALUBULO;60;26;15;0;14;1;0;0;0;56;4;JUNI
3553;SULAWESI BARAT;MAMASA;BAMBANG;SALUKADI;78;34;35;0;9;0;0;0;0;78;0;JUNI
3554;SULAWESI BARAT;MAMASA;BAMBANG;SALUKEPOPOK;107;55;18;7;25;1;0;0;0;106;1;JUNI
3555;SULAWESI BARAT;MAMASA;BAMBANG;ULUMAMBI BARAT;62;26;36;0;0;0;0;0;0;62;0;JUNI
3556;SULAWESI BARAT;MAMASA;BAMBANG;LIMBADEBATA;107;34;12;0;57;1;0;3;0;107;0;JUNI
3557;SULAWESI BARAT;MAMASA;BAMBANG;TANETE TOMBA;58;27;28;0;3;0;0;0;0;58;0;JUNI
3558;SULAWESI BARAT;MAMASA;BAMBANG;BAMBANG;133;85;17;0;24;3;0;3;0;132;1;JUNI
3559;SULAWESI BARAT;MAMASA;BAMBANG;RANTELEMO;53;11;24;0;16;2;0;0;0;53;0;JUNI
3560;SULAWESI BARAT;MAMASA;BAMBANG;SALUDENGEN;37;7;24;0;2;1;0;0;0;34;3;JUNI
3561;SULAWESI BARAT;MAMASA;BAMBANG;ULUMAMBI;66;10;48;1;0;0;0;0;0;59;7;JUNI
3562;SULAWESI BARAT;MAMASA;BAMBANG;BAMBANG TIMUR;72;46;22;0;2;1;0;1;0;72;0;JUNI
3563;SULAWESI BARAT;MAMASA;BAMBANG;MINANGA;135;42;50;0;38;1;0;4;0;135;0;JUNI
3564;SULAWESI BARAT;MAMASA;BAMBANG;SIKAMASE;55;20;34;0;1;0;0;0;0;55;0;JUNI
3565;SULAWESI BARAT;MAMASA;BAMBANG;RANTETARIMA;32;3;29;0;0;0;0;0;0;32;0;JUNI
3566;SULAWESI BARAT;MAMASA;BAMBANG;SALURURU;31;3;2;3;22;0;0;1;0;31;0;JUNI
3567;SULAWESI BARAT;MAMASA;BAMBANG;SALUTABANG;36;18;13;1;1;2;0;1;0;36;0;JUNI
3568;SULAWESI BARAT;MAMASA;BAMBANG;BALATANA;52;34;18;0;0;0;0;0;0;52;0;JUNI
3569;SULAWESI BARAT;MAMASA;BUNTUMALANGKA;BUNTUMALANGKA;132;26;69;2;25;4;0;5;0;131;1;JUNI
3570;SULAWESI BARAT;MAMASA;BUNTUMALANGKA;RANTEBERAN;123;54;62;0;6;0;0;1;0;123;0;JUNI
3571;SULAWESI BARAT;MAMASA;BUNTUMALANGKA;KEBANGA;46;9;24;0;12;0;0;0;1;46;0;JUNI
3572;SULAWESI BARAT;MAMASA;BUNTUMALANGKA;SALURINDU;53;27;16;1;7;0;0;2;0;53;0;JUNI
3573;SULAWESI BARAT;MAMASA;BUNTUMALANGKA;TAORA;49;12;33;0;2;0;0;2;0;49;0;JUNI
3574;SULAWESI BARAT;MAMASA;BUNTUMALANGKA;KABAE;74;10;59;0;4;0;0;1;0;74;0;JUNI
3575;SULAWESI BARAT;MAMASA;BUNTUMALANGKA;SALUTAMBUN BARAT;65;26;36;1;2;0;0;0;0;65;0;JUNI
3576;SULAWESI BARAT;MAMASA;BUNTUMALANGKA;PENATANGAN;123;48;48;0;18;2;1;1;1;119;4;JUNI
3577;SULAWESI BARAT;MAMASA;BUNTUMALANGKA;SALUTAMBUN TIMUR;50;18;30;0;1;0;0;1;0;50;0;JUNI
3578;SULAWESI BARAT;MAMASA;BUNTUMALANGKA;SALUTAMBUN;37;9;22;0;2;2;0;2;0;37;0;JUNI
3579;SULAWESI BARAT;MAMASA;BUNTUMALANGKA;ARALLE TIMUR;104;28;66;0;3;0;0;1;0;98;6;JUNI
3580;SULAWESI BARAT;MAMASA;NOSU;NOSU;80;6;37;1;22;7;0;5;0;78;2;JUNI
3581;SULAWESI BARAT;MAMASA;NOSU;MINANGA;26;4;12;1;8;0;0;1;0;26;0;JUNI
3582;SULAWESI BARAT;MAMASA;NOSU;BATUPAPAN;53;18;18;1;15;1;0;0;0;53;0;JUNI
3583;SULAWESI BARAT;MAMASA;NOSU;MASEWWE;25;8;3;0;14;0;0;0;0;25;0;JUNI
3584;SULAWESI BARAT;MAMASA;NOSU;SIWI;25;9;6;1;7;1;0;1;0;25;0;JUNI
3585;SULAWESI BARAT;MAMASA;NOSU;MINANGA TIMUR;10;2;2;0;6;0;0;0;0;10;0;JUNI
3586;SULAWESI BARAT;MAMASA;NOSU;PARINDING;23;2;16;0;5;0;0;0;0;23;0;JUNI
3587;SULAWESI BARAT;MAMASA;MAMBI;MAMBI;77;44;21;2;9;1;0;0;0;77;0;JUNI
3588;SULAWESI BARAT;MAMASA;MAMBI;TALIPUKKI;122;91;11;4;10;2;0;3;0;121;1;JUNI
3589;SULAWESI BARAT;MAMASA;MAMBI;RANTEBULAHAN;56;17;30;0;6;1;0;1;0;55;1;JUNI
3590;SULAWESI BARAT;MAMASA;MAMBI;SONDONGLAYU;36;16;5;3;7;0;0;5;0;36;0;JUNI
3591;SULAWESI BARAT;MAMASA;MAMBI;SALUBANUA;37;15;19;0;2;0;0;0;0;36;1;JUNI
3592;SULAWESI BARAT;MAMASA;MAMBI;TAPALINA;109;72;30;6;0;0;0;0;0;108;1;JUNI
3593;SULAWESI BARAT;MAMASA;MAMBI;SENDANA;149;61;70;3;15;0;0;0;0;149;0;JUNI
3594;SULAWESI BARAT;MAMASA;MAMBI;PAMOSEAN;50;40;9;1;0;0;0;0;0;50;0;JUNI
3595;SULAWESI BARAT;MAMASA;MAMBI;SELUMAKA;125;31;94;0;0;0;0;0;0;125;0;JUNI
3596;SULAWESI BARAT;MAMASA;MAMBI;BUJUNG MANURUNG;43;22;17;1;2;1;0;0;0;43;0;JUNI
3597;SULAWESI BARAT;MAMASA;MAMBI;SALU ALO;85;29;49;0;7;0;0;0;0;85;0;JUNI
3598;SULAWESI BARAT;MAMASA;MAMBI;INDOBANUA;27;10;10;0;1;6;0;0;0;27;0;JUNI
3599;SULAWESI BARAT;MAMASA;MAMBI;SALUDURIAN;91;28;53;0;8;1;0;1;0;91;0;JUNI
3600;SULAWESI BARAT;MAMASA;MEHALAAN;MEHALAAN;55;21;17;1;14;0;0;2;0;55;0;JUNI
3601;SULAWESI BARAT;MAMASA;MEHALAAN;BOTTENG;71;32;13;0;24;0;1;1;0;71;0;JUNI
3602;SULAWESI BARAT;MAMASA;MEHALAAN;SALUKONTA;52;26;8;1;16;0;0;1;0;52;0;JUNI
3603;SULAWESI BARAT;MAMASA;MEHALAAN;MESAKADA;58;16;22;1;19;0;0;0;0;58;0;JUNI
3604;SULAWESI BARAT;MAMASA;MEHALAAN;MEHALAAN BARAT;93;35;25;0;30;0;0;3;0;93;0;JUNI
3605;SULAWESI BARAT;MAMASA;MEHALAAN;SALUAHOK;71;23;23;2;19;0;0;4;0;71;0;JUNI
3606;SULAWESI BARAT;MAMASA;MEHALAAN;SALUBALO;44;24;13;0;7;0;0;0;0;44;0;JUNI
3607;SULAWESI BARAT;MAMASA;MEHALAAN;PASSEMBUK;42;19;12;0;11;0;0;0;0;42;0;JUNI
3608;SULAWESI BARAT;MAMASA;MEHALAAN;KONDO;34;17;9;0;7;0;0;1;0;34;0;JUNI
3609;SULAWESI BARAT;MAMASA;MEHALAAN;LEKO SUKAMAJU;32;13;10;0;8;0;0;1;0;32;0;JUNI
3610;SULAWESI BARAT;MAMASA;MEHALAAN;ULUMEA;27;14;4;0;9;0;0;0;0;27;0;JUNI
3611;SULAWESI BARAT;PASANGKAYU;SARJO;SARJO;297;87;54;34;64;12;0;44;1;296;1;JUNI
3612;SULAWESI BARAT;PASANGKAYU;SARJO;MAPONU;137;46;29;0;45;10;0;4;2;136;1;JUNI
3613;SULAWESI BARAT;PASANGKAYU;SARJO;LETAWA;221;91;22;15;65;10;1;17;0;221;0;JUNI
3614;SULAWESI BARAT;PASANGKAYU;SARJO;SARUDE;247;57;49;27;76;13;0;24;0;246;1;JUNI
3615;SULAWESI BARAT;PASANGKAYU;SARUDU;SARUDU;407;232;64;4;78;13;1;13;0;405;2;JUNI
3616;SULAWESI BARAT;PASANGKAYU;SARUDU;BULU MARIO;330;110;56;24;97;26;0;17;0;330;0;JUNI
3617;SULAWESI BARAT;PASANGKAYU;SARUDU;KUMASARI;266;124;47;4;74;9;0;6;1;265;1;JUNI
3618;SULAWESI BARAT;PASANGKAYU;SARUDU;PATIKA;65;20;19;0;12;3;0;6;0;60;5;JUNI
3619;SULAWESI BARAT;PASANGKAYU;SARUDU;DODA;283;133;61;3;80;3;0;3;0;283;0;JUNI
3620;SULAWESI BARAT;POLEWALI MANDAR;ANREAPI;ANREAPI;166;37;48;6;47;11;0;14;1;164;2;JUNI
3621;SULAWESI BARAT;POLEWALI MANDAR;ANREAPI;DUAMPANUA;398;118;141;22;89;5;0;17;0;392;6;JUNI
3622;SULAWESI BARAT;POLEWALI MANDAR;ANREAPI;KELAPA DUA;273;72;123;3;55;3;2;14;0;272;1;JUNI
3623;SULAWESI BARAT;POLEWALI MANDAR;ANREAPI;PAPPANDANGAN;248;88;70;10;66;2;3;8;0;247;1;JUNI
3624;SULAWESI BARAT;POLEWALI MANDAR;ANREAPI;KUNYI;241;38;109;4;67;4;0;11;1;234;7;JUNI
3625;SULAWESI BARAT;MAMUJU;TOMMO;TOMMO;352;128;78;1;129;6;0;10;0;352;0;JUNI
3626;SULAWESI BARAT;MAMUJU;TOMMO;CAMPALOGA;294;84;124;11;63;7;0;1;0;290;4;JUNI
3627;SULAWESI BARAT;MAMUJU;TOMMO;BUANA SAKTI;213;82;47;1;82;1;0;0;0;213;0;JUNI
3628;SULAWESI BARAT;MAMUJU;TOMMO;TAMEMONGGA;226;80;108;0;33;2;0;3;0;226;0;JUNI
3629;SULAWESI BARAT;MAMUJU;TOMMO;TAMEJARRA;200;65;59;6;50;7;1;12;0;200;0;JUNI
3630;SULAWESI BARAT;MAMUJU;TOMMO;RANTEMARIO;161;64;64;3;19;6;0;5;0;161;0;JUNI
3631;SULAWESI BARAT;MAMUJU;TOMMO;MALINO;75;42;19;6;4;1;0;2;0;74;1;JUNI
3632;SULAWESI BARAT;MAMUJU;TOMMO;KAKULLASANG;366;147;141;7;57;1;0;6;2;361;5;JUNI
3633;SULAWESI BARAT;MAMUJU;TOMMO;LELING;133;37;66;0;28;0;0;2;0;133;0;JUNI
3634;SULAWESI BARAT;MAMUJU;TOMMO;KALEPU;110;48;56;1;4;1;0;0;0;110;0;JUNI
3635;SULAWESI BARAT;MAMUJU;TOMMO;SANDANA;132;51;50;1;18;2;0;9;1;132;0;JUNI
3636;SULAWESI BARAT;MAMUJU;TOMMO;LELING BARAT;204;62;86;1;45;6;0;3;0;203;1;JUNI
3637;SULAWESI BARAT;MAMUJU;TOMMO;LELING UTARA;194;76;96;0;22;0;0;0;0;194;0;JUNI
3638;SULAWESI BARAT;MAMUJU;TOMMO;SALUDENGEN;132;67;58;0;6;0;0;1;0;132;0;JUNI
3639;SULAWESI BARAT;POLEWALI MANDAR;BALANIPA;BALANIPA;194;87;38;14;36;9;0;10;0;194;0;JUNI
3640;SULAWESI BARAT;POLEWALI MANDAR;BALANIPA;TAMMAJARRA;184;124;14;24;15;4;0;3;0;184;0;JUNI
3641;SULAWESI BARAT;POLEWALI MANDAR;BALANIPA;TAMANGGALLE;110;59;20;0;28;1;0;1;1;110;0;JUNI
3642;SULAWESI BARAT;POLEWALI MANDAR;BALANIPA;MOSSO;81;55;17;4;4;0;0;1;0;81;0;JUNI
3643;SULAWESI BARAT;POLEWALI MANDAR;BALANIPA;GALUNG TULUK;201;107;43;20;19;1;0;11;0;201;0;JUNI
3644;SULAWESI BARAT;POLEWALI MANDAR;BALANIPA;SABANG SUBIK;198;113;28;10;24;5;0;18;0;198;0;JUNI
3645;SULAWESI BARAT;POLEWALI MANDAR;BALANIPA;PAMBUSUANG;431;245;70;12;35;12;1;28;1;404;27;JUNI
3646;SULAWESI BARAT;POLEWALI MANDAR;BALANIPA;BALA;334;253;29;3;19;5;0;22;0;331;3;JUNI
3647;SULAWESI BARAT;POLEWALI MANDAR;BALANIPA;LAMBANAN;17;6;4;4;2;0;0;1;0;17;0;JUNI
3648;SULAWESI BARAT;POLEWALI MANDAR;BALANIPA;LEGO;107;68;25;0;6;0;0;8;0;107;0;JUNI
3649;SULAWESI BARAT;POLEWALI MANDAR;BALANIPA;PALLIS;27;12;8;1;4;1;0;1;0;27;0;JUNI
3650;SULAWESI BARAT;PASANGKAYU;PEDONGGA;MALEI;229;112;63;1;36;15;0;2;0;229;0;JUNI
3651;SULAWESI BARAT;PASANGKAYU;PEDONGGA;PEDANDA;201;55;55;3;75;6;0;6;0;200;1;JUNI
3652;SULAWESI BARAT;PASANGKAYU;PEDONGGA;BATU OGE;147;63;28;2;46;7;0;1;0;147;0;JUNI
3653;SULAWESI BARAT;PASANGKAYU;PEDONGGA;MARTASARI;571;216;68;7;245;21;0;12;0;569;2;JUNI
3654;SULAWESI BARAT;PASANGKAYU;DAPURANG;DAPURANG;413;229;66;5;79;20;1;6;0;406;7;JUNI
3655;SULAWESI BARAT;PASANGKAYU;DAPURANG;BENGGAULU;283;119;77;0;67;6;0;14;0;283;0;JUNI
3656;SULAWESI BARAT;PASANGKAYU;DAPURANG;TIRTABUANA;147;88;15;2;35;2;0;5;0;147;0;JUNI
3657;SULAWESI BARAT;PASANGKAYU;DAPURANG;BULU BONGGU;246;68;40;3;119;6;0;4;0;240;6;JUNI
3658;SULAWESI BARAT;PASANGKAYU;DAPURANG;SARASA;193;112;50;1;20;6;0;4;0;193;0;JUNI
3659;SULAWESI BARAT;MAMASA;TAWALIAN;TAWALIAN;246;113;41;0;74;8;0;8;0;244;2;JUNI
3660;SULAWESI BARAT;MAMASA;TAWALIAN;TAWALIAN TIMUR;169;67;49;2;48;1;0;1;0;168;1;JUNI
3661;SULAWESI BARAT;MAMASA;TAWALIAN;KARIANGO;204;77;51;0;76;0;0;0;0;204;0;JUNI
3662;SULAWESI BARAT;MAMASA;TAWALIAN;RANTETANGNGA;144;24;39;5;68;4;0;3;0;143;1;JUNI
3663;SULAWESI BARAT;MAMASA;TABULAHAN;LAKAHANG;272;88;160;2;11;3;1;7;0;272;0;JUNI
3664;SULAWESI BARAT;MAMASA;TABULAHAN;PERIANGAN;68;17;49;0;2;0;0;0;0;68;0;JUNI
3665;SULAWESI BARAT;MAMASA;TABULAHAN;MALATIRO;141;54;80;0;2;0;0;2;0;138;3;JUNI
3666;SULAWESI BARAT;MAMASA;TABULAHAN;TABULAHAN;58;18;36;0;1;1;0;2;0;58;0;JUNI
3667;SULAWESI BARAT;MAMASA;TABULAHAN;SALULEANG;35;12;22;0;1;0;0;0;0;35;0;JUNI
3668;SULAWESI BARAT;MAMASA;TABULAHAN;TAMPAK KURRA;176;49;120;1;4;0;1;1;0;176;0;JUNI
3669;SULAWESI BARAT;MAMASA;TABULAHAN;GANDANG DEWATA;36;13;19;0;4;0;0;0;0;36;0;JUNI
3670;SULAWESI BARAT;MAMASA;TABULAHAN;BURANA;98;26;66;0;4;0;1;1;0;98;0;JUNI
3671;SULAWESI BARAT;MAMASA;TABULAHAN;SALUBAKKA;100;59;39;0;0;0;0;2;0;100;0;JUNI
3672;SULAWESI BARAT;MAMASA;TABULAHAN;PANGANDARAN;134;46;84;0;4;0;0;0;0;134;0;JUNI
3673;SULAWESI BARAT;MAMASA;TABULAHAN;TALOPAK;54;17;31;0;6;0;0;0;0;54;0;JUNI
3674;SULAWESI BARAT;MAMASA;TABULAHAN;PEU';50;17;33;0;0;0;0;0;0;50;0;JUNI
3675;SULAWESI BARAT;MAMASA;TABULAHAN;TIMORO;43;12;22;0;6;1;0;2;0;43;0;JUNI
3676;SULAWESI BARAT;MAMASA;TABULAHAN;LAKAHANG UTAMA;76;26;44;0;2;0;0;3;0;75;1;JUNI
3677;SULAWESI BARAT;MAMASA;TABANG;TABANG;87;32;24;1;9;20;0;1;0;87;0;JUNI
3678;SULAWESI BARAT;MAMASA;TABANG;TADOKALUA;92;36;27;1;19;1;0;3;0;87;5;JUNI
3679;SULAWESI BARAT;MAMASA;TABANG;TABANG BARAT;164;71;52;1;37;2;0;0;1;164;0;JUNI
3680;SULAWESI BARAT;MAMASA;TABANG;MASUPU;79;11;63;0;4;0;0;0;1;79;0;JUNI
3681;SULAWESI BARAT;MAMASA;TABANG;KALAMA;69;11;24;0;20;3;0;1;0;59;10;JUNI
3682;SULAWESI BARAT;MAMASA;TABANG;BAKADISURA;98;20;60;0;16;1;0;1;0;98;0;JUNI
3683;SULAWESI BARAT;MAMASA;TABANG;SALUKONA;100;44;47;0;8;1;0;0;0;100;0;JUNI
3684;SULAWESI BARAT;MAJENE;TAMMERODO SENDANA;SEPPONG;148;82;38;4;14;6;0;4;0;148;0;JUNI
3685;SULAWESI BARAT;MAJENE;TAMMERODO SENDANA;TAMMERODO;154;72;29;2;13;23;3;10;0;152;2;JUNI
3686;SULAWESI BARAT;MAJENE;TAMMERODO SENDANA;ULIDANG;180;102;31;3;20;8;2;14;0;180;0;JUNI
3687;SULAWESI BARAT;MAJENE;TAMMERODO SENDANA;TALLAMBALAO;178;85;61;2;7;3;0;20;0;178;0;JUNI
3688;SULAWESI BARAT;MAJENE;TAMMERODO SENDANA;TAMMERODO UTARA;192;96;41;6;15;25;0;9;0;192;0;JUNI
3689;SULAWESI BARAT;MAJENE;TAMMERODO SENDANA;MANYAMBA;168;107;27;0;24;5;0;4;0;167;1;JUNI
3690;SULAWESI BARAT;MAJENE;TAMMERODO SENDANA;AWO;165;90;38;0;8;9;6;10;0;161;4;JUNI
3691;SULAWESI BARAT;MAJENE;TUBO SENDANA;ONANG;332;102;59;17;120;7;14;11;0;330;2;JUNI
3692;SULAWESI BARAT;MAJENE;TUBO SENDANA;TUBO;92;16;14;37;7;13;1;4;0;92;0;JUNI
3693;SULAWESI BARAT;MAJENE;TUBO SENDANA;ONANG UTARA;101;26;20;3;35;11;4;2;0;101;0;JUNI
3694;SULAWESI BARAT;MAJENE;TUBO SENDANA;TUBO SELATAN;103;34;19;1;28;14;2;5;0;103;0;JUNI
3695;SULAWESI BARAT;MAJENE;TUBO SENDANA;BONDE BONDE;90;22;13;8;21;15;6;5;0;90;0;JUNI
3696;SULAWESI BARAT;MAJENE;TUBO SENDANA;TUBO TENGAH;96;24;26;5;16;15;1;9;0;96;0;JUNI
3697;SULAWESI BARAT;MAJENE;TUBO SENDANA;TUBO POANG;90;35;32;8;8;2;0;5;0;90;0;JUNI
3698;SULAWESI BARAT;PASANGKAYU;DURIPOKU;TAMMARUNANG;200;71;45;13;54;6;0;11;0;200;0;JUNI
3699;SULAWESI BARAT;PASANGKAYU;DURIPOKU;SAPTANAJAYA;206;116;39;1;36;10;0;4;0;206;0;JUNI
3700;SULAWESI BARAT;PASANGKAYU;DURIPOKU;TARANGGI;93;15;23;6;40;8;0;1;0;93;0;JUNI
3701;SULAWESI BARAT;PASANGKAYU;DURIPOKU;SIPAKAINGA;84;42;27;1;12;2;0;0;0;84;0;JUNI
3702;SULAWESI BARAT;MAJENE;MALUNDA;MALUNDA;151;53;41;15;22;12;3;5;0;151;0;JUNI
3703;SULAWESI BARAT;MAJENE;MALUNDA;LAMUNGANG BATU;127;46;45;1;19;3;0;12;0;126;1;JUNI
3704;SULAWESI BARAT;MAJENE;MALUNDA;BAMBANGAN;160;84;43;2;28;2;0;1;0;160;0;JUNI
3705;SULAWESI BARAT;MAJENE;MALUNDA;LOMBANG;92;47;21;1;20;1;0;2;0;92;0;JUNI
3706;SULAWESI BARAT;MAJENE;MALUNDA;LOMBONG;226;64;99;7;28;6;0;20;0;224;2;JUNI
3707;SULAWESI BARAT;MAJENE;MALUNDA;MEKKATTA;219;103;28;10;59;5;0;8;0;213;6;JUNI
3708;SULAWESI BARAT;MAJENE;MALUNDA;MALIAYA;150;69;31;6;34;3;0;6;0;149;1;JUNI
3709;SULAWESI BARAT;MAJENE;MALUNDA;LOMBANG TIMUR;157;99;48;1;8;1;0;0;0;157;0;JUNI
3710;SULAWESI BARAT;MAJENE;MALUNDA;SALUTAHONGAN;95;60;26;0;6;1;0;1;0;94;1;JUNI
3711;SULAWESI BARAT;MAJENE;MALUNDA;LOMBONG TIMUR;99;16;30;10;4;20;0;19;0;99;0;JUNI
3712;SULAWESI BARAT;MAJENE;MALUNDA;MEKKATTA SELATAN;123;41;30;4;33;7;0;6;1;122;1;JUNI
3713;SULAWESI BARAT;MAJENE;MALUNDA;KAYUANGIN;161;85;33;8;10;10;0;12;0;158;3;JUNI
3714;SULAWESI BARAT;MAMASA;TANDUK KALUA;MINAKE;82;25;6;2;45;2;0;2;0;82;0;JUNI
3715;SULAWESI BARAT;MAMASA;TANDUK KALUA;MALABO;51;24;11;0;6;7;0;3;0;51;0;JUNI
3716;SULAWESI BARAT;MAMASA;TANDUK KALUA;SINDAGAMANIK;142;79;19;1;41;1;0;1;0;142;0;JUNI
3717;SULAWESI BARAT;MAMASA;TANDUK KALUA;PARONDOBULAWAN;107;71;9;1;22;1;0;3;0;107;0;JUNI
3718;SULAWESI BARAT;MAMASA;TANDUK KALUA;TAMALANTIK;158;66;54;0;30;4;0;1;1;156;2;JUNI
3719;SULAWESI BARAT;MAMASA;TANDUK KALUA;MANNABABA;69;29;2;0;38;0;0;0;0;69;0;JUNI
3720;SULAWESI BARAT;MAMASA;TANDUK KALUA;MESAKADA;123;52;28;0;43;0;0;0;0;123;0;JUNI
3721;SULAWESI BARAT;MAMASA;TANDUK KALUA;BALLABATU;146;22;15;0;106;2;0;1;0;146;0;JUNI
3722;SULAWESI BARAT;MAMASA;TANDUK KALUA;PAMBE;86;21;19;1;42;2;1;0;0;86;0;JUNI
3723;SULAWESI BARAT;MAMASA;TANDUK KALUA;SALURANO;72;30;13;0;28;1;0;0;0;72;0;JUNI
3724;SULAWESI BARAT;MAMASA;TANDUK KALUA;TALIMBUNG;91;47;38;0;5;0;0;1;0;91;0;JUNI
3725;SULAWESI BARAT;MAMASA;TANDUK KALUA;KANAN;114;43;25;0;35;8;0;1;0;112;2;JUNI
3726;SULAWESI BARAT;MAMUJU TENGAH;PANGALE;POLO PANGALE;241;56;61;8;106;5;0;3;0;239;2;JUNI
3727;SULAWESI BARAT;MAMUJU TENGAH;PANGALE;PANGALE;225;58;92;12;47;5;1;10;0;225;0;JUNI
3728;SULAWESI BARAT;MAMUJU TENGAH;PANGALE;SARTANAMAJU;86;32;19;11;15;4;0;5;0;86;0;JUNI
3729;SULAWESI BARAT;MAMUJU TENGAH;PANGALE;POLO LERENG;224;67;54;6;85;4;0;4;0;220;4;JUNI
3730;SULAWESI BARAT;MAMUJU TENGAH;PANGALE;KUO;434;210;66;3;131;14;0;8;2;434;0;JUNI
3731;SULAWESI BARAT;MAMUJU TENGAH;PANGALE;POLO CAMBA;149;52;47;10;34;1;0;2;3;149;0;JUNI
3732;SULAWESI BARAT;MAMUJU TENGAH;PANGALE;LAMBA-LAMBA;129;44;35;4;42;2;0;2;0;129;0;JUNI
3733;SULAWESI BARAT;MAMUJU TENGAH;PANGALE;KOMBILING;234;72;54;8;85;3;0;9;0;231;3;JUNI
3734;SULAWESI BARAT;MAMUJU TENGAH;PANGALE;LEMO-LEMO;134;52;40;1;38;2;1;0;0;134;0;JUNI
3735;SULAWESI BARAT;PASANGKAYU;LARIANG;PARABU;137;31;21;9;38;21;0;9;0;129;8;JUNI
3736;SULAWESI BARAT;PASANGKAYU;LARIANG;KENANGAN;53;12;6;2;19;7;0;5;0;51;2;JUNI
3737;SULAWESI BARAT;PASANGKAYU;LARIANG;BAJAWALI;122;25;24;4;45;13;0;11;0;122;0;JUNI
3738;SULAWESI BARAT;PASANGKAYU;LARIANG;SINGGANI;184;75;53;0;35;9;0;9;0;181;3;JUNI
3739;SULAWESI BARAT;PASANGKAYU;LARIANG;KULU;105;32;36;0;25;9;0;2;0;104;1;JUNI
3740;SULAWESI BARAT;PASANGKAYU;LARIANG;BATU MATORU;94;33;21;0;23;7;0;10;0;94;0;JUNI
3741;SULAWESI BARAT;PASANGKAYU;LARIANG;BAMBAKORO;152;58;31;1;44;10;0;8;0;152;0;JUNI
3742;SULAWESI BARAT;MAMASA;SESENAPADANG;OROBUA;203;37;18;3;118;15;0;5;3;199;4;JUNI
3743;SULAWESI BARAT;MAMASA;SESENAPADANG;PALADAN;65;10;7;0;44;1;0;0;0;62;3;JUNI
3744;SULAWESI BARAT;MAMASA;SESENAPADANG;OROBUA TIMUR;37;14;7;0;14;1;0;1;0;37;0;JUNI
3745;SULAWESI BARAT;MAMASA;SESENAPADANG;RANTE PUANG;95;23;20;0;47;2;0;1;0;93;2;JUNI
3746;SULAWESI BARAT;MAMASA;SESENAPADANG;SATENETEAN;46;6;23;0;15;1;0;1;0;46;0;JUNI
3747;SULAWESI BARAT;MAMASA;SESENAPADANG;LISUAN ADA;66;32;10;0;24;0;0;0;0;66;0;JUNI
3748;SULAWESI BARAT;MAMASA;SESENAPADANG;OROBUA SELATAN;64;17;9;0;21;17;0;0;0;64;0;JUNI
3749;SULAWESI BARAT;MAMASA;SESENAPADANG;MALANGKENA PADANG;71;18;6;0;46;0;0;0;1;71;0;JUNI
3750;SULAWESI BARAT;MAMASA;SESENAPADANG;MALIMBONG;26;7;1;0;17;0;0;1;0;26;0;JUNI
3751;SULAWESI BARAT;MAMASA;SESENAPADANG;MARAMPAN OROBUA;41;15;3;1;13;8;0;0;0;40;1;JUNI
3752;SULAWESI BARAT;MAMASA;PANA;PANA;60;16;35;2;6;1;0;0;0;60;0;JUNI
3753;SULAWESI BARAT;MAMASA;PANA;MANIPI;122;61;45;3;10;1;0;1;0;121;1;JUNI
3754;SULAWESI BARAT;MAMASA;PANA;MAMULLU;63;11;40;0;10;1;0;1;0;63;0;JUNI
3755;SULAWESI BARAT;MAMASA;PANA;SAPAN;61;15;25;0;21;0;0;0;0;61;0;JUNI
3756;SULAWESI BARAT;MAMASA;PANA;DATUBARINGAN;79;27;42;0;10;0;0;0;0;79;0;JUNI
3757;SULAWESI BARAT;MAMASA;PANA;PANURA;60;15;40;0;5;0;0;0;0;60;0;JUNI
3758;SULAWESI BARAT;MAMASA;PANA;TALLANG BULAWAN;71;22;37;4;7;0;0;1;0;71;0;JUNI
3759;SULAWESI BARAT;MAMASA;PANA;KARAKA;65;23;35;0;6;0;0;1;0;65;0;JUNI
3760;SULAWESI BARAT;MAMASA;PANA;ULUSALU;51;4;47;0;0;0;0;0;0;51;0;JUNI
3761;SULAWESI BARAT;MAMASA;PANA;WERI;52;10;35;1;4;1;0;1;0;52;0;JUNI
3762;SULAWESI BARAT;MAMASA;PANA;SALUTAMBUN;47;1;46;0;0;0;0;0;0;47;0;JUNI
3763;SULAWESI BARAT;MAMASA;PANA;SALOAN;98;31;57;0;9;0;0;0;0;97;1;JUNI
3764;SULAWESI BARAT;MAMASA;PANA;ULUSALU INDAH;53;24;29;0;0;0;0;0;0;53;0;JUNI
3765;SULAWESI BARAT;MAMASA;RANTEBULAHAN TIMUR;SALUMOKANAN;93;42;15;0;29;6;0;1;0;93;0;JUNI
3766;SULAWESI BARAT;MAMASA;RANTEBULAHAN TIMUR;SALUMOKANAN BARAT;107;44;27;0;33;0;0;0;1;105;2;JUNI
3767;SULAWESI BARAT;MAMASA;RANTEBULAHAN TIMUR;BUANGIN;95;66;19;0;9;0;0;0;0;94;1;JUNI
3768;SULAWESI BARAT;MAMASA;RANTEBULAHAN TIMUR;BAMBANG BUDA;116;28;64;2;19;1;0;2;0;116;0;JUNI
3769;SULAWESI BARAT;MAMASA;RANTEBULAHAN TIMUR;LEKO;22;6;11;0;5;0;0;0;0;22;0;JUNI
3770;SULAWESI BARAT;MAMASA;RANTEBULAHAN TIMUR;KIRAK;74;48;20;0;6;0;0;0;0;74;0;JUNI
3771;SULAWESI BARAT;MAMASA;RANTEBULAHAN TIMUR;SALUMOKANAN UTARA;115;72;6;1;34;1;0;1;0;115;0;JUNI
3772;SULAWESI BARAT;MAMASA;RANTEBULAHAN TIMUR;SAMPALE;51;17;13;0;21;0;0;0;0;51;0;JUNI
3773;SULAWESI BARAT;MAMASA;SUMARORONG;SUMARORONG;145;47;38;6;34;7;0;11;0;143;2;JUNI
3774;SULAWESI BARAT;MAMASA;SUMARORONG;TABONE;94;27;37;0;29;0;0;1;0;94;0;JUNI
3775;SULAWESI BARAT;MAMASA;SUMARORONG;BATANG URU;98;34;48;0;13;2;0;1;0;98;0;JUNI
3776;SULAWESI BARAT;MAMASA;SUMARORONG;SASAKAN;159;51;87;1;12;7;0;0;0;158;1;JUNI
3777;SULAWESI BARAT;MAMASA;SUMARORONG;TADISI;54;14;33;0;7;0;0;0;0;54;0;JUNI
3778;SULAWESI BARAT;MAMASA;SUMARORONG;SIBANAWA;102;30;48;0;22;0;0;2;0;102;0;JUNI
3779;SULAWESI BARAT;MAMASA;SUMARORONG;BATANGNGURU TIMUR;107;34;67;0;6;0;0;0;0;107;0;JUNI
3780;SULAWESI BARAT;MAMASA;SUMARORONG;SALUBALO;124;51;45;0;26;0;0;2;0;124;0;JUNI
3781;SULAWESI BARAT;MAMASA;SUMARORONG;BANEA;66;21;35;0;7;1;0;2;0;66;0;JUNI
3782;SULAWESI BARAT;MAMASA;SUMARORONG;RANTE KAMASE;163;76;30;4;41;5;0;7;0;163;0;JUNI
3783;SULAWESI BARAT;PASANGKAYU;PASANGKAYU;PASANGKAYU;1500;633;377;28;152;231;24;50;0;1495;5;JUNI
3784;SULAWESI BARAT;PASANGKAYU;PASANGKAYU;MARTAJAYA;179;61;33;4;43;24;0;14;0;179;0;JUNI
3785;SULAWESI BARAT;PASANGKAYU;PASANGKAYU;PAKAVA;385;211;100;5;63;4;0;2;0;385;0;JUNI
3786;SULAWESI BARAT;PASANGKAYU;PASANGKAYU;KARYA BERSAMA;318;150;55;3;81;20;0;9;0;318;0;JUNI
3787;SULAWESI BARAT;PASANGKAYU;PASANGKAYU;AKO;431;202;85;3;75;42;0;14;0;421;10;JUNI
3788;SULAWESI BARAT;PASANGKAYU;PASANGKAYU;GUNUNG SARI;536;289;81;7;102;24;0;25;0;528;8;JUNI
3789;SULAWESI BARAT;MAJENE;ULUMANDA;KABIRAAN;143;92;18;1;27;1;0;4;0;143;0;JUNI
3790;SULAWESI BARAT;MAJENE;ULUMANDA;SAMBABO;93;46;15;2;27;0;0;1;0;91;2;JUNI
3791;SULAWESI BARAT;MAJENE;ULUMANDA;TANDEALLO;129;65;40;1;5;1;2;14;0;128;1;JUNI
3792;SULAWESI BARAT;MAJENE;ULUMANDA;ULUMANDA;145;45;74;3;7;4;1;11;0;145;0;JUNI
3793;SULAWESI BARAT;MAJENE;ULUMANDA;SALUTAMBUNG;114;77;19;2;12;0;0;4;0;114;0;JUNI
3794;SULAWESI BARAT;MAJENE;ULUMANDA;POPENGA;78;59;15;0;1;0;0;3;0;78;0;JUNI
3795;SULAWESI BARAT;MAJENE;ULUMANDA;SULAI;127;53;47;5;15;0;0;6;0;126;1;JUNI
3796;SULAWESI BARAT;MAJENE;ULUMANDA;PANGGALO;104;52;35;4;8;2;0;1;0;102;2;JUNI
3797;SULAWESI BARAT;POLEWALI MANDAR;ALLU;PETOOSANG;83;26;21;7;15;3;0;9;0;81;2;JUNI
3798;SULAWESI BARAT;POLEWALI MANDAR;ALLU;MOMBI;133;60;25;6;31;0;4;5;1;132;1;JUNI
3799;SULAWESI BARAT;POLEWALI MANDAR;ALLU;KALUMAMMANG;99;37;37;0;19;0;0;6;0;99;0;JUNI
3800;SULAWESI BARAT;POLEWALI MANDAR;ALLU;PAO-PAO;196;76;57;0;61;0;0;2;0;196;0;JUNI
3801;SULAWESI BARAT;POLEWALI MANDAR;ALLU;PUPPU URING;212;86;81;2;24;0;1;1;2;197;15;JUNI
3802;SULAWESI BARAT;POLEWALI MANDAR;ALLU;SARAGIAN;134;74;25;6;20;0;0;8;0;133;1;JUNI
3803;SULAWESI BARAT;POLEWALI MANDAR;ALLU;SAYOANG;51;24;18;0;6;1;0;2;0;51;0;JUNI
3804;SULAWESI BARAT;POLEWALI MANDAR;ALLU;ALU;123;51;39;11;19;1;0;2;0;123;0;JUNI
3805;SULAWESI BARAT;MAJENE;BANGGAE;BANGGAE;330;96;108;14;62;35;1;14;0;330;0;JUNI
3806;SULAWESI BARAT;MAJENE;BANGGAE;BARU;523;148;141;10;186;13;0;25;0;523;0;JUNI
3807;SULAWESI BARAT;MAJENE;BANGGAE;PANGALI ALI;836;306;216;12;206;59;2;32;0;833;3;JUNI
3808;SULAWESI BARAT;MAJENE;BANGGAE;TOTOLI;448;153;107;17;140;12;1;18;0;448;0;JUNI
3809;SULAWESI BARAT;MAJENE;BANGGAE;RANGAS;891;359;322;17;143;32;1;15;2;891;0;JUNI
3810;SULAWESI BARAT;MAJENE;BANGGAE;GALUNG;253;51;17;29;87;29;0;38;0;251;2;JUNI
3811;SULAWESI BARAT;MAJENE;BANGGAE;PALIPI SOREANG;233;105;38;19;54;11;0;6;0;233;0;JUNI
3812;SULAWESI BARAT;MAJENE;BANGGAE;PAMBOBORANG;233;39;72;12;82;5;0;22;0;232;1;JUNI
3813;SULAWESI BARAT;MAMASA;MESSAWA;MESSAWA;39;10;20;0;7;0;0;2;0;39;0;JUNI
3814;SULAWESI BARAT;MAMASA;MESSAWA;RIPPUNG;137;62;59;0;15;1;0;0;0;137;0;JUNI
3815;SULAWESI BARAT;MAMASA;MESSAWA;MAKUANG;106;57;32;1;16;0;0;0;0;106;0;JUNI
3816;SULAWESI BARAT;MAMASA;MESSAWA;SEPANG;73;36;34;0;3;0;0;0;0;73;0;JUNI
3817;SULAWESI BARAT;MAMASA;MESSAWA;MALIMBONG;56;18;34;0;4;0;0;0;0;56;0;JUNI
3818;SULAWESI BARAT;MAMASA;MESSAWA;MATANDE;84;16;54;6;7;1;0;0;0;84;0;JUNI
3819;SULAWESI BARAT;MAMASA;MESSAWA;SIPAI;82;37;36;0;9;0;0;0;0;82;0;JUNI
3820;SULAWESI BARAT;MAMASA;MESSAWA;PASMA MAMBU;49;14;24;0;11;0;0;0;0;49;0;JUNI
3821;SULAWESI BARAT;MAMASA;MESSAWA;TANETE BATU;55;28;23;0;3;0;0;1;0;55;0;JUNI
3822;SULAWESI BARAT;MAJENE;BANGGAE TIMUR;BAURUNG;524;244;74;26;160;10;1;8;1;524;0;JUNI
3823;SULAWESI BARAT;MAJENE;BANGGAE TIMUR;BARUGA;188;50;20;42;42;14;0;8;0;176;12;JUNI
3824;SULAWESI BARAT;MAJENE;BANGGAE TIMUR;BARUGA DHUA;180;58;41;36;41;2;0;1;0;179;1;JUNI
3825;SULAWESI BARAT;MAJENE;BANGGAE TIMUR;LABUANG;282;56;59;31;106;15;1;14;0;282;0;JUNI
3826;SULAWESI BARAT;MAJENE;BANGGAE TIMUR;TANDE;130;23;29;27;38;4;0;4;0;125;5;JUNI
3827;SULAWESI BARAT;MAJENE;BANGGAE TIMUR;LEMBANG;712;293;158;118;107;24;0;12;0;712;0;JUNI
3828;SULAWESI BARAT;MAJENE;BANGGAE TIMUR;LABUANG UTARA;301;82;76;18;67;32;1;23;0;299;2;JUNI
3829;SULAWESI BARAT;MAJENE;BANGGAE TIMUR;TANDE TIMUR;128;47;16;11;33;10;0;11;0;128;0;JUNI
3830;SULAWESI BARAT;MAJENE;BANGGAE TIMUR;BUTTU BARUGA;81;23;10;4;42;0;0;1;0;80;1;JUNI
3831;SULAWESI BARAT;MAJENE;PAMBOANG;LALAMPANUA;134;27;21;23;38;11;0;12;1;133;1;JUNI
3832;SULAWESI BARAT;MAJENE;PAMBOANG;SIRINDU;138;28;18;2;66;10;0;14;0;138;0;JUNI
3833;SULAWESI BARAT;MAJENE;PAMBOANG;ADOLANG;102;22;5;1;65;4;0;5;0;102;0;JUNI
3834;SULAWESI BARAT;MAJENE;PAMBOANG;BABABULO;189;97;24;8;46;6;1;7;0;189;0;JUNI
3835;SULAWESI BARAT;MAJENE;PAMBOANG;BONDE;232;134;53;4;16;8;1;14;0;230;2;JUNI
3836;SULAWESI BARAT;MAJENE;PAMBOANG;BETTENG;106;61;11;0;30;1;0;3;0;106;0;JUNI
3837;SULAWESI BARAT;MAJENE;PAMBOANG;SIMBANG;60;15;12;5;19;3;1;5;0;60;0;JUNI
3838;SULAWESI BARAT;MAJENE;PAMBOANG;BONDE UTARA;360;232;41;4;40;11;2;16;0;346;14;JUNI
3839;SULAWESI BARAT;MAJENE;PAMBOANG;BABABULO UTARA;109;59;18;11;11;3;0;7;0;109;0;JUNI
3840;SULAWESI BARAT;MAJENE;PAMBOANG;BUTTU PAMBOANG;99;47;15;3;24;4;0;6;0;99;0;JUNI
3841;SULAWESI BARAT;MAJENE;PAMBOANG;BANUA ADOLANG;87;28;25;0;26;5;0;3;0;87;0;JUNI
3842;SULAWESI BARAT;MAJENE;PAMBOANG;ADOLANG DHUA;104;40;6;2;43;0;1;8;0;100;4;JUNI
3843;SULAWESI BARAT;MAJENE;PAMBOANG;TINAMBUNG;179;39;43;17;54;5;0;21;0;179;0;JUNI
3844;SULAWESI BARAT;MAJENE;PAMBOANG;PESULOANG;97;30;7;8;37;1;3;11;0;97;0;JUNI
3845;SULAWESI BARAT;MAJENE;PAMBOANG;BALOMBONG;113;32;14;2;54;7;0;4;0;113;0;JUNI
3846;SULAWESI BARAT;MAJENE;SENDANA;MOSSO;336;149;88;5;60;21;1;10;1;335;1;JUNI
3847;SULAWESI BARAT;MAJENE;SENDANA;MOSSO DHUA;96;31;23;5;11;11;2;5;0;88;8;JUNI
3848;SULAWESI BARAT;MAJENE;SENDANA;TOTOLISI SENDANA;116;32;42;4;21;8;1;6;0;114;2;JUNI
3849;SULAWESI BARAT;MAJENE;SENDANA;TALLUBANUA;140;44;33;14;12;19;1;7;0;130;10;JUNI
3850;SULAWESI BARAT;MAJENE;SENDANA;LALATEDZONG;95;27;19;6;18;16;0;5;2;93;2;JUNI
3851;SULAWESI BARAT;MAJENE;SENDANA;BINANGA;71;31;11;6;11;9;1;2;0;71;0;JUNI
3852;SULAWESI BARAT;MAJENE;SENDANA;PUTTADA;73;40;21;0;10;1;0;1;0;73;0;JUNI
3853;SULAWESI BARAT;MAJENE;SENDANA;PAMINGGALAN;41;31;10;0;0;0;0;0;0;41;0;JUNI
3854;SULAWESI BARAT;MAJENE;SENDANA;LEPPANGANG;48;23;11;0;8;2;0;4;0;48;0;JUNI
3855;SULAWESI BARAT;MAJENE;SENDANA;PUNDAU;64;4;29;5;21;3;0;2;0;64;0;JUNI
3856;SULAWESI BARAT;MAJENE;SENDANA;SENDANA;78;40;22;1;0;7;1;7;0;78;0;JUNI
3857;SULAWESI BARAT;MAJENE;SENDANA;BANUA SENDANA;105;63;11;4;1;21;0;5;0;105;0;JUNI
3858;SULAWESI BARAT;MAJENE;SENDANA;TALLUBANUA UTARA;153;68;45;2;5;29;0;4;0;153;0;JUNI
3859;SULAWESI BARAT;MAJENE;SENDANA;LIMBORO RAMBU-RAMBU;100;23;32;2;37;4;0;0;0;98;2;JUNI
3860;SULAWESI BARAT;MAJENE;SENDANA;LIMBUA;92;33;22;2;20;12;0;3;0;92;0;JUNI
3861;SULAWESI BARAT;MAJENE;SENDANA;BUKIT SAMANG;117;38;23;8;24;14;4;6;0;117;0;JUNI
3862;SULAWESI BARAT;MAMUJU TENGAH;TOPOYO;BUDONG-BUDONG;240;100;65;3;46;7;0;10;0;231;9;JUNI
3863;SULAWESI BARAT;MAMUJU TENGAH;TOPOYO;TOPOYO;940;315;220;18;185;59;0;28;0;825;115;JUNI
3864;SULAWESI BARAT;MAMUJU TENGAH;TOPOYO;TUMBU;320;150;63;2;72;19;0;12;0;318;2;JUNI
3865;SULAWESI BARAT;MAMUJU TENGAH;TOPOYO;KABUBU;279;83;45;19;112;14;1;5;0;279;0;JUNI
3866;SULAWESI BARAT;MAMUJU TENGAH;TOPOYO;WAEPUTEH;277;151;28;13;72;6;0;4;0;274;3;JUNI
3867;SULAWESI BARAT;MAMUJU TENGAH;TOPOYO;TANGKOU;136;70;28;0;31;3;0;2;2;136;0;JUNI
3868;SULAWESI BARAT;MAMUJU TENGAH;TOPOYO;TABOLANG;444;164;97;13;101;8;1;9;2;395;49;JUNI
3869;SULAWESI BARAT;MAMUJU TENGAH;TOPOYO;PARAILI;197;109;39;2;29;13;2;3;0;197;0;JUNI
3870;SULAWESI BARAT;MAMUJU TENGAH;TOPOYO;SALUPANGKANG;475;143;64;10;245;8;0;3;1;474;1;JUNI
3871;SULAWESI BARAT;MAMUJU TENGAH;TOPOYO;SALUPANGKANG IV;58;41;3;0;13;0;0;1;0;58;0;JUNI
3872;SULAWESI BARAT;MAMUJU TENGAH;TOPOYO;TAPPILINA;155;50;35;11;38;14;0;7;0;155;0;JUNI
3873;SULAWESI BARAT;MAMUJU TENGAH;TOPOYO;BAMBAMANURUNG;158;70;11;4;66;6;0;0;1;158;0;JUNI
3874;SULAWESI BARAT;MAMUJU TENGAH;TOPOYO;SALULEKBO;395;159;90;5;137;2;0;1;0;394;1;JUNI
3875;SULAWESI BARAT;MAMUJU TENGAH;TOPOYO;PANGALLOANG;257;83;55;2;108;6;0;2;0;256;1;JUNI
3876;SULAWESI BARAT;MAMUJU TENGAH;TOPOYO;SINABATTA;114;57;34;1;13;4;0;1;0;110;4;JUNI
3877;SULAWESI BARAT;MAMUJU TENGAH;KAROSSA;KAROSSA;630;309;119;6;165;13;1;16;1;630;0;JUNI
3878;SULAWESI BARAT;MAMUJU TENGAH;KAROSSA;TASOKKO;434;167;109;7;116;9;0;26;0;434;0;JUNI
3879;SULAWESI BARAT;MAMUJU TENGAH;KAROSSA;LARA;122;37;14;2;61;4;1;3;0;122;0;JUNI
3880;SULAWESI BARAT;MAMUJU TENGAH;KAROSSA;KADAILA;154;48;28;2;72;3;0;1;0;154;0;JUNI
3881;SULAWESI BARAT;MAMUJU TENGAH;KAROSSA;KAYU CALLA;75;26;15;2;31;1;0;0;0;75;0;JUNI
3882;SULAWESI BARAT;MAMUJU TENGAH;KAROSSA;LEMBAH HOPO;150;44;19;10;66;1;0;10;0;150;0;JUNI
3883;SULAWESI BARAT;MAMUJU TENGAH;KAROSSA;BENGGAULU;270;123;67;1;61;9;0;8;0;269;1;JUNI
3884;SULAWESI BARAT;MAMUJU TENGAH;KAROSSA;SUKA MAJU;102;37;34;1;24;2;0;1;0;99;3;JUNI
3885;SULAWESI BARAT;MAMUJU TENGAH;KAROSSA;KAMBUNONG;286;150;66;2;48;8;0;11;0;285;1;JUNI
3886;SULAWESI BARAT;MAMUJU TENGAH;KAROSSA;SALUBIRO;158;82;32;1;34;0;0;9;0;158;0;JUNI
3887;SULAWESI BARAT;MAMUJU TENGAH;KAROSSA;SANJANGO;147;47;35;2;55;1;4;3;0;147;0;JUNI
3888;SULAWESI BARAT;MAMASA;NOSU;NOSU;80;6;37;1;22;7;0;5;0;78;2;JULI
3889;SULAWESI BARAT;MAMASA;NOSU;MINANGA;25;4;11;1;8;0;0;1;0;25;0;JULI
3890;SULAWESI BARAT;MAMASA;NOSU;BATUPAPAN;55;18;20;1;15;1;0;0;0;55;0;JULI
3891;SULAWESI BARAT;MAMASA;NOSU;MASEWWE;30;9;3;0;17;0;0;1;0;30;0;JULI
3892;SULAWESI BARAT;MAMASA;NOSU;SIWI;23;10;3;1;7;1;0;1;0;23;0;JULI
3893;SULAWESI BARAT;MAMASA;NOSU;MINANGA TIMUR;11;3;2;0;6;0;0;0;0;11;0;JULI
3894;SULAWESI BARAT;MAMASA;NOSU;PARINDING;23;2;16;0;5;0;0;0;0;23;0;JULI
3895;SULAWESI BARAT;MAMASA;MAMBI;MAMBI;78;44;21;2;10;1;0;0;0;78;0;JULI
3896;SULAWESI BARAT;MAMASA;MAMBI;TALIPUKKI;124;93;11;4;10;2;0;3;0;123;1;JULI
3897;SULAWESI BARAT;MAMASA;MAMBI;RANTEBULAHAN;51;13;29;0;6;1;0;1;0;50;1;JULI
3898;SULAWESI BARAT;MAMASA;MAMBI;SONDONGLAYU;34;11;4;4;8;0;0;6;0;33;1;JULI
3899;SULAWESI BARAT;MAMASA;MAMBI;SALUBANUA;31;12;17;0;1;0;0;0;0;30;1;JULI
3900;SULAWESI BARAT;MAMASA;MAMBI;TAPALINA;85;50;27;2;0;0;0;1;0;80;5;JULI
3901;SULAWESI BARAT;MAMASA;MAMBI;SENDANA;147;60;68;3;16;0;0;0;0;147;0;JULI
3902;SULAWESI BARAT;MAMASA;MAMBI;PAMOSEAN;46;38;7;1;0;0;0;0;0;46;0;JULI
3903;SULAWESI BARAT;MAMASA;MAMBI;SELUMAKA;109;27;82;0;0;0;0;0;0;109;0;JULI
3904;SULAWESI BARAT;MAMASA;MAMBI;BUJUNG MANURUNG;43;22;17;1;2;1;0;0;0;43;0;JULI
3905;SULAWESI BARAT;MAMASA;MAMBI;SALU ALO;78;27;45;0;6;0;0;0;0;78;0;JULI
3906;SULAWESI BARAT;MAMASA;MAMBI;INDOBANUA;13;4;3;0;2;4;0;0;0;13;0;JULI
3907;SULAWESI BARAT;MAMASA;MAMBI;SALUDURIAN;91;28;53;0;8;1;0;1;0;91;0;JULI
3908;SULAWESI BARAT;MAMASA;BAMBANG;MOKALLANG;41;16;21;0;3;0;0;1;0;41;0;JULI
3909;SULAWESI BARAT;MAMASA;BAMBANG;MASOSO;45;21;12;0;12;0;0;0;0;45;0;JULI
3910;SULAWESI BARAT;MAMASA;BAMBANG;SALUASSING;125;90;22;4;8;0;0;1;0;125;0;JULI
3911;SULAWESI BARAT;MAMASA;BAMBANG;SALUBULO;60;20;20;0;13;1;0;0;0;54;6;JULI
3912;SULAWESI BARAT;MAMASA;BAMBANG;SALUKADI;69;31;31;0;7;0;0;0;0;69;0;JULI
3913;SULAWESI BARAT;MAMASA;BAMBANG;SALUKEPOPOK;82;44;10;3;22;1;0;0;1;81;1;JULI
3914;SULAWESI BARAT;MAMASA;BAMBANG;ULUMAMBI BARAT;62;29;33;0;0;0;0;0;0;62;0;JULI
3915;SULAWESI BARAT;MAMASA;BAMBANG;LIMBADEBATA;107;35;13;1;54;1;0;3;0;107;0;JULI
3916;SULAWESI BARAT;MAMASA;BAMBANG;TANETE TOMBA;54;27;25;0;2;0;0;0;0;54;0;JULI
3917;SULAWESI BARAT;MAMASA;BAMBANG;BAMBANG;132;83;17;0;25;3;0;3;0;131;1;JULI
3918;SULAWESI BARAT;MAMASA;BAMBANG;RANTELEMO;51;13;24;0;12;2;0;0;0;51;0;JULI
3919;SULAWESI BARAT;MAMASA;BAMBANG;SALUDENGEN;34;8;22;0;1;1;0;0;0;32;2;JULI
3920;SULAWESI BARAT;MAMASA;BAMBANG;ULUMAMBI;66;10;49;1;0;0;0;0;0;60;6;JULI
3921;SULAWESI BARAT;MAMASA;BAMBANG;BAMBANG TIMUR;72;46;22;0;2;1;0;1;0;72;0;JULI
3922;SULAWESI BARAT;MAMASA;BAMBANG;MINANGA;129;41;45;0;38;1;0;4;0;129;0;JULI
3923;SULAWESI BARAT;MAMASA;BAMBANG;SIKAMASE;55;20;34;0;1;0;0;0;0;55;0;JULI
3924;SULAWESI BARAT;MAMASA;BAMBANG;RANTETARIMA;32;2;30;0;0;0;0;0;0;32;0;JULI
3925;SULAWESI BARAT;MAMASA;BAMBANG;SALURURU;32;4;2;3;22;0;0;1;0;32;0;JULI
3926;SULAWESI BARAT;MAMASA;BAMBANG;SALUTABANG;34;18;10;1;2;2;0;1;0;34;0;JULI
3927;SULAWESI BARAT;MAMASA;BAMBANG;BALATANA;39;28;10;0;1;0;0;0;0;39;0;JULI
3928;SULAWESI BARAT;PASANGKAYU;PEDONGGA;MALEI;224;110;63;1;34;14;0;2;0;224;0;JULI
3929;SULAWESI BARAT;PASANGKAYU;PEDONGGA;PEDANDA;201;54;54;3;76;7;0;6;0;200;1;JULI
3930;SULAWESI BARAT;PASANGKAYU;PEDONGGA;BATU OGE;146;61;28;2;46;8;0;1;0;146;0;JULI
3931;SULAWESI BARAT;PASANGKAYU;PEDONGGA;MARTASARI;551;209;62;5;239;23;0;11;0;549;2;JULI
3932;SULAWESI BARAT;POLEWALI MANDAR;BALANIPA;BALANIPA;183;83;35;13;34;7;0;11;0;183;0;JULI
3933;SULAWESI BARAT;POLEWALI MANDAR;BALANIPA;TAMMAJARRA;174;120;14;18;15;4;0;3;0;174;0;JULI
3934;SULAWESI BARAT;POLEWALI MANDAR;BALANIPA;TAMANGGALLE;110;60;19;0;28;1;0;1;1;110;0;JULI
3935;SULAWESI BARAT;POLEWALI MANDAR;BALANIPA;MOSSO;78;54;15;4;4;0;0;1;0;78;0;JULI
3936;SULAWESI BARAT;POLEWALI MANDAR;BALANIPA;GALUNG TULUK;189;99;39;19;20;1;0;11;0;189;0;JULI
3937;SULAWESI BARAT;POLEWALI MANDAR;BALANIPA;SABANG SUBIK;201;119;26;9;24;5;0;18;0;201;0;JULI
3938;SULAWESI BARAT;POLEWALI MANDAR;BALANIPA;PAMBUSUANG;416;232;70;11;35;10;1;30;1;390;26;JULI
3939;SULAWESI BARAT;POLEWALI MANDAR;BALANIPA;BALA;322;244;30;2;20;4;0;19;0;319;3;JULI
3940;SULAWESI BARAT;POLEWALI MANDAR;BALANIPA;LAMBANAN;13;5;2;3;2;0;0;1;0;13;0;JULI
3941;SULAWESI BARAT;POLEWALI MANDAR;BALANIPA;LEGO;104;65;26;0;5;0;0;8;0;104;0;JULI
3942;SULAWESI BARAT;POLEWALI MANDAR;BALANIPA;PALLIS;27;11;8;1;4;1;0;2;0;27;0;JULI
3943;SULAWESI BARAT;POLEWALI MANDAR;ANREAPI;ANREAPI;164;35;48;6;48;11;0;13;1;162;2;JULI
3944;SULAWESI BARAT;POLEWALI MANDAR;ANREAPI;DUAMPANUA;397;119;143;23;85;4;0;17;0;391;6;JULI
3945;SULAWESI BARAT;POLEWALI MANDAR;ANREAPI;KELAPA DUA;273;72;122;3;57;2;2;14;0;272;1;JULI
3946;SULAWESI BARAT;POLEWALI MANDAR;ANREAPI;PAPPANDANGAN;248;89;70;10;65;2;3;8;0;247;1;JULI
3947;SULAWESI BARAT;POLEWALI MANDAR;ANREAPI;KUNYI;239;38;108;4;67;4;0;11;1;233;6;JULI
3948;SULAWESI BARAT;POLEWALI MANDAR;BULO;BULO;104;19;9;2;72;2;0;0;0;104;0;JULI
3949;SULAWESI BARAT;POLEWALI MANDAR;BULO;PULLIWA;307;100;50;3;140;3;0;10;0;306;1;JULI
3950;SULAWESI BARAT;POLEWALI MANDAR;BULO;PATAMBANUA;145;28;107;0;7;0;0;1;0;143;2;JULI
3951;SULAWESI BARAT;POLEWALI MANDAR;BULO;KAROMBANG;137;80;20;0;34;2;0;1;0;137;0;JULI
3952;SULAWESI BARAT;POLEWALI MANDAR;BULO;DAALA TIMUR;126;42;60;2;21;0;0;1;0;126;0;JULI
3953;SULAWESI BARAT;POLEWALI MANDAR;BULO;LENGGO;53;18;29;1;4;1;0;0;0;53;0;JULI
3954;SULAWESI BARAT;POLEWALI MANDAR;BULO;SABURA;67;30;28;0;8;0;0;1;0;67;0;JULI
3955;SULAWESI BARAT;POLEWALI MANDAR;BULO;SEPPORRAKI;100;28;24;0;46;0;0;2;0;100;0;JULI
3956;SULAWESI BARAT;POLEWALI MANDAR;BULO;IHING;109;24;23;2;55;1;0;1;0;106;3;JULI
3957;SULAWESI BARAT;MAMASA;ARALLE;ARALLE;110;42;55;1;8;1;0;3;0;110;0;JULI
3958;SULAWESI BARAT;MAMASA;ARALLE;RALLE ANAK;35;8;18;0;6;0;0;3;0;35;0;JULI
3959;SULAWESI BARAT;MAMASA;ARALLE;PANETEAN;69;50;17;1;1;0;0;0;0;69;0;JULI
3960;SULAWESI BARAT;MAMASA;ARALLE;UHAILANU;69;18;31;0;11;3;0;5;0;68;1;JULI
3961;SULAWESI BARAT;MAMASA;ARALLE;ARALLE UTARA;57;24;31;0;2;0;0;0;0;57;0;JULI
3962;SULAWESI BARAT;MAMASA;ARALLE;UHAIDAHO;53;7;40;1;5;0;0;0;0;53;0;JULI
3963;SULAWESI BARAT;MAMASA;ARALLE;BARURU;92;63;27;0;1;0;0;0;1;92;0;JULI
3964;SULAWESI BARAT;MAMASA;ARALLE;RALLEANAK UTARA;37;16;18;0;2;0;0;1;0;37;0;JULI
3965;SULAWESI BARAT;MAMASA;ARALLE;PAMOSEANG PANGGA;38;17;18;2;1;0;0;0;0;38;0;JULI
3966;SULAWESI BARAT;MAMASA;ARALLE;KALABE;63;28;32;0;3;0;0;0;0;63;0;JULI
3967;SULAWESI BARAT;MAMASA;ARALLE;ARALLE SELATAN;31;10;18;0;2;0;0;1;0;31;0;JULI
3968;SULAWESI BARAT;MAMASA;ARALLE;HAHANGAN;36;18;12;0;6;0;0;0;0;36;0;JULI
3969;SULAWESI BARAT;POLEWALI MANDAR;CAMPALAGIAN;PAPPANG;151;84;13;12;9;6;0;13;1;138;13;JULI
3970;SULAWESI BARAT;POLEWALI MANDAR;CAMPALAGIAN;LALIKO;179;109;41;4;6;3;0;16;0;179;0;JULI
3971;SULAWESI BARAT;POLEWALI MANDAR;CAMPALAGIAN;BONDE;165;91;34;5;12;11;0;12;0;165;0;JULI
3972;SULAWESI BARAT;POLEWALI MANDAR;CAMPALAGIAN;KATUMBANGAN LEMO;159;85;38;12;16;5;0;3;0;159;0;JULI
3973;SULAWESI BARAT;POLEWALI MANDAR;CAMPALAGIAN;PANYAMPA;209;122;55;5;11;3;0;11;1;208;1;JULI
3974;SULAWESI BARAT;POLEWALI MANDAR;CAMPALAGIAN;SURUANG;146;79;36;7;10;1;0;7;0;140;6;JULI
3975;SULAWESI BARAT;POLEWALI MANDAR;CAMPALAGIAN;LAMPOKO;222;145;54;8;7;2;0;6;0;222;0;JULI
3976;SULAWESI BARAT;POLEWALI MANDAR;CAMPALAGIAN;KATUMBANGAN;294;130;43;10;57;39;0;12;0;291;3;JULI
3977;SULAWESI BARAT;POLEWALI MANDAR;CAMPALAGIAN;LAPEO;123;72;21;4;12;2;0;11;0;122;1;JULI
3978;SULAWESI BARAT;POLEWALI MANDAR;CAMPALAGIAN;PARAPPE;258;153;57;4;37;3;0;2;0;256;2;JULI
3979;SULAWESI BARAT;POLEWALI MANDAR;CAMPALAGIAN;ONGKO;92;23;14;12;33;7;0;3;0;92;0;JULI
3980;SULAWESI BARAT;POLEWALI MANDAR;CAMPALAGIAN;KENJE;146;100;11;8;18;3;0;6;0;146;0;JULI
3981;SULAWESI BARAT;POLEWALI MANDAR;CAMPALAGIAN;SUMARRANG;444;243;129;5;61;6;0;0;0;444;0;JULI
3982;SULAWESI BARAT;POLEWALI MANDAR;CAMPALAGIAN;BOTTO;250;121;60;0;57;3;0;7;0;248;2;JULI
3983;SULAWESI BARAT;POLEWALI MANDAR;CAMPALAGIAN;GATTUNGAN;161;53;23;17;45;15;0;7;0;160;1;JULI
3984;SULAWESI BARAT;POLEWALI MANDAR;CAMPALAGIAN;PADANG TIMUR;132;61;25;3;37;2;0;4;0;132;0;JULI
3985;SULAWESI BARAT;POLEWALI MANDAR;CAMPALAGIAN;PADANG;76;47;8;5;12;0;0;1;0;73;3;JULI
3986;SULAWESI BARAT;POLEWALI MANDAR;CAMPALAGIAN;LAGI-AGI;211;153;31;2;16;2;0;7;0;211;0;JULI
3987;SULAWESI BARAT;MAMUJU;PAPALANG;TOABO;632;276;145;4;193;9;0;3;1;631;1;JULI
3988;SULAWESI BARAT;MAMUJU;PAPALANG;PAPALANG;680;317;176;8;136;3;0;5;0;645;35;JULI
3989;SULAWESI BARAT;MAMUJU;PAPALANG;BONDA;315;172;89;2;49;1;0;1;0;314;1;JULI
3990;SULAWESI BARAT;MAMUJU;PAPALANG;TOPORE;189;99;40;7;34;1;0;2;0;183;6;JULI
3991;SULAWESI BARAT;MAMUJU;PAPALANG;SALUKAYU;253;122;89;2;31;3;0;6;0;253;0;JULI
3992;SULAWESI BARAT;MAMUJU;PAPALANG;SUKADAMAI;107;53;36;1;13;0;0;4;0;107;0;JULI
3993;SULAWESI BARAT;MAMUJU;PAPALANG;BODA-BODA;185;98;67;1;18;0;0;1;0;185;0;JULI
3994;SULAWESI BARAT;MAMUJU;PAPALANG;SISANGO;106;34;62;0;5;3;0;1;0;105;1;JULI
3995;SULAWESI BARAT;MAMUJU;PAPALANG;BATU AMPA;157;48;80;12;17;0;0;0;0;157;0;JULI
3996;SULAWESI BARAT;MAMASA;MAMASA;MAMASA;366;60;45;3;178;60;0;20;0;366;0;JULI
3997;SULAWESI BARAT;MAMASA;MAMASA;RAMBUSARATU;250;84;80;16;54;10;0;6;0;250;0;JULI
3998;SULAWESI BARAT;MAMASA;MAMASA;OSANGO;452;87;70;10;178;88;0;14;1;448;4;JULI
3999;SULAWESI BARAT;MAMASA;MAMASA;LAMBANAN;219;66;48;8;85;6;0;6;0;219;0;JULI
4000;SULAWESI BARAT;MAMASA;MAMASA;LEMBANA SALULO;88;15;16;1;44;5;0;6;0;87;1;JULI
4001;SULAWESI BARAT;MAMASA;MAMASA;TAUPE;228;46;32;7;139;1;1;2;0;228;0;JULI
4002;SULAWESI BARAT;MAMASA;MAMASA;BUNTU BUDA;291;77;31;11;103;24;0;5;0;251;40;JULI
4003;SULAWESI BARAT;MAMASA;MAMASA;TONDOK BAKARU;244;75;77;14;60;10;0;7;0;243;1;JULI
4004;SULAWESI BARAT;MAMASA;MAMASA;PEBASSIAN;92;22;24;2;41;1;0;2;0;92;0;JULI
4005;SULAWESI BARAT;MAMASA;MAMASA;MAMBULILING;120;55;21;2;37;2;0;1;0;118;2;JULI
4006;SULAWESI BARAT;MAMASA;MAMASA;BOMBONG LAMBE;147;47;18;2;65;14;0;1;0;147;0;JULI
4007;SULAWESI BARAT;MAMASA;MAMASA;BUBUN BATU;125;21;11;5;77;3;0;2;0;119;6;JULI
4008;SULAWESI BARAT;PASANGKAYU;SARUDU;SARUDU;403;229;64;4;77;13;1;13;0;401;2;JULI
4009;SULAWESI BARAT;PASANGKAYU;SARUDU;BULU MARIO;328;111;56;24;95;25;0;17;0;328;0;JULI
4010;SULAWESI BARAT;PASANGKAYU;SARUDU;KUMASARI;250;112;44;4;73;9;0;6;1;249;1;JULI
4011;SULAWESI BARAT;PASANGKAYU;SARUDU;PATIKA;66;19;19;0;14;3;0;6;0;61;5;JULI
4012;SULAWESI BARAT;PASANGKAYU;SARUDU;DODA;286;133;64;3;79;4;0;3;0;286;0;JULI
4013;SULAWESI BARAT;POLEWALI MANDAR;LIMBORO;LIMBORO;100;31;18;11;16;2;0;7;0;85;15;JULI
4014;SULAWESI BARAT;POLEWALI MANDAR;LIMBORO;LEMBANG LEMBANG;211;90;38;26;38;6;0;13;0;211;0;JULI
4015;SULAWESI BARAT;POLEWALI MANDAR;LIMBORO;TANDASURA;131;69;14;9;26;3;0;9;0;130;1;JULI
4016;SULAWESI BARAT;POLEWALI MANDAR;LIMBORO;SAMASUNDU;142;47;48;9;25;6;0;7;0;142;0;JULI
4017;SULAWESI BARAT;POLEWALI MANDAR;LIMBORO;NAPO;151;79;20;2;40;0;0;10;0;151;0;JULI
4018;SULAWESI BARAT;POLEWALI MANDAR;LIMBORO;TODANG TODANG;37;15;14;5;2;0;0;1;0;37;0;JULI
4019;SULAWESI BARAT;POLEWALI MANDAR;LIMBORO;PENDULANGAN;58;35;19;0;1;0;0;3;0;58;0;JULI
4020;SULAWESI BARAT;POLEWALI MANDAR;LIMBORO;RENGGEANG;106;36;30;6;30;0;0;4;0;106;0;JULI
4021;SULAWESI BARAT;POLEWALI MANDAR;LIMBORO;SALARRI;56;23;15;5;12;0;0;1;0;56;0;JULI
4022;SULAWESI BARAT;POLEWALI MANDAR;LIMBORO;TANGAN BARU;80;30;10;1;34;0;0;5;0;80;0;JULI
4023;SULAWESI BARAT;POLEWALI MANDAR;LIMBORO;PALECE;110;25;34;32;14;3;0;2;0;110;0;JULI
4024;SULAWESI BARAT;MAMUJU;TAPALANG BARAT;DUNGKAIT;247;100;98;5;35;3;1;3;0;245;2;JULI
4025;SULAWESI BARAT;MAMUJU;TAPALANG BARAT;LEBANI;117;41;51;0;8;0;0;4;2;106;11;JULI
4026;SULAWESI BARAT;MAMUJU;TAPALANG BARAT;LABUANG RANO;205;108;67;0;14;4;0;2;0;195;10;JULI
4027;SULAWESI BARAT;MAMUJU;TAPALANG BARAT;PASABU;149;46;55;6;17;8;0;13;2;147;2;JULI
4028;SULAWESI BARAT;MAMUJU;TAPALANG BARAT;TANETE PAO;44;31;10;0;2;0;0;0;0;43;1;JULI
4029;SULAWESI BARAT;MAMUJU;TAPALANG BARAT;PANGASAAN;52;22;18;2;4;4;0;0;0;50;2;JULI
4030;SULAWESI BARAT;MAMUJU;TAPALANG BARAT;AHU;170;95;56;2;7;0;0;2;0;162;8;JULI
4031;SULAWESI BARAT;POLEWALI MANDAR;BINUANG;AMASSANGAN;302;137;55;2;73;2;0;33;0;302;0;JULI
4032;SULAWESI BARAT;POLEWALI MANDAR;BINUANG;TONYAMAN;496;201;149;4;96;12;0;13;2;477;19;JULI
4033;SULAWESI BARAT;POLEWALI MANDAR;BINUANG;KUAJANG;375;169;70;12;107;4;0;13;0;375;0;JULI
4034;SULAWESI BARAT;POLEWALI MANDAR;BINUANG;PAKU;157;74;42;11;19;0;0;10;1;157;0;JULI
4035;SULAWESI BARAT;POLEWALI MANDAR;BINUANG;MIRRING;215;110;41;4;39;1;0;17;0;212;3;JULI
4036;SULAWESI BARAT;POLEWALI MANDAR;BINUANG;BATETANGNGA;689;403;140;11;81;5;0;18;2;660;29;JULI
4037;SULAWESI BARAT;POLEWALI MANDAR;BINUANG;MAMMI;243;78;58;8;85;3;0;10;0;242;1;JULI
4038;SULAWESI BARAT;POLEWALI MANDAR;BINUANG;KALEOK;147;49;61;2;30;0;0;5;0;147;0;JULI
4039;SULAWESI BARAT;POLEWALI MANDAR;BINUANG;AMOLA;157;94;23;2;35;0;1;2;0;157;0;JULI
4040;SULAWESI BARAT;POLEWALI MANDAR;BINUANG;REA;214;89;67;6;29;1;2;17;0;211;3;JULI
4041;SULAWESI BARAT;MAMUJU;MAMUJU;BINANGA;786;455;162;15;70;55;1;17;2;777;9;JULI
4042;SULAWESI BARAT;MAMUJU;MAMUJU;MAMUNYU;596;297;161;39;51;28;1;15;0;592;4;JULI
4043;SULAWESI BARAT;MAMUJU;MAMUJU;KAREMA;860;450;118;38;101;63;2;32;0;804;56;JULI
4044;SULAWESI BARAT;MAMUJU;MAMUJU;RIMUKU;675;293;145;31;52;75;2;32;1;631;44;JULI
4045;SULAWESI BARAT;MAMUJU;MAMUJU;BAMBU;345;191;77;14;43;5;0;15;0;345;0;JULI
4046;SULAWESI BARAT;MAMUJU;MAMUJU;KARAMPUANG;480;353;67;2;31;10;0;14;0;477;3;JULI
4047;SULAWESI BARAT;MAMUJU;MAMUJU;TADUI;481;162;201;0;66;6;0;27;2;464;17;JULI
4048;SULAWESI BARAT;MAMUJU;MAMUJU;BATU PANNU;179;128;33;0;11;3;0;4;0;179;0;JULI
4049;SULAWESI BARAT;MAMUJU;KEP. BALA BALAKANG;BALA BALAKANG;124;61;51;2;9;0;0;0;0;123;1;JULI
4050;SULAWESI BARAT;MAMUJU;KEP. BALA BALAKANG;BALA-BALAKANG TIMUR;97;29;66;1;0;0;1;0;0;97;0;JULI
4051;SULAWESI BARAT;MAJENE;MALUNDA;MALUNDA;145;49;40;15;21;12;3;5;0;145;0;JULI
4052;SULAWESI BARAT;MAJENE;MALUNDA;LAMUNGANG BATU;128;46;45;1;19;4;0;12;0;127;1;JULI
4053;SULAWESI BARAT;MAJENE;MALUNDA;BAMBANGAN;156;81;38;3;32;2;0;0;0;156;0;JULI
4054;SULAWESI BARAT;MAJENE;MALUNDA;LOMBANG;87;45;19;1;19;1;0;2;0;87;0;JULI
4055;SULAWESI BARAT;MAJENE;MALUNDA;LOMBONG;216;61;95;7;25;6;0;20;0;214;2;JULI
4056;SULAWESI BARAT;MAJENE;MALUNDA;MEKKATTA;213;101;26;12;57;5;0;8;0;209;4;JULI
4057;SULAWESI BARAT;MAJENE;MALUNDA;MALIAYA;154;70;32;6;35;3;0;7;0;153;1;JULI
4058;SULAWESI BARAT;MAJENE;MALUNDA;LOMBANG TIMUR;154;94;48;2;9;1;0;0;0;154;0;JULI
4059;SULAWESI BARAT;MAJENE;MALUNDA;SALUTAHONGAN;97;62;26;0;6;1;0;1;0;96;1;JULI
4060;SULAWESI BARAT;MAJENE;MALUNDA;LOMBONG TIMUR;96;17;25;11;5;19;0;19;0;96;0;JULI
4061;SULAWESI BARAT;MAJENE;MALUNDA;MEKKATTA SELATAN;124;40;32;4;33;7;0;6;1;123;1;JULI
4062;SULAWESI BARAT;MAJENE;MALUNDA;KAYUANGIN;165;85;33;9;11;11;0;13;0;162;3;JULI
4063;SULAWESI BARAT;MAJENE;TUBO SENDANA;ONANG;331;100;60;17;119;8;14;11;0;329;2;JULI
4064;SULAWESI BARAT;MAJENE;TUBO SENDANA;TUBO;87;16;12;35;7;12;1;4;0;87;0;JULI
4065;SULAWESI BARAT;MAJENE;TUBO SENDANA;ONANG UTARA;97;23;20;2;34;12;4;2;0;97;0;JULI
4066;SULAWESI BARAT;MAJENE;TUBO SENDANA;TUBO SELATAN;101;32;19;1;28;14;2;5;0;101;0;JULI
4067;SULAWESI BARAT;MAJENE;TUBO SENDANA;BONDE BONDE;87;21;13;9;19;14;6;5;0;87;0;JULI
4068;SULAWESI BARAT;MAJENE;TUBO SENDANA;TUBO TENGAH;91;22;24;5;15;15;1;9;0;91;0;JULI
4069;SULAWESI BARAT;MAJENE;TUBO SENDANA;TUBO POANG;93;38;32;9;7;2;0;5;0;93;0;JULI
4070;SULAWESI BARAT;PASANGKAYU;LARIANG;PARABU;130;28;19;9;36;20;0;11;0;123;7;JULI
4071;SULAWESI BARAT;PASANGKAYU;LARIANG;KENANGAN;53;12;6;2;19;7;0;5;0;51;2;JULI
4072;SULAWESI BARAT;PASANGKAYU;LARIANG;BAJAWALI;117;24;22;4;43;12;0;12;0;117;0;JULI
4073;SULAWESI BARAT;PASANGKAYU;LARIANG;SINGGANI;175;75;46;0;34;9;0;9;0;173;2;JULI
4074;SULAWESI BARAT;PASANGKAYU;LARIANG;KULU;96;31;31;0;22;9;0;2;0;95;1;JULI
4075;SULAWESI BARAT;PASANGKAYU;LARIANG;BATU MATORU;94;32;21;0;24;7;0;10;0;94;0;JULI
4076;SULAWESI BARAT;PASANGKAYU;LARIANG;BAMBAKORO;144;51;29;1;46;9;0;8;0;144;0;JULI
4077;SULAWESI BARAT;MAJENE;TAMMERODO SENDANA;SEPPONG;93;52;22;4;7;4;0;4;0;93;0;JULI
4078;SULAWESI BARAT;MAJENE;TAMMERODO SENDANA;TAMMERODO;136;61;25;3;11;21;4;9;0;134;2;JULI
4079;SULAWESI BARAT;MAJENE;TAMMERODO SENDANA;ULIDANG;159;87;25;3;18;8;2;15;0;158;1;JULI
4080;SULAWESI BARAT;MAJENE;TAMMERODO SENDANA;TALLAMBALAO;126;64;37;0;3;2;0;20;0;126;0;JULI
4081;SULAWESI BARAT;MAJENE;TAMMERODO SENDANA;TAMMERODO UTARA;165;81;36;6;15;19;0;8;0;165;0;JULI
4082;SULAWESI BARAT;MAJENE;TAMMERODO SENDANA;MANYAMBA;113;80;14;0;12;4;0;2;0;112;1;JULI
4083;SULAWESI BARAT;MAJENE;TAMMERODO SENDANA;AWO;150;84;30;0;8;9;6;10;0;147;3;JULI
4084;SULAWESI BARAT;PASANGKAYU;DAPURANG;DAPURANG;405;223;65;5;77;19;1;7;0;397;8;JULI
4085;SULAWESI BARAT;PASANGKAYU;DAPURANG;BENGGAULU;268;110;72;0;66;6;0;14;0;268;0;JULI
4086;SULAWESI BARAT;PASANGKAYU;DAPURANG;TIRTABUANA;145;87;15;2;34;2;0;5;0;145;0;JULI
4087;SULAWESI BARAT;PASANGKAYU;DAPURANG;BULU BONGGU;238;64;39;3;116;6;0;4;0;232;6;JULI
4088;SULAWESI BARAT;PASANGKAYU;DAPURANG;SARASA;184;101;51;1;21;6;0;3;0;183;1;JULI
4089;SULAWESI BARAT;MAMASA;TABULAHAN;LAKAHANG;270;87;157;2;12;3;2;7;0;270;0;JULI
4090;SULAWESI BARAT;MAMASA;TABULAHAN;PERIANGAN;68;17;49;0;2;0;0;0;0;68;0;JULI
4091;SULAWESI BARAT;MAMASA;TABULAHAN;MALATIRO;143;54;82;0;2;0;0;2;0;140;3;JULI
4092;SULAWESI BARAT;MAMASA;TABULAHAN;TABULAHAN;58;19;35;0;1;1;0;2;0;58;0;JULI
4093;SULAWESI BARAT;MAMASA;TABULAHAN;SALULEANG;35;12;22;0;1;0;0;0;0;35;0;JULI
4094;SULAWESI BARAT;MAMASA;TABULAHAN;TAMPAK KURRA;176;49;120;1;4;0;1;1;0;176;0;JULI
4095;SULAWESI BARAT;MAMASA;TABULAHAN;GANDANG DEWATA;36;13;19;0;4;0;0;0;0;36;0;JULI
4096;SULAWESI BARAT;MAMASA;TABULAHAN;BURANA;98;27;65;0;4;0;1;1;0;98;0;JULI
4097;SULAWESI BARAT;MAMASA;TABULAHAN;SALUBAKKA;96;58;36;0;0;0;0;2;0;96;0;JULI
4098;SULAWESI BARAT;MAMASA;TABULAHAN;PANGANDARAN;133;45;84;0;4;0;0;0;0;133;0;JULI
4099;SULAWESI BARAT;MAMASA;TABULAHAN;TALOPAK;54;17;31;0;6;0;0;0;0;54;0;JULI
4100;SULAWESI BARAT;MAMASA;TABULAHAN;PEU';50;17;33;0;0;0;0;0;0;50;0;JULI
4101;SULAWESI BARAT;MAMASA;TABULAHAN;TIMORO;44;11;23;0;7;1;0;2;0;44;0;JULI
4102;SULAWESI BARAT;MAMASA;TABULAHAN;LAKAHANG UTAMA;74;26;42;0;2;0;0;3;0;73;1;JULI
4103;SULAWESI BARAT;MAMASA;TABANG;TABANG;82;31;20;0;10;20;0;1;0;82;0;JULI
4104;SULAWESI BARAT;MAMASA;TABANG;TADOKALUA;91;36;26;1;19;1;0;3;0;86;5;JULI
4105;SULAWESI BARAT;MAMASA;TABANG;TABANG BARAT;152;65;49;1;34;2;0;0;1;152;0;JULI
4106;SULAWESI BARAT;MAMASA;TABANG;MASUPU;79;11;63;0;4;0;0;0;1;79;0;JULI
4107;SULAWESI BARAT;MAMASA;TABANG;KALAMA;68;11;20;0;21;3;0;2;0;57;11;JULI
4108;SULAWESI BARAT;MAMASA;TABANG;BAKADISURA;101;21;58;0;20;1;0;1;0;101;0;JULI
4109;SULAWESI BARAT;MAMASA;TABANG;SALUKONA;99;45;45;0;8;1;0;0;0;99;0;JULI
4110;SULAWESI BARAT;MAMUJU TENGAH;PANGALE;POLO PANGALE;243;56;58;9;111;5;0;3;0;242;1;JULI
4111;SULAWESI BARAT;MAMUJU TENGAH;PANGALE;PANGALE;203;50;84;10;43;6;1;9;0;203;0;JULI
4112;SULAWESI BARAT;MAMUJU TENGAH;PANGALE;SARTANAMAJU;73;25;16;9;14;5;0;4;0;73;0;JULI
4113;SULAWESI BARAT;MAMUJU TENGAH;PANGALE;POLO LERENG;221;65;54;6;84;4;0;4;0;217;4;JULI
4114;SULAWESI BARAT;MAMUJU TENGAH;PANGALE;KUO;416;203;60;4;129;12;0;6;2;416;0;JULI
4115;SULAWESI BARAT;MAMUJU TENGAH;PANGALE;POLO CAMBA;148;51;49;8;34;1;0;2;3;148;0;JULI
4116;SULAWESI BARAT;MAMUJU TENGAH;PANGALE;LAMBA-LAMBA;127;44;35;4;41;2;0;1;0;127;0;JULI
4117;SULAWESI BARAT;MAMUJU TENGAH;PANGALE;KOMBILING;215;69;42;9;81;3;0;8;0;212;3;JULI
4118;SULAWESI BARAT;MAMUJU TENGAH;PANGALE;LEMO-LEMO;135;53;42;1;36;2;1;0;0;135;0;JULI
4119;SULAWESI BARAT;MAMASA;TANDUK KALUA;MINAKE;82;27;6;1;44;2;0;2;0;82;0;JULI
4120;SULAWESI BARAT;MAMASA;TANDUK KALUA;MALABO;51;23;12;0;6;7;0;3;0;51;0;JULI
4121;SULAWESI BARAT;MAMASA;TANDUK KALUA;SINDAGAMANIK;138;80;18;0;38;1;0;1;0;138;0;JULI
4122;SULAWESI BARAT;MAMASA;TANDUK KALUA;PARONDOBULAWAN;107;72;9;1;21;1;0;3;0;107;0;JULI
4123;SULAWESI BARAT;MAMASA;TANDUK KALUA;TAMALANTIK;158;63;55;0;32;4;0;1;1;156;2;JULI
4124;SULAWESI BARAT;MAMASA;TANDUK KALUA;MANNABABA;69;30;2;0;37;0;0;0;0;69;0;JULI
4125;SULAWESI BARAT;MAMASA;TANDUK KALUA;MESAKADA;118;50;26;0;42;0;0;0;0;118;0;JULI
4126;SULAWESI BARAT;MAMASA;TANDUK KALUA;BALLABATU;144;22;15;0;104;2;0;1;0;144;0;JULI
4127;SULAWESI BARAT;MAMASA;TANDUK KALUA;PAMBE;86;22;18;1;42;2;1;0;0;86;0;JULI
4128;SULAWESI BARAT;MAMASA;TANDUK KALUA;SALURANO;72;30;13;0;28;1;0;0;0;72;0;JULI
4129;SULAWESI BARAT;MAMASA;TANDUK KALUA;TALIMBUNG;89;45;38;0;5;0;0;1;0;89;0;JULI
4130;SULAWESI BARAT;MAMASA;TANDUK KALUA;KANAN;114;43;26;0;34;8;0;1;0;112;2;JULI
4131;SULAWESI BARAT;MAMASA;TAWALIAN;TAWALIAN;240;100;45;0;75;8;0;8;3;239;1;JULI
4132;SULAWESI BARAT;MAMASA;TAWALIAN;TAWALIAN TIMUR;169;67;49;2;48;1;0;1;0;168;1;JULI
4133;SULAWESI BARAT;MAMASA;TAWALIAN;KARIANGO;204;77;51;0;76;0;0;0;0;204;0;JULI
4134;SULAWESI BARAT;MAMASA;TAWALIAN;RANTETANGNGA;139;25;35;4;66;4;0;4;0;138;1;JULI
4135;SULAWESI BARAT;PASANGKAYU;PASANGKAYU;PASANGKAYU;1496;633;371;31;151;230;24;51;0;1491;5;JULI
4136;SULAWESI BARAT;PASANGKAYU;PASANGKAYU;MARTAJAYA;180;61;33;3;45;24;0;14;0;180;0;JULI
4137;SULAWESI BARAT;PASANGKAYU;PASANGKAYU;PAKAVA;381;206;96;5;68;4;0;2;0;381;0;JULI
4138;SULAWESI BARAT;PASANGKAYU;PASANGKAYU;KARYA BERSAMA;317;150;53;3;79;23;0;9;0;317;0;JULI
4139;SULAWESI BARAT;PASANGKAYU;PASANGKAYU;AKO;429;198;85;4;75;42;0;15;0;419;10;JULI
4140;SULAWESI BARAT;PASANGKAYU;PASANGKAYU;GUNUNG SARI;533;287;79;7;103;24;0;25;0;525;8;JULI
4141;SULAWESI BARAT;MAMASA;PANA;PANA;61;16;37;1;6;1;0;0;0;61;0;JULI
4142;SULAWESI BARAT;MAMASA;PANA;MANIPI;121;61;44;3;10;1;0;1;0;120;1;JULI
4143;SULAWESI BARAT;MAMASA;PANA;MAMULLU;63;11;40;0;10;1;0;1;0;63;0;JULI
4144;SULAWESI BARAT;MAMASA;PANA;SAPAN;59;14;24;0;21;0;0;0;0;59;0;JULI
4145;SULAWESI BARAT;MAMASA;PANA;DATUBARINGAN;79;27;41;1;10;0;0;0;0;79;0;JULI
4146;SULAWESI BARAT;MAMASA;PANA;PANURA;60;15;40;0;5;0;0;0;0;60;0;JULI
4147;SULAWESI BARAT;MAMASA;PANA;TALLANG BULAWAN;71;20;39;4;7;0;0;1;0;71;0;JULI
4148;SULAWESI BARAT;MAMASA;PANA;KARAKA;62;23;31;0;7;0;0;1;0;62;0;JULI
4149;SULAWESI BARAT;MAMASA;PANA;ULUSALU;57;5;52;0;0;0;0;0;0;57;0;JULI
4150;SULAWESI BARAT;MAMASA;PANA;WERI;51;8;36;1;4;1;0;1;0;51;0;JULI
4151;SULAWESI BARAT;MAMASA;PANA;SALUTAMBUN;59;0;59;0;0;0;0;0;0;59;0;JULI
4152;SULAWESI BARAT;MAMASA;PANA;SALOAN;97;31;56;0;9;0;0;0;0;96;1;JULI
4153;SULAWESI BARAT;MAMASA;PANA;ULUSALU INDAH;54;16;38;0;0;0;0;0;0;54;0;JULI
4154;SULAWESI BARAT;PASANGKAYU;DURIPOKU;TAMMARUNANG;179;56;49;12;47;5;0;10;0;179;0;JULI
4155;SULAWESI BARAT;PASANGKAYU;DURIPOKU;SAPTANAJAYA;205;116;38;1;36;10;0;4;0;205;0;JULI
4156;SULAWESI BARAT;PASANGKAYU;DURIPOKU;TARANGGI;92;15;23;5;40;8;0;1;0;92;0;JULI
4157;SULAWESI BARAT;PASANGKAYU;DURIPOKU;SIPAKAINGA;84;42;27;1;12;2;0;0;0;84;0;JULI
4158;SULAWESI BARAT;MAMASA;RANTEBULAHAN TIMUR;SALUMOKANAN;93;44;14;0;28;6;0;1;0;93;0;JULI
4159;SULAWESI BARAT;MAMASA;RANTEBULAHAN TIMUR;SALUMOKANAN BARAT;107;45;26;0;33;0;0;0;1;105;2;JULI
4160;SULAWESI BARAT;MAMASA;RANTEBULAHAN TIMUR;BUANGIN;94;66;18;0;9;0;0;0;0;93;1;JULI
4161;SULAWESI BARAT;MAMASA;RANTEBULAHAN TIMUR;BAMBANG BUDA;116;28;64;2;19;1;0;2;0;116;0;JULI
4162;SULAWESI BARAT;MAMASA;RANTEBULAHAN TIMUR;LEKO;21;5;11;0;5;0;0;0;0;21;0;JULI
4163;SULAWESI BARAT;MAMASA;RANTEBULAHAN TIMUR;KIRAK;75;52;17;0;6;0;0;0;0;75;0;JULI
4164;SULAWESI BARAT;MAMASA;RANTEBULAHAN TIMUR;SALUMOKANAN UTARA;115;72;6;1;34;1;0;1;0;115;0;JULI
4165;SULAWESI BARAT;MAMASA;RANTEBULAHAN TIMUR;SAMPALE;50;17;13;0;20;0;0;0;0;50;0;JULI
4166;SULAWESI BARAT;MAMASA;SESENAPADANG;OROBUA;200;37;19;2;116;15;0;5;3;197;3;JULI
4167;SULAWESI BARAT;MAMASA;SESENAPADANG;PALADAN;64;9;7;0;44;1;0;0;0;61;3;JULI
4168;SULAWESI BARAT;MAMASA;SESENAPADANG;OROBUA TIMUR;37;14;7;0;14;1;0;1;0;37;0;JULI
4169;SULAWESI BARAT;MAMASA;SESENAPADANG;RANTE PUANG;95;23;20;0;47;2;0;1;0;93;2;JULI
4170;SULAWESI BARAT;MAMASA;SESENAPADANG;SATENETEAN;45;6;23;0;14;1;0;1;0;45;0;JULI
4171;SULAWESI BARAT;MAMASA;SESENAPADANG;LISUAN ADA;66;32;10;0;24;0;0;0;0;66;0;JULI
4172;SULAWESI BARAT;MAMASA;SESENAPADANG;OROBUA SELATAN;63;16;9;0;21;17;0;0;0;63;0;JULI
4173;SULAWESI BARAT;MAMASA;SESENAPADANG;MALANGKENA PADANG;68;10;3;0;54;0;0;0;1;68;0;JULI
4174;SULAWESI BARAT;MAMASA;SESENAPADANG;MALIMBONG;23;6;1;0;15;0;0;1;0;23;0;JULI
4175;SULAWESI BARAT;MAMASA;SESENAPADANG;MARAMPAN OROBUA;30;11;0;0;9;9;0;0;0;29;1;JULI
4176;SULAWESI BARAT;MAJENE;BANGGAE;BANGGAE;328;95;108;14;61;36;1;13;0;328;0;JULI
4177;SULAWESI BARAT;MAJENE;BANGGAE;BARU;517;146;143;11;181;13;0;23;0;517;0;JULI
4178;SULAWESI BARAT;MAJENE;BANGGAE;PANGALI ALI;870;289;264;11;203;63;1;33;0;864;6;JULI
4179;SULAWESI BARAT;MAJENE;BANGGAE;TOTOLI;448;153;108;17;139;12;1;18;0;448;0;JULI
4180;SULAWESI BARAT;MAJENE;BANGGAE;RANGAS;893;356;326;17;143;33;1;15;2;893;0;JULI
4181;SULAWESI BARAT;MAJENE;BANGGAE;GALUNG;225;43;15;23;78;25;0;38;0;222;3;JULI
4182;SULAWESI BARAT;MAJENE;BANGGAE;PALIPI SOREANG;236;104;39;17;56;10;0;10;0;236;0;JULI
4183;SULAWESI BARAT;MAJENE;BANGGAE;PAMBOBORANG;246;47;81;13;78;5;0;21;0;245;1;JULI
4184;SULAWESI BARAT;MAMASA;SUMARORONG;SUMARORONG;142;45;38;6;33;7;0;11;0;140;2;JULI
4185;SULAWESI BARAT;MAMASA;SUMARORONG;TABONE;95;27;37;0;30;0;0;1;0;95;0;JULI
4186;SULAWESI BARAT;MAMASA;SUMARORONG;BATANG URU;98;36;47;0;12;2;0;1;0;98;0;JULI
4187;SULAWESI BARAT;MAMASA;SUMARORONG;SASAKAN;155;53;83;1;10;7;0;0;0;154;1;JULI
4188;SULAWESI BARAT;MAMASA;SUMARORONG;TADISI;55;13;38;0;3;0;0;1;0;55;0;JULI
4189;SULAWESI BARAT;MAMASA;SUMARORONG;SIBANAWA;101;27;51;0;22;0;0;1;0;101;0;JULI
4190;SULAWESI BARAT;MAMASA;SUMARORONG;BATANGNGURU TIMUR;106;33;67;0;6;0;0;0;0;106;0;JULI
4191;SULAWESI BARAT;MAMASA;SUMARORONG;SALUBALO;121;49;42;0;27;0;0;3;0;121;0;JULI
4192;SULAWESI BARAT;MAMASA;SUMARORONG;BANEA;66;20;35;0;8;1;0;2;0;66;0;JULI
4193;SULAWESI BARAT;MAMASA;SUMARORONG;RANTE KAMASE;162;76;29;4;41;5;0;7;0;162;0;JULI
4194;SULAWESI BARAT;PASANGKAYU;TIKKE RAYA;TIKKE;310;84;54;3;102;41;0;12;1;297;13;JULI
4195;SULAWESI BARAT;PASANGKAYU;TIKKE RAYA;MAKMUR JAYA;462;167;115;4;126;26;0;20;1;459;3;JULI
4196;SULAWESI BARAT;PASANGKAYU;TIKKE RAYA;LARIANG;397;136;78;1;155;14;0;9;0;393;4;JULI
4197;SULAWESI BARAT;PASANGKAYU;TIKKE RAYA;PAJALELE;355;133;79;2;98;22;0;16;1;351;4;JULI
4198;SULAWESI BARAT;PASANGKAYU;TIKKE RAYA;JENGENG RAYA;185;57;40;8;51;21;0;8;0;185;0;JULI
4199;SULAWESI BARAT;MAMASA;BALLA;BALLA;162;27;27;2;83;11;0;11;0;161;1;JULI
4200;SULAWESI BARAT;MAMASA;BALLA;BALLA BARAT;84;38;12;0;34;0;0;0;0;84;0;JULI
4201;SULAWESI BARAT;MAMASA;BALLA;BALLA SATANETEAN;145;54;13;3;62;8;0;3;0;143;2;JULI
4202;SULAWESI BARAT;MAMASA;BALLA;BALLA TUMUKA;113;38;34;0;39;1;0;1;0;113;0;JULI
4203;SULAWESI BARAT;MAMASA;BALLA;SEPAKUAN;157;52;14;2;85;2;0;2;0;157;0;JULI
4204;SULAWESI BARAT;MAMASA;BALLA;PIDARA;63;25;8;0;28;1;0;1;0;63;0;JULI
4205;SULAWESI BARAT;MAMASA;BALLA;BAMBAPUANG;62;30;16;0;16;0;0;0;0;62;0;JULI
4206;SULAWESI BARAT;MAMASA;BALLA;BALLA TIMUR;34;6;3;0;22;1;0;2;0;34;0;JULI
4207;SULAWESI BARAT;MAMASA;MEHALAAN;MEHALAAN;53;21;16;1;13;0;0;2;0;53;0;JULI
4208;SULAWESI BARAT;MAMASA;MEHALAAN;BOTTENG;75;32;13;0;28;0;1;1;0;75;0;JULI
4209;SULAWESI BARAT;MAMASA;MEHALAAN;SALUKONTA;56;26;11;1;17;0;0;1;0;56;0;JULI
4210;SULAWESI BARAT;MAMASA;MEHALAAN;MESAKADA;54;17;18;1;17;0;0;1;0;54;0;JULI
4211;SULAWESI BARAT;MAMASA;MEHALAAN;MEHALAAN BARAT;90;32;24;0;31;0;0;3;0;90;0;JULI
4212;SULAWESI BARAT;MAMASA;MEHALAAN;SALUAHOK;67;22;22;1;20;0;0;2;0;67;0;JULI
4213;SULAWESI BARAT;MAMASA;MEHALAAN;SALUBALO;41;22;12;0;7;0;0;0;0;41;0;JULI
4214;SULAWESI BARAT;MAMASA;MEHALAAN;PASSEMBUK;43;18;13;0;12;0;0;0;0;43;0;JULI
4215;SULAWESI BARAT;MAMASA;MEHALAAN;KONDO;34;17;9;0;7;0;0;1;0;34;0;JULI
4216;SULAWESI BARAT;MAMASA;MEHALAAN;LEKO SUKAMAJU;32;12;10;0;9;0;0;1;0;32;0;JULI
4217;SULAWESI BARAT;MAMASA;MEHALAAN;ULUMEA;27;16;3;0;8;0;0;0;0;27;0;JULI
4218;SULAWESI BARAT;MAMASA;BUNTUMALANGKA;BUNTUMALANGKA;131;26;68;2;25;4;0;5;0;130;1;JULI
4219;SULAWESI BARAT;MAMASA;BUNTUMALANGKA;RANTEBERAN;111;58;44;0;8;0;0;1;0;111;0;JULI
4220;SULAWESI BARAT;MAMASA;BUNTUMALANGKA;KEBANGA;41;9;19;0;12;0;0;0;1;41;0;JULI
4221;SULAWESI BARAT;MAMASA;BUNTUMALANGKA;SALURINDU;52;27;15;1;7;0;0;2;0;52;0;JULI
4222;SULAWESI BARAT;MAMASA;BUNTUMALANGKA;TAORA;41;10;26;1;2;0;0;2;0;41;0;JULI
4223;SULAWESI BARAT;MAMASA;BUNTUMALANGKA;KABAE;70;10;55;0;4;0;0;1;0;70;0;JULI
4224;SULAWESI BARAT;MAMASA;BUNTUMALANGKA;SALUTAMBUN BARAT;58;26;30;0;1;0;0;0;1;58;0;JULI
4225;SULAWESI BARAT;MAMASA;BUNTUMALANGKA;PENATANGAN;102;38;31;0;23;3;0;1;0;96;6;JULI
4226;SULAWESI BARAT;MAMASA;BUNTUMALANGKA;SALUTAMBUN TIMUR;38;16;19;0;1;0;0;2;0;38;0;JULI
4227;SULAWESI BARAT;MAMASA;BUNTUMALANGKA;SALUTAMBUN;26;8;14;0;1;1;0;2;0;26;0;JULI
4228;SULAWESI BARAT;MAMASA;BUNTUMALANGKA;ARALLE TIMUR;93;26;58;0;3;0;0;1;0;88;5;JULI
4229;SULAWESI BARAT;MAMUJU;SIMBORO;SIMBORO;1538;605;181;72;168;249;1;70;5;1351;187;JULI
4230;SULAWESI BARAT;MAMUJU;SIMBORO;RANGAS;561;169;151;20;128;19;3;12;0;502;59;JULI
4231;SULAWESI BARAT;MAMUJU;SIMBORO;BOTTENG;185;104;43;1;22;2;0;12;0;184;1;JULI
4232;SULAWESI BARAT;MAMUJU;SIMBORO;SALETTO;288;137;75;5;44;4;1;22;0;288;0;JULI
4233;SULAWESI BARAT;MAMUJU;SIMBORO;SUMARE;224;106;80;2;26;10;0;0;0;224;0;JULI
4234;SULAWESI BARAT;MAMUJU;SIMBORO;BOTTENG UTARA;360;143;93;1;103;5;1;0;0;346;14;JULI
4235;SULAWESI BARAT;MAMUJU;SIMBORO;TAPANDULLU;49;30;1;0;14;0;2;2;0;49;0;JULI
4236;SULAWESI BARAT;MAMUJU;SIMBORO;PATI'DI;182;102;40;1;35;1;0;3;0;182;0;JULI
4237;SULAWESI BARAT;POLEWALI MANDAR;TINAMBUNG;TINAMBUNG;118;37;26;2;23;4;0;26;0;118;0;JULI
4238;SULAWESI BARAT;POLEWALI MANDAR;TINAMBUNG;KARAMA;461;331;44;20;46;2;0;15;0;458;3;JULI
4239;SULAWESI BARAT;POLEWALI MANDAR;TINAMBUNG;TANGNGA TANGNGA;201;144;33;2;13;1;0;8;0;201;0;JULI
4240;SULAWESI BARAT;POLEWALI MANDAR;TINAMBUNG;LEKOPADIS;78;28;14;5;23;1;0;6;0;77;1;JULI
4241;SULAWESI BARAT;POLEWALI MANDAR;TINAMBUNG;GALUNG LOMBOK;134;53;17;14;32;3;0;15;0;134;0;JULI
4242;SULAWESI BARAT;POLEWALI MANDAR;TINAMBUNG;TANDUNG;115;54;21;7;16;4;0;11;0;113;2;JULI
4243;SULAWESI BARAT;POLEWALI MANDAR;TINAMBUNG;BATULAYA;115;45;24;19;12;5;1;9;0;115;0;JULI
4244;SULAWESI BARAT;POLEWALI MANDAR;TINAMBUNG;SEPABATU;100;38;22;10;15;2;0;13;0;100;0;JULI
4245;SULAWESI BARAT;MAMUJU;BONEHAU;BONEHAU;166;44;84;3;23;2;0;4;0;160;6;JULI
4246;SULAWESI BARAT;MAMUJU;BONEHAU;SALUTIWO;91;34;36;2;19;0;0;0;0;91;0;JULI
4247;SULAWESI BARAT;MAMUJU;BONEHAU;BUTTUADA;204;9;171;3;16;1;0;2;0;202;2;JULI
4248;SULAWESI BARAT;MAMUJU;BONEHAU;TAMALEA;48;4;36;0;7;0;0;1;0;48;0;JULI
4249;SULAWESI BARAT;MAMUJU;BONEHAU;LUMIKA;129;38;55;2;33;1;0;0;0;129;0;JULI
4250;SULAWESI BARAT;MAMUJU;BONEHAU;MAPPU;73;17;42;0;13;0;0;1;0;73;0;JULI
4251;SULAWESI BARAT;MAMUJU;BONEHAU;BANUADA;97;13;78;1;3;0;0;2;0;97;0;JULI
4252;SULAWESI BARAT;MAMUJU;BONEHAU;HINUA;103;28;27;6;35;1;0;3;1;101;2;JULI
4253;SULAWESI BARAT;MAMUJU;BONEHAU;KINATANG;107;17;87;1;0;0;0;2;0;107;0;JULI
4254;SULAWESI BARAT;MAMUJU;KALUKKU;SINYONYOI;451;235;131;10;47;5;0;12;0;440;11;JULI
4255;SULAWESI BARAT;MAMUJU;KALUKKU;BEBANGA;753;446;205;4;65;5;2;23;0;750;3;JULI
4256;SULAWESI BARAT;MAMUJU;KALUKKU;KALUKKU;675;236;172;8;186;24;1;28;0;655;20;JULI
4257;SULAWESI BARAT;MAMUJU;KALUKKU;SINYONYOI SELATAN;270;130;71;5;32;3;0;23;0;264;6;JULI
4258;SULAWESI BARAT;MAMUJU;KALUKKU;SONDOANG;273;115;86;1;63;1;0;5;1;272;1;JULI
4259;SULAWESI BARAT;MAMUJU;KALUKKU;BERU-BERU;548;320;82;3;129;2;0;11;1;548;0;JULI
4260;SULAWESI BARAT;MAMUJU;KALUKKU;BELANG BELANG;366;152;109;3;90;2;0;10;0;366;0;JULI
4261;SULAWESI BARAT;MAMUJU;KALUKKU;KABULOANG;358;140;128;3;70;1;1;10;1;354;4;JULI
4262;SULAWESI BARAT;MAMUJU;KALUKKU;KEANG;229;69;124;0;27;1;0;7;0;228;1;JULI
4263;SULAWESI BARAT;MAMUJU;KALUKKU;POKKANG;202;85;41;2;62;3;1;8;0;202;0;JULI
4264;SULAWESI BARAT;MAMUJU;KALUKKU;GULILING;152;48;63;0;36;0;0;2;2;151;1;JULI
4265;SULAWESI BARAT;MAMUJU;KALUKKU;UHAIMATE;121;77;36;1;7;0;0;0;0;121;0;JULI
4266;SULAWESI BARAT;MAMUJU;KALUKKU;KALUKKU BARAT;473;278;68;1;121;2;0;3;0;473;0;JULI
4267;SULAWESI BARAT;MAMUJU;KALUKKU;PAMMULUKANG;231;113;75;7;22;0;0;12;1;230;1;JULI
4268;SULAWESI BARAT;POLEWALI MANDAR;POLEWALI;POLEWALI;516;159;152;40;77;31;0;46;0;505;11;JULI
4269;SULAWESI BARAT;POLEWALI MANDAR;POLEWALI;WATTANG;185;60;57;12;24;15;0;17;0;185;0;JULI
4270;SULAWESI BARAT;POLEWALI MANDAR;POLEWALI;SULEWATANG;338;78;161;5;73;6;0;15;0;338;0;JULI
4271;SULAWESI BARAT;POLEWALI MANDAR;POLEWALI;LANTORA;410;110;162;22;52;34;0;30;0;410;0;JULI
4272;SULAWESI BARAT;POLEWALI MANDAR;POLEWALI;TAKATIDUNG;496;231;102;25;74;21;0;26;0;479;17;JULI
4273;SULAWESI BARAT;POLEWALI MANDAR;POLEWALI;PEKKABATA;307;138;56;27;42;26;0;17;0;306;1;JULI
4274;SULAWESI BARAT;POLEWALI MANDAR;POLEWALI;MADATE;565;194;162;70;85;22;0;32;0;565;0;JULI
4275;SULAWESI BARAT;POLEWALI MANDAR;POLEWALI;MANDING;377;126;98;16;82;20;0;34;0;376;1;JULI
4276;SULAWESI BARAT;POLEWALI MANDAR;POLEWALI;DARMA;552;193;168;31;115;15;0;30;0;552;0;JULI
4277;SULAWESI BARAT;POLEWALI MANDAR;WONOMULYO;SIDODADI;389;203;85;3;52;29;0;14;1;387;2;JULI
4278;SULAWESI BARAT;POLEWALI MANDAR;WONOMULYO;SIDOREJO;284;157;64;11;22;12;0;16;0;282;2;JULI
4279;SULAWESI BARAT;POLEWALI MANDAR;WONOMULYO;SUMBEREJO;466;212;88;26;94;35;0;5;1;461;5;JULI
4280;SULAWESI BARAT;POLEWALI MANDAR;WONOMULYO;BUMIAYU;389;140;83;25;49;58;0;16;1;372;17;JULI
4281;SULAWESI BARAT;POLEWALI MANDAR;WONOMULYO;KEBUNSARI;263;97;44;8;41;40;1;11;0;242;21;JULI
4282;SULAWESI BARAT;POLEWALI MANDAR;WONOMULYO;BANUA BARU;177;87;29;6;18;16;0;9;0;165;12;JULI
4283;SULAWESI BARAT;POLEWALI MANDAR;WONOMULYO;NEPO;255;153;47;3;35;9;1;4;0;252;3;JULI
4284;SULAWESI BARAT;POLEWALI MANDAR;WONOMULYO;SUGIHWARAS;508;235;127;15;78;29;0;12;0;496;12;JULI
4285;SULAWESI BARAT;POLEWALI MANDAR;WONOMULYO;CAMPURJO;233;113;40;6;38;16;0;19;0;232;1;JULI
4286;SULAWESI BARAT;POLEWALI MANDAR;WONOMULYO;BUMIMULYO;177;88;43;0;32;11;0;1;0;175;2;JULI
4287;SULAWESI BARAT;POLEWALI MANDAR;WONOMULYO;TUMPILING;230;115;53;3;34;4;0;9;0;218;12;JULI
4288;SULAWESI BARAT;POLEWALI MANDAR;WONOMULYO;BAKKA-BAKKA;183;99;35;3;30;7;0;5;0;179;4;JULI
4289;SULAWESI BARAT;POLEWALI MANDAR;WONOMULYO;ARJO SARI;252;126;75;3;12;19;0;8;0;243;9;JULI
4290;SULAWESI BARAT;POLEWALI MANDAR;WONOMULYO;GALESON;248;168;32;3;27;5;0;8;0;243;5;JULI
4291;SULAWESI BARAT;MAMUJU;TAPALANG;GALUNG;253;57;103;5;40;25;0;19;1;250;3;JULI
4292;SULAWESI BARAT;MAMUJU;TAPALANG;KASAMBANG;204;77;55;0;58;2;0;10;1;203;1;JULI
4293;SULAWESI BARAT;MAMUJU;TAPALANG;DAYANGINNA;125;36;39;9;25;6;0;7;0;122;3;JULI
4294;SULAWESI BARAT;MAMUJU;TAPALANG;OROBATU;91;33;31;10;3;8;0;6;0;91;0;JULI
4295;SULAWESI BARAT;MAMUJU;TAPALANG;TAKANDEANG;180;64;32;6;59;14;1;4;0;180;0;JULI
4296;SULAWESI BARAT;MAMUJU;TAPALANG;BELA;49;33;7;0;9;0;0;0;0;49;0;JULI
4297;SULAWESI BARAT;MAMUJU;TAPALANG;TAAN;217;80;75;1;51;2;0;7;0;216;1;JULI
4298;SULAWESI BARAT;MAMUJU;TAPALANG;TAMPALANG;155;68;30;2;38;3;0;10;1;152;3;JULI
4299;SULAWESI BARAT;MAMUJU;TAPALANG;RANTEDODA;72;34;13;9;11;0;0;5;0;72;0;JULI
4300;SULAWESI BARAT;MAMUJU;TAPALANG;KOPEANG;70;43;19;0;8;0;0;0;0;70;0;JULI
4301;SULAWESI BARAT;POLEWALI MANDAR;MAPILLI;MAPILI;113;40;10;6;38;4;0;15;0;113;0;JULI
4302;SULAWESI BARAT;POLEWALI MANDAR;MAPILLI;UGIBARU;240;60;54;40;36;8;0;25;0;223;17;JULI
4303;SULAWESI BARAT;POLEWALI MANDAR;MAPILLI;RUMPA;171;90;19;5;49;4;0;4;0;171;0;JULI
4304;SULAWESI BARAT;POLEWALI MANDAR;MAPILLI;KURMA;289;155;48;0;71;2;0;13;0;289;0;JULI
4305;SULAWESI BARAT;POLEWALI MANDAR;MAPILLI;BUKU;228;157;33;4;26;2;0;2;0;224;4;JULI
4306;SULAWESI BARAT;POLEWALI MANDAR;MAPILLI;BONNE BONNE;132;44;17;10;45;9;0;7;0;132;0;JULI
4307;SULAWESI BARAT;POLEWALI MANDAR;MAPILLI;BEROANGIN;221;71;27;1;99;4;0;14;1;217;4;JULI
4308;SULAWESI BARAT;POLEWALI MANDAR;MAPILLI;SEGERANG;162;95;34;4;21;1;0;7;0;162;0;JULI
4309;SULAWESI BARAT;POLEWALI MANDAR;MAPILLI;BONRA;166;77;48;0;32;1;0;8;0;166;0;JULI
4310;SULAWESI BARAT;POLEWALI MANDAR;MAPILLI;SATTOKO;85;20;9;0;50;1;0;5;0;85;0;JULI
4311;SULAWESI BARAT;POLEWALI MANDAR;MAPILLI;RAPPANG BARAT;301;96;105;2;69;4;0;24;0;300;1;JULI
4312;SULAWESI BARAT;POLEWALI MANDAR;MAPILLI;LANDI KANUSUANG;323;120;39;1;147;0;0;16;0;323;0;JULI
4313;SULAWESI BARAT;POLEWALI MANDAR;LUYO;BATUPANGA;233;112;40;4;63;2;1;7;0;229;4;JULI
4314;SULAWESI BARAT;POLEWALI MANDAR;LUYO;MAMBU;202;107;27;2;39;1;1;13;3;193;9;JULI
4315;SULAWESI BARAT;POLEWALI MANDAR;LUYO;TENGGELANG;267;136;54;11;48;0;1;7;0;257;10;JULI
4316;SULAWESI BARAT;POLEWALI MANDAR;LUYO;BARU;280;88;76;29;43;8;0;22;0;266;14;JULI
4317;SULAWESI BARAT;POLEWALI MANDAR;LUYO;PUSSUI;179;96;30;2;43;0;1;5;1;178;1;JULI
4318;SULAWESI BARAT;POLEWALI MANDAR;LUYO;MAPILI BARAT;189;109;41;12;17;0;0;10;0;189;0;JULI
4319;SULAWESI BARAT;POLEWALI MANDAR;LUYO;SAMBALI WALI;269;156;46;14;38;3;0;3;0;260;9;JULI
4320;SULAWESI BARAT;POLEWALI MANDAR;LUYO;BATUPANGA DAALA;316;150;51;3;105;0;1;5;0;315;1;JULI
4321;SULAWESI BARAT;POLEWALI MANDAR;LUYO;LUYO;199;98;25;5;51;2;2;15;0;198;1;JULI
4322;SULAWESI BARAT;POLEWALI MANDAR;LUYO;PUSSUI BARAT;114;54;14;3;26;13;1;2;0;113;1;JULI
4323;SULAWESI BARAT;POLEWALI MANDAR;LUYO;PUCCADI;201;145;22;0;24;3;0;7;0;201;0;JULI
4324;SULAWESI BARAT;MAMUJU;SAMPAGA;BUNDE;510;247;129;3;125;1;0;5;0;510;0;JULI
4325;SULAWESI BARAT;MAMUJU;SAMPAGA;KALONDING;449;178;182;8;73;4;0;3;0;448;1;JULI
4326;SULAWESI BARAT;MAMUJU;SAMPAGA;TARAILU;260;119;80;0;49;5;0;7;0;260;0;JULI
4327;SULAWESI BARAT;MAMUJU;SAMPAGA;SAMPAGA;184;88;65;2;25;1;0;2;1;184;0;JULI
4328;SULAWESI BARAT;MAMUJU;SAMPAGA;TANAMBUAH;68;24;25;0;18;0;0;1;0;68;0;JULI
4329;SULAWESI BARAT;MAMUJU;SAMPAGA;SALUBARANA;70;34;17;1;15;1;0;2;0;70;0;JULI
4330;SULAWESI BARAT;MAMUJU;SAMPAGA;LOSSO;132;49;28;0;54;0;0;0;0;131;1;JULI
4331;SULAWESI BARAT;POLEWALI MANDAR;TAPANGO;PELITAKAN;153;84;27;1;15;1;0;10;0;138;15;JULI
4332;SULAWESI BARAT;POLEWALI MANDAR;TAPANGO;TAPANGO;214;122;36;3;42;5;0;6;0;214;0;JULI
4333;SULAWESI BARAT;POLEWALI MANDAR;TAPANGO;RAPPANG;222;122;49;2;37;3;0;8;0;221;1;JULI
4334;SULAWESI BARAT;POLEWALI MANDAR;TAPANGO;DAKKA;150;69;34;3;36;2;0;4;0;148;2;JULI
4335;SULAWESI BARAT;POLEWALI MANDAR;TAPANGO;BATU;137;71;32;3;22;1;0;6;0;135;2;JULI
4336;SULAWESI BARAT;POLEWALI MANDAR;TAPANGO;RISO;178;102;11;0;54;4;0;5;0;176;2;JULI
4337;SULAWESI BARAT;POLEWALI MANDAR;TAPANGO;PALATTA;180;70;58;1;41;0;0;1;0;171;9;JULI
4338;SULAWESI BARAT;POLEWALI MANDAR;TAPANGO;TAPANGO BARAT;154;83;34;3;23;3;0;8;0;154;0;JULI
4339;SULAWESI BARAT;POLEWALI MANDAR;TAPANGO;KURRAK;75;42;24;0;7;1;0;1;0;75;0;JULI
4340;SULAWESI BARAT;POLEWALI MANDAR;TAPANGO;BUSSU;147;86;37;4;16;2;0;2;0;147;0;JULI
4341;SULAWESI BARAT;POLEWALI MANDAR;TAPANGO;TUTTULA;116;77;17;2;15;1;0;0;0;112;4;JULI
4342;SULAWESI BARAT;POLEWALI MANDAR;TAPANGO;JAMBU MALEA;192;73;75;3;29;0;0;12;0;192;0;JULI
4343;SULAWESI BARAT;POLEWALI MANDAR;TAPANGO;KALIMBUA;178;112;37;1;23;0;0;5;0;178;0;JULI
4344;SULAWESI BARAT;POLEWALI MANDAR;TAPANGO;BANATO REJO;326;200;78;0;34;6;0;3;0;321;5;JULI
4345;SULAWESI BARAT;MAMUJU TENGAH;BUDONG-BUDONG;BABANA;617;294;94;12;179;21;2;14;0;616;1;JULI
4346;SULAWESI BARAT;MAMUJU TENGAH;BUDONG-BUDONG;LUMU;245;107;30;0;94;4;0;8;0;243;2;JULI
4347;SULAWESI BARAT;MAMUJU TENGAH;BUDONG-BUDONG;PONTANAKAYANG;317;186;22;8;87;6;0;1;1;311;6;JULI
4348;SULAWESI BARAT;MAMUJU TENGAH;BUDONG-BUDONG;SALOGATTA;543;204;96;15;192;11;0;8;0;526;17;JULI
4349;SULAWESI BARAT;MAMUJU TENGAH;BUDONG-BUDONG;KIRE;149;47;29;0;71;0;0;2;0;149;0;JULI
4350;SULAWESI BARAT;MAMUJU TENGAH;BUDONG-BUDONG;TINALI;219;112;33;0;67;1;0;6;0;219;0;JULI
4351;SULAWESI BARAT;MAMUJU TENGAH;BUDONG-BUDONG;SALUMANURUNG;150;64;51;3;24;3;0;5;0;150;0;JULI
4352;SULAWESI BARAT;MAMUJU TENGAH;BUDONG-BUDONG;PASAPA;167;74;45;1;35;0;0;7;0;162;5;JULI
4353;SULAWESI BARAT;MAMUJU TENGAH;BUDONG-BUDONG;BOJO;230;99;52;1;67;5;0;6;0;230;0;JULI
4354;SULAWESI BARAT;MAMUJU TENGAH;BUDONG-BUDONG;BARAKKANG;119;54;21;3;37;1;0;3;0;119;0;JULI
4355;SULAWESI BARAT;MAMUJU TENGAH;BUDONG-BUDONG;LEMBAH HADA;57;27;10;0;18;1;0;1;0;57;0;JULI
4356;SULAWESI BARAT;MAMUJU;KALUMPANG;KALUMPANG;51;25;13;0;6;0;0;3;0;47;4;JULI
4357;SULAWESI BARAT;MAMUJU;KALUMPANG;KARATAUN;178;100;38;0;37;0;0;1;0;176;2;JULI
4358;SULAWESI BARAT;MAMUJU;KALUMPANG;KARAMA;122;50;50;0;21;0;0;1;0;122;0;JULI
4359;SULAWESI BARAT;MAMUJU;KALUMPANG;SIRAUN;97;56;21;0;18;0;0;0;1;96;1;JULI
4360;SULAWESI BARAT;MAMUJU;KALUMPANG;TUMOGA;73;35;10;0;22;0;0;0;0;67;6;JULI
4361;SULAWESI BARAT;MAMUJU;KALUMPANG;SALUMAKKI;92;64;14;0;12;0;0;0;0;90;2;JULI
4362;SULAWESI BARAT;MAMUJU;KALUMPANG;POLIO;63;31;24;0;8;0;0;0;0;63;0;JULI
4363;SULAWESI BARAT;MAMUJU;KALUMPANG;LIMBONG;89;25;18;0;44;1;0;1;0;89;0;JULI
4364;SULAWESI BARAT;MAMUJU;KALUMPANG;SANDAPANG;91;26;5;0;58;0;0;1;0;90;1;JULI
4365;SULAWESI BARAT;MAMUJU;KALUMPANG;KONDO BULO;84;51;26;0;5;0;0;1;0;83;1;JULI
4366;SULAWESI BARAT;MAMUJU;KALUMPANG;MAKKALIKI;70;35;18;0;17;0;0;0;0;70;0;JULI
4367;SULAWESI BARAT;MAMUJU;KALUMPANG;BATU MAKKADA;77;34;35;0;7;0;0;0;0;76;1;JULI
4368;SULAWESI BARAT;MAMUJU;KALUMPANG;LASA';117;72;25;0;16;0;0;0;1;114;3;JULI
4369;SULAWESI BARAT;POLEWALI MANDAR;TUTAR;TARAMANU;202;94;34;6;45;1;12;10;0;202;0;JULI
4370;SULAWESI BARAT;POLEWALI MANDAR;TUTAR;AMBOPADANG;272;99;55;0;114;2;0;2;0;272;0;JULI
4371;SULAWESI BARAT;POLEWALI MANDAR;TUTAR;TUBBI;131;43;66;4;7;3;0;8;0;131;0;JULI
4372;SULAWESI BARAT;POLEWALI MANDAR;TUTAR;RATTE;185;82;61;2;37;1;1;0;1;185;0;JULI
4373;SULAWESI BARAT;POLEWALI MANDAR;TUTAR;BESOANGIN;122;67;8;2;45;0;0;0;0;122;0;JULI
4374;SULAWESI BARAT;POLEWALI MANDAR;TUTAR;PIRIANG TAPIKO;114;34;58;0;20;0;0;2;0;114;0;JULI
4375;SULAWESI BARAT;POLEWALI MANDAR;TUTAR;PEBURRU;187;107;43;2;28;2;0;5;0;187;0;JULI
4376;SULAWESI BARAT;POLEWALI MANDAR;TUTAR;TALOBA;99;38;38;0;19;0;0;3;0;98;1;JULI
4377;SULAWESI BARAT;POLEWALI MANDAR;TUTAR;POLLEWANI;261;134;89;2;33;0;0;3;0;261;0;JULI
4378;SULAWESI BARAT;POLEWALI MANDAR;TUTAR;ARABUA;156;90;36;0;12;0;15;3;0;156;0;JULI
4379;SULAWESI BARAT;POLEWALI MANDAR;TUTAR;BESOANGIN UTARA;109;53;22;1;32;0;0;1;0;109;0;JULI
4380;SULAWESI BARAT;POLEWALI MANDAR;TUTAR;PODA;120;47;53;4;12;0;1;3;0;120;0;JULI
4381;SULAWESI BARAT;POLEWALI MANDAR;TUTAR;TARAMANU TUA;170;34;55;2;69;3;0;4;0;167;3;JULI
4382;SULAWESI BARAT;POLEWALI MANDAR;MATANGNGA;MATANGNGA;70;35;6;3;22;1;0;3;0;70;0;JULI
4383;SULAWESI BARAT;POLEWALI MANDAR;MATANGNGA;LILLI;110;41;15;1;51;0;0;1;0;109;1;JULI
4384;SULAWESI BARAT;POLEWALI MANDAR;MATANGNGA;RANGOAN;69;27;24;3;13;0;0;0;0;67;2;JULI
4385;SULAWESI BARAT;POLEWALI MANDAR;MATANGNGA;TAPUA;162;71;27;6;57;0;0;1;0;162;0;JULI
4386;SULAWESI BARAT;POLEWALI MANDAR;MATANGNGA;MAMBU TAPUA;96;32;13;1;47;0;0;3;0;96;0;JULI
4387;SULAWESI BARAT;POLEWALI MANDAR;MATANGNGA;BA'BA TAPUA;70;29;10;0;31;0;0;0;0;70;0;JULI
4388;SULAWESI BARAT;POLEWALI MANDAR;MATANGNGA;KATIMBANG;86;37;23;1;23;1;0;0;0;85;1;JULI
4389;SULAWESI BARAT;POLEWALI MANDAR;MATAKALI;MATAKALI;330;159;82;14;52;11;0;12;0;330;0;JULI
4390;SULAWESI BARAT;POLEWALI MANDAR;MATAKALI;PETAMPANUA;282;132;87;3;38;15;2;5;0;282;0;JULI
4391;SULAWESI BARAT;POLEWALI MANDAR;MATAKALI;BARUMBUNG;198;87;58;3;43;5;0;2;0;198;0;JULI
4392;SULAWESI BARAT;POLEWALI MANDAR;MATAKALI;PASIANG;399;139;80;11;133;11;0;21;0;395;4;JULI
4393;SULAWESI BARAT;POLEWALI MANDAR;MATAKALI;TONROLIMA;233;125;48;2;34;5;0;10;2;226;7;JULI
4394;SULAWESI BARAT;POLEWALI MANDAR;MATAKALI;INDOMAKKOMBONG;386;187;101;3;72;5;0;10;2;380;6;JULI
4395;SULAWESI BARAT;POLEWALI MANDAR;MATAKALI;BUNGA-BUNGA;144;67;47;6;19;1;0;4;0;144;0;JULI
4396;SULAWESI BARAT;PASANGKAYU;BULU TABA;LILIMORI;282;105;37;7;79;33;0;21;0;282;0;JULI
4397;SULAWESI BARAT;PASANGKAYU;BULU TABA;KARAVE;251;94;40;20;63;8;0;12;0;237;14;JULI
4398;SULAWESI BARAT;PASANGKAYU;BULU TABA;BUKIT HARAPAN;143;58;37;0;33;10;1;4;0;143;0;JULI
4399;SULAWESI BARAT;PASANGKAYU;BULU TABA;KASTABUANA;157;91;24;1;27;7;0;6;0;156;1;JULI
4400;SULAWESI BARAT;PASANGKAYU;BULU TABA;SUMBER SARI;31;24;5;0;2;0;0;0;0;31;0;JULI
4401;SULAWESI BARAT;PASANGKAYU;BULU TABA;LELEJAE;158;70;26;2;39;11;0;9;1;158;0;JULI
4402;SULAWESI BARAT;PASANGKAYU;BULU TABA;OMPI;100;44;30;3;18;3;0;2;0;100;0;JULI
4403;SULAWESI BARAT;PASANGKAYU;BAMBALAMOTU;BAMBALAMOTU;385;174;75;4;83;23;0;25;0;384;1;JULI
4404;SULAWESI BARAT;PASANGKAYU;BAMBALAMOTU;POLEWALI;435;156;138;2;92;30;0;17;0;435;0;JULI
4405;SULAWESI BARAT;PASANGKAYU;BAMBALAMOTU;RANDOMAYANG;438;149;66;2;156;19;0;36;0;428;10;JULI
4406;SULAWESI BARAT;PASANGKAYU;BAMBALAMOTU;PANGIANG;184;98;40;2;22;14;0;8;0;184;0;JULI
4407;SULAWESI BARAT;PASANGKAYU;BAMBALAMOTU;KALOLA;462;128;106;0;196;19;0;13;0;462;0;JULI
4408;SULAWESI BARAT;PASANGKAYU;BAMBALAMOTU;WULAI;263;62;69;0;113;6;0;13;0;263;0;JULI
4409;SULAWESI BARAT;PASANGKAYU;BAMBAIRA;BAMBAIRA;257;74;41;7;110;10;0;12;0;254;3;JULI
4410;SULAWESI BARAT;PASANGKAYU;BAMBAIRA;KASOLOANG;171;66;20;0;64;11;0;10;0;171;0;JULI
4411;SULAWESI BARAT;PASANGKAYU;BAMBAIRA;TAMPAURE;225;89;53;1;57;6;0;12;1;219;6;JULI
4412;SULAWESI BARAT;PASANGKAYU;BAMBAIRA;KALUKU NANGKA;279;135;61;3;62;5;0;13;0;279;0;JULI
4413;SULAWESI BARAT;MAMUJU TENGAH;TOBADAK;MAHAHE;327;132;69;11;85;14;0;11;4;326;1;JULI
4414;SULAWESI BARAT;MAMUJU TENGAH;TOBADAK;SALOBAJA;342;174;45;15;94;5;0;9;0;342;0;JULI
4415;SULAWESI BARAT;MAMUJU TENGAH;TOBADAK;TOBADAK;1301;551;262;23;324;43;2;31;1;1237;64;JULI
4416;SULAWESI BARAT;MAMUJU TENGAH;TOBADAK;PALONGAAN;282;102;85;6;67;4;0;17;0;281;1;JULI
4417;SULAWESI BARAT;MAMUJU TENGAH;TOBADAK;BATU PARIGI;728;159;243;13;257;24;1;22;0;719;9;JULI
4418;SULAWESI BARAT;MAMUJU TENGAH;TOBADAK;BAMBADARU;180;61;48;9;53;2;1;6;0;180;0;JULI
4419;SULAWESI BARAT;MAMUJU TENGAH;TOBADAK;SEJATI;150;82;30;2;29;2;0;5;0;150;0;JULI
4420;SULAWESI BARAT;MAMUJU TENGAH;TOBADAK;SALOADAK;259;120;18;1;99;10;0;9;0;257;2;JULI
4421;SULAWESI BARAT;PASANGKAYU;BARAS;BARAS;276;101;27;2;95;38;0;13;0;276;0;JULI
4422;SULAWESI BARAT;PASANGKAYU;BARAS;BALANTI;356;179;70;2;84;11;0;7;0;353;3;JULI
4423;SULAWESI BARAT;PASANGKAYU;BARAS;MOTU;555;197;124;10;125;63;0;33;0;552;3;JULI
4424;SULAWESI BARAT;PASANGKAYU;BARAS;BULU PARIGI;169;67;10;2;83;6;0;1;0;169;0;JULI
4425;SULAWESI BARAT;PASANGKAYU;BARAS;TOWONI;162;42;40;2;64;7;0;6;0;161;1;JULI
4426;SULAWESI BARAT;PASANGKAYU;BARAS;KASANO;294;179;32;0;71;10;0;2;0;294;0;JULI
4427;SULAWESI BARAT;MAJENE;BANGGAE TIMUR;BAURUNG;478;214;66;23;156;9;1;8;1;478;0;JULI
4428;SULAWESI BARAT;MAJENE;BANGGAE TIMUR;BARUGA;185;43;24;41;44;12;0;9;0;173;12;JULI
4429;SULAWESI BARAT;MAJENE;BANGGAE TIMUR;BARUGA DHUA;154;49;29;36;36;1;0;1;0;152;2;JULI
4430;SULAWESI BARAT;MAJENE;BANGGAE TIMUR;LABUANG;256;53;47;26;102;13;0;15;0;256;0;JULI
4431;SULAWESI BARAT;MAJENE;BANGGAE TIMUR;TANDE;107;18;24;27;25;3;0;3;0;100;7;JULI
4432;SULAWESI BARAT;MAJENE;BANGGAE TIMUR;LEMBANG;698;280;163;113;106;24;0;12;0;698;0;JULI
4433;SULAWESI BARAT;MAJENE;BANGGAE TIMUR;LABUANG UTARA;285;78;69;19;63;29;0;25;0;283;2;JULI
4434;SULAWESI BARAT;MAJENE;BANGGAE TIMUR;TANDE TIMUR;120;44;16;11;29;9;0;11;0;120;0;JULI
4435;SULAWESI BARAT;MAJENE;BANGGAE TIMUR;BUTTU BARUGA;55;9;7;1;35;0;0;1;1;54;1;JULI
4436;SULAWESI BARAT;MAJENE;SENDANA;MOSSO;331;146;87;4;61;20;1;10;1;330;1;JULI
4437;SULAWESI BARAT;MAJENE;SENDANA;MOSSO DHUA;97;29;24;5;12;12;2;5;0;89;8;JULI
4438;SULAWESI BARAT;MAJENE;SENDANA;TOTOLISI SENDANA;114;31;42;4;21;7;1;6;0;112;2;JULI
4439;SULAWESI BARAT;MAJENE;SENDANA;TALLUBANUA;139;44;32;14;12;19;1;7;0;129;10;JULI
4440;SULAWESI BARAT;MAJENE;SENDANA;LALATEDZONG;82;27;18;3;13;14;0;3;2;80;2;JULI
4441;SULAWESI BARAT;MAJENE;SENDANA;BINANGA;67;31;8;5;13;7;1;2;0;67;0;JULI
4442;SULAWESI BARAT;MAJENE;SENDANA;PUTTADA;61;38;15;0;6;1;0;1;0;61;0;JULI
4443;SULAWESI BARAT;MAJENE;SENDANA;PAMINGGALAN;41;31;10;0;0;0;0;0;0;41;0;JULI
4444;SULAWESI BARAT;MAJENE;SENDANA;LEPPANGANG;43;22;8;0;7;2;0;4;0;43;0;JULI
4445;SULAWESI BARAT;MAJENE;SENDANA;PUNDAU;65;4;28;6;21;3;0;3;0;65;0;JULI
4446;SULAWESI BARAT;MAJENE;SENDANA;SENDANA;77;40;22;1;0;6;1;7;0;77;0;JULI
4447;SULAWESI BARAT;MAJENE;SENDANA;BANUA SENDANA;95;56;11;4;1;18;0;5;0;95;0;JULI
4448;SULAWESI BARAT;MAJENE;SENDANA;TALLUBANUA UTARA;151;66;46;2;5;28;0;4;0;151;0;JULI
4449;SULAWESI BARAT;MAJENE;SENDANA;LIMBORO RAMBU-RAMBU;88;18;24;2;35;4;0;0;0;83;5;JULI
4450;SULAWESI BARAT;MAJENE;SENDANA;LIMBUA;90;31;22;2;20;12;0;3;0;90;0;JULI
4451;SULAWESI BARAT;MAJENE;SENDANA;BUKIT SAMANG;117;38;24;7;24;14;4;6;0;117;0;JULI
4452;SULAWESI BARAT;MAMUJU TENGAH;TOPOYO;BUDONG-BUDONG;236;96;65;3;46;8;0;10;0;228;8;JULI
4453;SULAWESI BARAT;MAMUJU TENGAH;TOPOYO;TOPOYO;905;301;216;15;181;57;0;26;0;796;109;JULI
4454;SULAWESI BARAT;MAMUJU TENGAH;TOPOYO;TUMBU;312;143;64;2;69;19;0;13;0;310;2;JULI
4455;SULAWESI BARAT;MAMUJU TENGAH;TOPOYO;KABUBU;269;77;42;14;117;14;1;4;0;269;0;JULI
4456;SULAWESI BARAT;MAMUJU TENGAH;TOPOYO;WAEPUTEH;279;149;26;16;76;6;0;3;0;276;3;JULI
4457;SULAWESI BARAT;MAMUJU TENGAH;TOPOYO;TANGKOU;125;59;28;0;31;3;0;2;2;125;0;JULI
4458;SULAWESI BARAT;MAMUJU TENGAH;TOPOYO;TABOLANG;443;161;98;13;102;8;1;9;2;394;49;JULI
4459;SULAWESI BARAT;MAMUJU TENGAH;TOPOYO;PARAILI;162;89;29;1;25;13;1;4;0;162;0;JULI
4460;SULAWESI BARAT;MAMUJU TENGAH;TOPOYO;SALUPANGKANG;466;132;62;10;248;9;0;3;1;465;1;JULI
4461;SULAWESI BARAT;MAMUJU TENGAH;TOPOYO;SALUPANGKANG IV;55;31;4;0;19;0;0;1;0;55;0;JULI
4462;SULAWESI BARAT;MAMUJU TENGAH;TOPOYO;TAPPILINA;152;46;37;11;37;14;0;7;0;152;0;JULI
4463;SULAWESI BARAT;MAMUJU TENGAH;TOPOYO;BAMBAMANURUNG;150;68;9;4;61;6;0;0;2;150;0;JULI
4464;SULAWESI BARAT;MAMUJU TENGAH;TOPOYO;SALULEKBO;386;152;88;5;137;2;0;1;0;385;1;JULI
4465;SULAWESI BARAT;MAMUJU TENGAH;TOPOYO;PANGALLOANG;255;82;56;2;107;6;0;2;0;255;0;JULI
4466;SULAWESI BARAT;MAMUJU TENGAH;TOPOYO;SINABATTA;100;47;30;1;12;6;0;1;0;97;3;JULI
4467;SULAWESI BARAT;MAMUJU TENGAH;KAROSSA;KAROSSA;614;293;116;7;168;12;1;16;1;614;0;JULI
4468;SULAWESI BARAT;MAMUJU TENGAH;KAROSSA;TASOKKO;432;168;111;6;113;9;0;25;0;432;0;JULI
4469;SULAWESI BARAT;MAMUJU TENGAH;KAROSSA;LARA;119;36;12;2;61;4;1;3;0;119;0;JULI
4470;SULAWESI BARAT;MAMUJU TENGAH;KAROSSA;KADAILA;155;49;28;2;72;3;0;1;0;155;0;JULI
4471;SULAWESI BARAT;MAMUJU TENGAH;KAROSSA;KAYU CALLA;70;24;14;3;27;1;0;0;0;69;1;JULI
4472;SULAWESI BARAT;MAMUJU TENGAH;KAROSSA;LEMBAH HOPO;141;45;14;7;64;1;0;10;0;141;0;JULI
4473;SULAWESI BARAT;MAMUJU TENGAH;KAROSSA;BENGGAULU;251;117;58;1;59;8;0;7;0;250;1;JULI
4474;SULAWESI BARAT;MAMUJU TENGAH;KAROSSA;SUKA MAJU;99;35;36;1;21;2;0;1;0;96;3;JULI
4475;SULAWESI BARAT;MAMUJU TENGAH;KAROSSA;KAMBUNONG;284;149;64;2;48;8;0;12;0;283;1;JULI
4476;SULAWESI BARAT;MAMUJU TENGAH;KAROSSA;SALUBIRO;156;82;31;1;33;0;0;9;0;156;0;JULI
4477;SULAWESI BARAT;MAMUJU TENGAH;KAROSSA;SANJANGO;149;49;35;2;55;1;4;3;0;149;0;JULI
4478;SULAWESI BARAT;POLEWALI MANDAR;ALLU;PETOOSANG;81;26;19;7;15;3;0;9;0;79;2;JULI
4479;SULAWESI BARAT;POLEWALI MANDAR;ALLU;MOMBI;132;59;24;6;32;0;4;5;1;131;1;JULI
4480;SULAWESI BARAT;POLEWALI MANDAR;ALLU;KALUMAMMANG;95;39;29;0;21;0;0;6;0;95;0;JULI
4481;SULAWESI BARAT;POLEWALI MANDAR;ALLU;PAO-PAO;199;76;58;0;63;0;0;2;0;199;0;JULI
4482;SULAWESI BARAT;POLEWALI MANDAR;ALLU;PUPPU URING;211;84;84;1;23;0;1;1;2;196;15;JULI
4483;SULAWESI BARAT;POLEWALI MANDAR;ALLU;SARAGIAN;118;64;24;5;17;0;0;8;0;118;0;JULI
4484;SULAWESI BARAT;POLEWALI MANDAR;ALLU;SAYOANG;42;20;16;0;4;1;0;1;0;42;0;JULI
4485;SULAWESI BARAT;POLEWALI MANDAR;ALLU;ALU;121;50;39;10;19;1;0;2;0;121;0;JULI
4486;SULAWESI BARAT;MAMUJU;TOMMO;TOMMO;332;118;73;1;125;6;0;9;0;332;0;JULI
4487;SULAWESI BARAT;MAMUJU;TOMMO;CAMPALOGA;292;84;120;11;66;6;0;1;0;288;4;JULI
4488;SULAWESI BARAT;MAMUJU;TOMMO;BUANA SAKTI;213;80;48;1;83;1;0;0;0;213;0;JULI
4489;SULAWESI BARAT;MAMUJU;TOMMO;TAMEMONGGA;223;79;106;0;33;2;0;3;0;223;0;JULI
4490;SULAWESI BARAT;MAMUJU;TOMMO;TAMEJARRA;200;68;58;4;50;7;1;12;0;200;0;JULI
4491;SULAWESI BARAT;MAMUJU;TOMMO;RANTEMARIO;162;61;64;3;19;6;0;5;0;158;4;JULI
4492;SULAWESI BARAT;MAMUJU;TOMMO;MALINO;76;42;20;6;4;1;0;2;0;75;1;JULI
4493;SULAWESI BARAT;MAMUJU;TOMMO;KAKULLASANG;364;146;140;7;57;1;0;6;2;359;5;JULI
4494;SULAWESI BARAT;MAMUJU;TOMMO;LELING;135;40;64;0;29;0;0;2;0;135;0;JULI
4495;SULAWESI BARAT;MAMUJU;TOMMO;KALEPU;109;51;52;1;4;1;0;0;0;109;0;JULI
4496;SULAWESI BARAT;MAMUJU;TOMMO;SANDANA;133;51;51;1;18;2;0;9;1;133;0;JULI
4497;SULAWESI BARAT;MAMUJU;TOMMO;LELING BARAT;206;61;87;3;45;6;0;3;0;205;1;JULI
4498;SULAWESI BARAT;MAMUJU;TOMMO;LELING UTARA;193;76;95;0;22;0;0;0;0;193;0;JULI
4499;SULAWESI BARAT;MAMUJU;TOMMO;SALUDENGEN;136;70;58;0;7;0;0;1;0;136;0;JULI
4500;SULAWESI BARAT;MAMASA;MESSAWA;MESSAWA;36;10;16;0;5;0;0;5;0;36;0;JULI
4501;SULAWESI BARAT;MAMASA;MESSAWA;RIPPUNG;129;60;53;0;14;1;0;0;0;128;1;JULI
4502;SULAWESI BARAT;MAMASA;MESSAWA;MAKUANG;104;58;30;1;15;0;0;0;0;104;0;JULI
4503;SULAWESI BARAT;MAMASA;MESSAWA;SEPANG;73;31;33;0;8;0;0;1;0;73;0;JULI
4504;SULAWESI BARAT;MAMASA;MESSAWA;MALIMBONG;53;17;30;0;5;0;0;1;0;53;0;JULI
4505;SULAWESI BARAT;MAMASA;MESSAWA;MATANDE;83;16;50;5;7;3;0;2;0;83;0;JULI
4506;SULAWESI BARAT;MAMASA;MESSAWA;SIPAI;80;38;33;0;9;0;0;0;0;80;0;JULI
4507;SULAWESI BARAT;MAMASA;MESSAWA;PASMA MAMBU;49;12;21;0;15;0;0;1;0;49;0;JULI
4508;SULAWESI BARAT;MAMASA;MESSAWA;TANETE BATU;53;26;22;0;3;0;0;1;0;52;1;JULI
4509;SULAWESI BARAT;PASANGKAYU;SARJO;SARJO;267;81;45;23;63;12;0;42;0;266;1;JULI
4510;SULAWESI BARAT;PASANGKAYU;SARJO;MAPONU;132;42;32;0;42;10;0;4;1;131;1;JULI
4511;SULAWESI BARAT;PASANGKAYU;SARJO;LETAWA;203;74;24;16;62;9;1;16;0;202;1;JULI
4512;SULAWESI BARAT;PASANGKAYU;SARJO;SARUDE;238;53;47;27;76;13;0;21;0;237;1;JULI
4513;SULAWESI BARAT;MAJENE;PAMBOANG;LALAMPANUA;103;21;9;17;35;7;0;11;2;102;1;JULI
4514;SULAWESI BARAT;MAJENE;PAMBOANG;SIRINDU;132;27;18;2;61;10;0;14;0;132;0;JULI
4515;SULAWESI BARAT;MAJENE;PAMBOANG;ADOLANG;96;23;5;1;59;3;0;5;0;96;0;JULI
4516;SULAWESI BARAT;MAJENE;PAMBOANG;BABABULO;172;81;26;8;43;6;1;7;0;172;0;JULI
4517;SULAWESI BARAT;MAJENE;PAMBOANG;BONDE;208;123;48;4;11;8;0;12;0;206;2;JULI
4518;SULAWESI BARAT;MAJENE;PAMBOANG;BETTENG;103;63;8;0;28;1;0;3;0;103;0;JULI
4519;SULAWESI BARAT;MAJENE;PAMBOANG;SIMBANG;59;14;12;6;20;3;1;3;0;59;0;JULI
4520;SULAWESI BARAT;MAJENE;PAMBOANG;BONDE UTARA;325;204;43;5;36;12;2;16;0;318;7;JULI
4521;SULAWESI BARAT;MAJENE;PAMBOANG;BABABULO UTARA;108;55;20;12;12;3;0;6;0;108;0;JULI
4522;SULAWESI BARAT;MAJENE;PAMBOANG;BUTTU PAMBOANG;97;39;18;3;27;4;0;6;0;97;0;JULI
4523;SULAWESI BARAT;MAJENE;PAMBOANG;BANUA ADOLANG;79;25;23;0;27;1;0;3;0;79;0;JULI
4524;SULAWESI BARAT;MAJENE;PAMBOANG;ADOLANG DHUA;89;35;4;2;36;0;1;7;0;85;4;JULI
4525;SULAWESI BARAT;MAJENE;PAMBOANG;TINAMBUNG;178;44;40;17;51;5;0;21;0;178;0;JULI
4526;SULAWESI BARAT;MAJENE;PAMBOANG;PESULOANG;92;29;8;6;34;1;3;11;0;92;0;JULI
4527;SULAWESI BARAT;MAJENE;PAMBOANG;BALOMBONG;91;25;10;2;43;6;0;5;0;91;0;JULI
4528;SULAWESI BARAT;MAJENE;ULUMANDA;KABIRAAN;144;95;16;2;26;1;0;4;0;144;0;JULI
4529;SULAWESI BARAT;MAJENE;ULUMANDA;SAMBABO;93;45;16;2;26;0;0;2;0;91;2;JULI
4530;SULAWESI BARAT;MAJENE;ULUMANDA;TANDEALLO;129;65;41;1;5;1;2;13;0;128;1;JULI
4531;SULAWESI BARAT;MAJENE;ULUMANDA;ULUMANDA;143;44;74;3;7;4;1;10;0;143;0;JULI
4532;SULAWESI BARAT;MAJENE;ULUMANDA;SALUTAMBUNG;110;74;19;2;11;0;0;4;0;110;0;JULI
4533;SULAWESI BARAT;MAJENE;ULUMANDA;POPENGA;79;60;15;0;1;0;0;3;0;79;0;JULI
4534;SULAWESI BARAT;MAJENE;ULUMANDA;SULAI;126;55;44;5;15;0;0;6;0;125;1;JULI
4535;SULAWESI BARAT;MAJENE;ULUMANDA;PANGGALO;104;52;36;3;8;2;0;1;0;102;2;JULI
4536;SULAWESI BARAT;MAMASA;BAMBANG;MOKALLANG;41;16;22;0;2;0;0;1;0;41;0;AGUSTUS
4537;SULAWESI BARAT;MAMASA;BAMBANG;MASOSO;45;21;12;0;12;0;0;0;0;45;0;AGUSTUS
4538;SULAWESI BARAT;MAMASA;BAMBANG;SALUASSING;125;90;22;4;8;0;0;1;0;125;0;AGUSTUS
4539;SULAWESI BARAT;MAMASA;BAMBANG;SALUBULO;60;20;20;0;13;1;0;0;0;54;6;AGUSTUS
4540;SULAWESI BARAT;MAMASA;BAMBANG;SALUKADI;73;33;33;0;7;0;0;0;0;73;0;AGUSTUS
4541;SULAWESI BARAT;MAMASA;BAMBANG;SALUKEPOPOK;86;47;12;3;22;1;0;0;0;85;1;AGUSTUS
4542;SULAWESI BARAT;MAMASA;BAMBANG;ULUMAMBI BARAT;62;29;33;0;0;0;0;0;0;62;0;AGUSTUS
4543;SULAWESI BARAT;MAMASA;BAMBANG;LIMBADEBATA;107;34;14;1;54;1;0;3;0;107;0;AGUSTUS
4544;SULAWESI BARAT;MAMASA;BAMBANG;TANETE TOMBA;54;27;25;0;2;0;0;0;0;54;0;AGUSTUS
4545;SULAWESI BARAT;MAMASA;BAMBANG;BAMBANG;132;83;17;0;25;3;0;3;0;131;1;AGUSTUS
4546;SULAWESI BARAT;MAMASA;BAMBANG;RANTELEMO;51;12;25;0;12;2;0;0;0;51;0;AGUSTUS
4547;SULAWESI BARAT;MAMASA;BAMBANG;SALUDENGEN;36;8;24;0;1;1;0;0;0;34;2;AGUSTUS
4548;SULAWESI BARAT;MAMASA;BAMBANG;ULUMAMBI;65;10;48;1;0;0;0;0;0;59;6;AGUSTUS
4549;SULAWESI BARAT;MAMASA;BAMBANG;BAMBANG TIMUR;72;46;22;0;2;1;0;1;0;72;0;AGUSTUS
4550;SULAWESI BARAT;MAMASA;BAMBANG;MINANGA;128;40;45;0;38;1;0;4;0;128;0;AGUSTUS
4551;SULAWESI BARAT;MAMASA;BAMBANG;SIKAMASE;55;20;34;0;1;0;0;0;0;55;0;AGUSTUS
4552;SULAWESI BARAT;MAMASA;BAMBANG;RANTETARIMA;32;2;30;0;0;0;0;0;0;32;0;AGUSTUS
4553;SULAWESI BARAT;MAMASA;BAMBANG;SALURURU;32;4;2;3;22;0;0;1;0;32;0;AGUSTUS
4554;SULAWESI BARAT;MAMASA;BAMBANG;SALUTABANG;34;18;10;1;2;2;0;1;0;34;0;AGUSTUS
4555;SULAWESI BARAT;MAMASA;BAMBANG;BALATANA;40;30;9;0;1;0;0;0;0;40;0;AGUSTUS
4556;SULAWESI BARAT;MAMASA;BUNTUMALANGKA;BUNTUMALANGKA;131;29;64;2;26;4;0;5;0;130;1;AGUSTUS
4557;SULAWESI BARAT;MAMASA;BUNTUMALANGKA;RANTEBERAN;111;61;43;0;6;0;0;1;0;111;0;AGUSTUS
4558;SULAWESI BARAT;MAMASA;BUNTUMALANGKA;KEBANGA;42;9;18;0;14;0;0;0;1;42;0;AGUSTUS
4559;SULAWESI BARAT;MAMASA;BUNTUMALANGKA;SALURINDU;53;27;16;1;7;0;0;2;0;53;0;AGUSTUS
4560;SULAWESI BARAT;MAMASA;BUNTUMALANGKA;TAORA;43;10;27;2;2;0;0;2;0;43;0;AGUSTUS
4561;SULAWESI BARAT;MAMASA;BUNTUMALANGKA;KABAE;71;10;56;0;4;0;0;1;0;71;0;AGUSTUS
4562;SULAWESI BARAT;MAMASA;BUNTUMALANGKA;SALUTAMBUN BARAT;59;23;34;0;1;0;0;0;1;59;0;AGUSTUS
4563;SULAWESI BARAT;MAMASA;BUNTUMALANGKA;PENATANGAN;106;39;34;0;23;3;0;1;0;100;6;AGUSTUS
4564;SULAWESI BARAT;MAMASA;BUNTUMALANGKA;SALUTAMBUN TIMUR;38;16;19;0;1;0;0;2;0;38;0;AGUSTUS
4565;SULAWESI BARAT;MAMASA;BUNTUMALANGKA;SALUTAMBUN;28;9;14;0;2;1;0;2;0;28;0;AGUSTUS
4566;SULAWESI BARAT;MAMASA;BUNTUMALANGKA;ARALLE TIMUR;94;34;51;0;3;0;0;1;0;89;5;AGUSTUS
4567;SULAWESI BARAT;MAMASA;MEHALAAN;MEHALAAN;52;21;16;1;12;0;0;2;0;52;0;AGUSTUS
4568;SULAWESI BARAT;MAMASA;MEHALAAN;BOTTENG;75;31;15;0;27;0;1;1;0;75;0;AGUSTUS
4569;SULAWESI BARAT;MAMASA;MEHALAAN;SALUKONTA;56;27;10;1;17;0;0;1;0;56;0;AGUSTUS
4570;SULAWESI BARAT;MAMASA;MEHALAAN;MESAKADA;54;19;16;1;17;0;0;1;0;54;0;AGUSTUS
4571;SULAWESI BARAT;MAMASA;MEHALAAN;MEHALAAN BARAT;91;32;25;0;31;0;0;3;0;91;0;AGUSTUS
4572;SULAWESI BARAT;MAMASA;MEHALAAN;SALUAHOK;69;20;24;1;22;0;0;2;0;69;0;AGUSTUS
4573;SULAWESI BARAT;MAMASA;MEHALAAN;SALUBALO;41;22;12;0;7;0;0;0;0;41;0;AGUSTUS
4574;SULAWESI BARAT;MAMASA;MEHALAAN;PASSEMBUK;43;18;12;0;13;0;0;0;0;43;0;AGUSTUS
4575;SULAWESI BARAT;MAMASA;MEHALAAN;KONDO;34;17;9;0;7;0;0;1;0;34;0;AGUSTUS
4576;SULAWESI BARAT;MAMASA;MEHALAAN;LEKO SUKAMAJU;32;12;10;0;9;0;0;1;0;32;0;AGUSTUS
4577;SULAWESI BARAT;MAMASA;MEHALAAN;ULUMEA;26;15;3;0;8;0;0;0;0;26;0;AGUSTUS
4578;SULAWESI BARAT;PASANGKAYU;TIKKE RAYA;TIKKE;312;86;54;3;102;41;0;12;1;299;13;AGUSTUS
4579;SULAWESI BARAT;PASANGKAYU;TIKKE RAYA;MAKMUR JAYA;465;166;117;4;128;26;0;20;1;462;3;AGUSTUS
4580;SULAWESI BARAT;PASANGKAYU;TIKKE RAYA;LARIANG;408;136;83;1;158;16;0;10;0;404;4;AGUSTUS
4581;SULAWESI BARAT;PASANGKAYU;TIKKE RAYA;PAJALELE;359;132;80;3;100;23;0;16;1;355;4;AGUSTUS
4582;SULAWESI BARAT;PASANGKAYU;TIKKE RAYA;JENGENG RAYA;190;58;41;8;54;21;0;8;0;190;0;AGUSTUS
4583;SULAWESI BARAT;MAMASA;NOSU;NOSU;79;4;39;1;21;7;0;5;0;77;2;AGUSTUS
4584;SULAWESI BARAT;MAMASA;NOSU;MINANGA;25;4;11;1;8;0;0;1;0;25;0;AGUSTUS
4585;SULAWESI BARAT;MAMASA;NOSU;BATUPAPAN;55;18;20;1;15;1;0;0;0;55;0;AGUSTUS
4586;SULAWESI BARAT;MAMASA;NOSU;MASEWWE;35;13;3;0;18;0;0;1;0;35;0;AGUSTUS
4587;SULAWESI BARAT;MAMASA;NOSU;SIWI;23;10;3;1;7;1;0;1;0;23;0;AGUSTUS
4588;SULAWESI BARAT;MAMASA;NOSU;MINANGA TIMUR;11;3;2;0;6;0;0;0;0;11;0;AGUSTUS
4589;SULAWESI BARAT;MAMASA;NOSU;PARINDING;23;2;16;0;5;0;0;0;0;23;0;AGUSTUS
4590;SULAWESI BARAT;MAMASA;MAMBI;MAMBI;80;47;19;2;10;1;0;1;0;80;0;AGUSTUS
4591;SULAWESI BARAT;MAMASA;MAMBI;TALIPUKKI;124;93;11;4;10;2;0;3;0;123;1;AGUSTUS
4592;SULAWESI BARAT;MAMASA;MAMBI;RANTEBULAHAN;50;13;29;0;6;1;0;0;0;49;1;AGUSTUS
4593;SULAWESI BARAT;MAMASA;MAMBI;SONDONGLAYU;36;13;4;5;8;0;0;5;0;35;1;AGUSTUS
4594;SULAWESI BARAT;MAMASA;MAMBI;SALUBANUA;31;13;16;0;1;0;0;0;0;30;1;AGUSTUS
4595;SULAWESI BARAT;MAMASA;MAMBI;TAPALINA;85;49;28;2;0;0;0;1;0;80;5;AGUSTUS
4596;SULAWESI BARAT;MAMASA;MAMBI;SENDANA;148;61;68;3;16;0;0;0;0;148;0;AGUSTUS
4597;SULAWESI BARAT;MAMASA;MAMBI;PAMOSEAN;47;39;7;1;0;0;0;0;0;47;0;AGUSTUS
4598;SULAWESI BARAT;MAMASA;MAMBI;SELUMAKA;111;27;84;0;0;0;0;0;0;111;0;AGUSTUS
4599;SULAWESI BARAT;MAMASA;MAMBI;BUJUNG MANURUNG;43;22;17;1;2;1;0;0;0;43;0;AGUSTUS
4600;SULAWESI BARAT;MAMASA;MAMBI;SALU ALO;77;27;44;0;6;0;0;0;0;77;0;AGUSTUS
4601;SULAWESI BARAT;MAMASA;MAMBI;INDOBANUA;13;4;3;0;2;4;0;0;0;13;0;AGUSTUS
4602;SULAWESI BARAT;MAMASA;MAMBI;SALUDURIAN;93;28;53;0;9;2;0;1;0;93;0;AGUSTUS
4603;SULAWESI BARAT;PASANGKAYU;PEDONGGA;MALEI;225;111;62;1;34;15;0;2;0;225;0;AGUSTUS
4604;SULAWESI BARAT;PASANGKAYU;PEDONGGA;PEDANDA;202;54;55;3;76;7;0;6;0;201;1;AGUSTUS
4605;SULAWESI BARAT;PASANGKAYU;PEDONGGA;BATU OGE;146;61;28;2;46;8;0;1;0;146;0;AGUSTUS
4606;SULAWESI BARAT;PASANGKAYU;PEDONGGA;MARTASARI;547;203;64;5;239;23;0;11;0;545;2;AGUSTUS
4607;SULAWESI BARAT;POLEWALI MANDAR;BALANIPA;BALANIPA;188;84;37;13;35;8;0;11;0;188;0;AGUSTUS
4608;SULAWESI BARAT;POLEWALI MANDAR;BALANIPA;TAMMAJARRA;177;124;13;18;15;4;0;3;0;177;0;AGUSTUS
4609;SULAWESI BARAT;POLEWALI MANDAR;BALANIPA;TAMANGGALLE;111;60;19;0;28;1;0;2;1;111;0;AGUSTUS
4610;SULAWESI BARAT;POLEWALI MANDAR;BALANIPA;MOSSO;78;53;15;5;4;0;0;1;0;78;0;AGUSTUS
4611;SULAWESI BARAT;POLEWALI MANDAR;BALANIPA;GALUNG TULUK;189;99;39;19;20;1;0;11;0;189;0;AGUSTUS
4612;SULAWESI BARAT;POLEWALI MANDAR;BALANIPA;SABANG SUBIK;206;124;25;9;24;5;0;19;0;206;0;AGUSTUS
4613;SULAWESI BARAT;POLEWALI MANDAR;BALANIPA;PAMBUSUANG;415;232;70;11;35;10;1;29;1;389;26;AGUSTUS
4614;SULAWESI BARAT;POLEWALI MANDAR;BALANIPA;BALA;323;244;30;2;20;5;0;19;0;320;3;AGUSTUS
4615;SULAWESI BARAT;POLEWALI MANDAR;BALANIPA;LAMBANAN;13;5;2;3;2;0;0;1;0;13;0;AGUSTUS
4616;SULAWESI BARAT;POLEWALI MANDAR;BALANIPA;LEGO;104;65;26;0;5;0;0;8;0;104;0;AGUSTUS
4617;SULAWESI BARAT;POLEWALI MANDAR;BALANIPA;PALLIS;27;11;8;1;4;1;0;2;0;27;0;AGUSTUS
4618;SULAWESI BARAT;POLEWALI MANDAR;BULO;BULO;107;20;10;2;73;2;0;0;0;107;0;AGUSTUS
4619;SULAWESI BARAT;POLEWALI MANDAR;BULO;PULLIWA;306;100;50;3;139;3;0;10;0;305;1;AGUSTUS
4620;SULAWESI BARAT;POLEWALI MANDAR;BULO;PATAMBANUA;144;28;106;0;7;0;0;1;0;142;2;AGUSTUS
4621;SULAWESI BARAT;POLEWALI MANDAR;BULO;KAROMBANG;140;80;20;0;37;2;0;1;0;140;0;AGUSTUS
4622;SULAWESI BARAT;POLEWALI MANDAR;BULO;DAALA TIMUR;127;43;60;2;21;0;0;1;0;127;0;AGUSTUS
4623;SULAWESI BARAT;POLEWALI MANDAR;BULO;LENGGO;53;18;29;1;4;1;0;0;0;53;0;AGUSTUS
4624;SULAWESI BARAT;POLEWALI MANDAR;BULO;SABURA;67;30;28;0;8;0;0;1;0;67;0;AGUSTUS
4625;SULAWESI BARAT;POLEWALI MANDAR;BULO;SEPPORRAKI;99;28;24;0;45;0;0;2;0;99;0;AGUSTUS
4626;SULAWESI BARAT;POLEWALI MANDAR;BULO;IHING;115;25;24;2;59;1;0;1;0;112;3;AGUSTUS
4627;SULAWESI BARAT;POLEWALI MANDAR;ANREAPI;ANREAPI;167;33;53;6;48;11;0;13;1;165;2;AGUSTUS
4628;SULAWESI BARAT;POLEWALI MANDAR;ANREAPI;DUAMPANUA;397;117;144;23;86;4;0;17;0;391;6;AGUSTUS
4629;SULAWESI BARAT;POLEWALI MANDAR;ANREAPI;KELAPA DUA;272;75;122;3;54;2;2;13;0;271;1;AGUSTUS
4630;SULAWESI BARAT;POLEWALI MANDAR;ANREAPI;PAPPANDANGAN;248;91;69;10;64;2;3;8;0;247;1;AGUSTUS
4631;SULAWESI BARAT;POLEWALI MANDAR;ANREAPI;KUNYI;239;39;108;4;66;4;0;11;1;233;6;AGUSTUS
4632;SULAWESI BARAT;MAMUJU;PAPALANG;TOABO;634;273;152;4;192;9;0;3;0;633;1;AGUSTUS
4633;SULAWESI BARAT;MAMUJU;PAPALANG;PAPALANG;679;317;176;8;136;3;0;5;0;645;34;AGUSTUS
4634;SULAWESI BARAT;MAMUJU;PAPALANG;BONDA;316;173;89;3;48;1;0;1;0;315;1;AGUSTUS
4635;SULAWESI BARAT;MAMUJU;PAPALANG;TOPORE;189;99;40;7;34;1;0;2;0;183;6;AGUSTUS
4636;SULAWESI BARAT;MAMUJU;PAPALANG;SALUKAYU;251;123;86;2;31;3;0;6;0;251;0;AGUSTUS
4637;SULAWESI BARAT;MAMUJU;PAPALANG;SUKADAMAI;107;55;35;1;12;0;0;4;0;107;0;AGUSTUS
4638;SULAWESI BARAT;MAMUJU;PAPALANG;BODA-BODA;185;98;67;1;18;0;0;1;0;185;0;AGUSTUS
4639;SULAWESI BARAT;MAMUJU;PAPALANG;SISANGO;105;33;62;0;5;3;0;1;0;104;1;AGUSTUS
4640;SULAWESI BARAT;MAMUJU;PAPALANG;BATU AMPA;163;50;85;11;17;0;0;0;0;163;0;AGUSTUS
4641;SULAWESI BARAT;POLEWALI MANDAR;TAPANGO;PELITAKAN;152;84;27;1;14;1;0;10;0;137;15;AGUSTUS
4642;SULAWESI BARAT;POLEWALI MANDAR;TAPANGO;TAPANGO;214;121;38;3;41;5;0;6;0;214;0;AGUSTUS
4643;SULAWESI BARAT;POLEWALI MANDAR;TAPANGO;RAPPANG;222;122;49;2;37;3;0;8;0;221;1;AGUSTUS
4644;SULAWESI BARAT;POLEWALI MANDAR;TAPANGO;DAKKA;151;69;34;3;37;2;0;4;0;149;2;AGUSTUS
4645;SULAWESI BARAT;POLEWALI MANDAR;TAPANGO;BATU;137;72;31;2;23;1;0;6;0;135;2;AGUSTUS
4646;SULAWESI BARAT;POLEWALI MANDAR;TAPANGO;RISO;181;104;11;0;54;4;0;6;0;179;2;AGUSTUS
4647;SULAWESI BARAT;POLEWALI MANDAR;TAPANGO;PALATTA;179;68;60;0;41;0;0;1;0;170;9;AGUSTUS
4648;SULAWESI BARAT;POLEWALI MANDAR;TAPANGO;TAPANGO BARAT;154;82;34;3;24;3;0;8;0;154;0;AGUSTUS
4649;SULAWESI BARAT;POLEWALI MANDAR;TAPANGO;KURRAK;76;43;25;0;6;1;0;1;0;76;0;AGUSTUS
4650;SULAWESI BARAT;POLEWALI MANDAR;TAPANGO;BUSSU;146;88;36;4;15;1;0;2;0;146;0;AGUSTUS
4651;SULAWESI BARAT;POLEWALI MANDAR;TAPANGO;TUTTULA;117;77;18;2;15;1;0;0;0;113;4;AGUSTUS
4652;SULAWESI BARAT;POLEWALI MANDAR;TAPANGO;JAMBU MALEA;195;73;76;3;30;0;0;13;0;195;0;AGUSTUS
4653;SULAWESI BARAT;POLEWALI MANDAR;TAPANGO;KALIMBUA;178;111;38;1;23;0;0;5;0;178;0;AGUSTUS
4654;SULAWESI BARAT;POLEWALI MANDAR;TAPANGO;BANATO REJO;326;201;77;0;34;6;0;3;0;321;5;AGUSTUS
4655;SULAWESI BARAT;POLEWALI MANDAR;POLEWALI;POLEWALI;513;158;150;40;76;32;0;46;0;502;11;AGUSTUS
4656;SULAWESI BARAT;POLEWALI MANDAR;POLEWALI;WATTANG;188;60;58;12;24;17;0;17;0;188;0;AGUSTUS
4657;SULAWESI BARAT;POLEWALI MANDAR;POLEWALI;SULEWATANG;345;78;168;5;73;6;0;15;0;345;0;AGUSTUS
4658;SULAWESI BARAT;POLEWALI MANDAR;POLEWALI;LANTORA;411;108;164;23;52;34;0;30;0;411;0;AGUSTUS
4659;SULAWESI BARAT;POLEWALI MANDAR;POLEWALI;TAKATIDUNG;503;230;108;25;76;22;0;26;0;487;16;AGUSTUS
4660;SULAWESI BARAT;POLEWALI MANDAR;POLEWALI;PEKKABATA;308;136;57;28;42;26;0;18;0;307;1;AGUSTUS
4661;SULAWESI BARAT;POLEWALI MANDAR;POLEWALI;MADATE;568;196;159;73;86;22;0;32;0;568;0;AGUSTUS
4662;SULAWESI BARAT;POLEWALI MANDAR;POLEWALI;MANDING;399;127;107;16;91;20;0;37;0;398;1;AGUSTUS
4663;SULAWESI BARAT;POLEWALI MANDAR;POLEWALI;DARMA;552;196;167;30;113;16;0;30;0;552;0;AGUSTUS
4664;SULAWESI BARAT;MAMUJU;BONEHAU;BONEHAU;167;44;86;3;23;2;0;3;0;161;6;AGUSTUS
4665;SULAWESI BARAT;MAMUJU;BONEHAU;SALUTIWO;92;33;38;2;19;0;0;0;0;92;0;AGUSTUS
4666;SULAWESI BARAT;MAMUJU;BONEHAU;BUTTUADA;202;8;171;3;16;1;0;1;0;200;2;AGUSTUS
4667;SULAWESI BARAT;MAMUJU;BONEHAU;TAMALEA;48;4;36;0;7;0;0;1;0;48;0;AGUSTUS
4668;SULAWESI BARAT;MAMUJU;BONEHAU;LUMIKA;129;38;56;2;32;1;0;0;0;129;0;AGUSTUS
4669;SULAWESI BARAT;MAMUJU;BONEHAU;MAPPU;73;17;43;0;12;0;0;1;0;73;0;AGUSTUS
4670;SULAWESI BARAT;MAMUJU;BONEHAU;BANUADA;98;12;80;1;3;0;0;2;0;98;0;AGUSTUS
4671;SULAWESI BARAT;MAMUJU;BONEHAU;HINUA;103;28;25;7;36;1;0;3;1;101;2;AGUSTUS
4672;SULAWESI BARAT;MAMUJU;BONEHAU;KINATANG;112;19;90;1;0;0;0;2;0;112;0;AGUSTUS
4673;SULAWESI BARAT;POLEWALI MANDAR;MATANGNGA;MATANGNGA;70;35;5;4;21;2;0;3;0;70;0;AGUSTUS
4674;SULAWESI BARAT;POLEWALI MANDAR;MATANGNGA;LILLI;109;39;16;1;51;0;0;1;0;108;1;AGUSTUS
4675;SULAWESI BARAT;POLEWALI MANDAR;MATANGNGA;RANGOAN;70;26;28;1;13;0;0;0;0;68;2;AGUSTUS
4676;SULAWESI BARAT;POLEWALI MANDAR;MATANGNGA;TAPUA;166;71;30;7;57;0;0;1;0;166;0;AGUSTUS
4677;SULAWESI BARAT;POLEWALI MANDAR;MATANGNGA;MAMBU TAPUA;96;31;15;0;47;0;0;3;0;96;0;AGUSTUS
4678;SULAWESI BARAT;POLEWALI MANDAR;MATANGNGA;BA'BA TAPUA;67;26;10;0;31;0;0;0;0;67;0;AGUSTUS
4679;SULAWESI BARAT;POLEWALI MANDAR;MATANGNGA;KATIMBANG;85;36;23;1;23;1;0;0;0;84;1;AGUSTUS
4680;SULAWESI BARAT;POLEWALI MANDAR;TINAMBUNG;TINAMBUNG;118;37;26;2;23;4;0;26;0;118;0;AGUSTUS
4681;SULAWESI BARAT;POLEWALI MANDAR;TINAMBUNG;KARAMA;462;332;44;19;47;2;0;15;0;459;3;AGUSTUS
4682;SULAWESI BARAT;POLEWALI MANDAR;TINAMBUNG;TANGNGA TANGNGA;201;143;33;2;14;1;0;8;0;201;0;AGUSTUS
4683;SULAWESI BARAT;POLEWALI MANDAR;TINAMBUNG;LEKOPADIS;79;29;14;4;24;1;0;6;0;78;1;AGUSTUS
4684;SULAWESI BARAT;POLEWALI MANDAR;TINAMBUNG;GALUNG LOMBOK;144;59;22;16;29;3;0;15;0;144;0;AGUSTUS
4685;SULAWESI BARAT;POLEWALI MANDAR;TINAMBUNG;TANDUNG;126;60;23;8;17;4;0;12;0;124;2;AGUSTUS
4686;SULAWESI BARAT;POLEWALI MANDAR;TINAMBUNG;BATULAYA;118;48;26;17;12;5;1;9;0;118;0;AGUSTUS
4687;SULAWESI BARAT;POLEWALI MANDAR;TINAMBUNG;SEPABATU;101;38;22;10;16;2;0;13;0;101;0;AGUSTUS
4688;SULAWESI BARAT;MAMUJU;KALUKKU;SINYONYOI;449;233;130;10;47;5;0;13;0;438;11;AGUSTUS
4689;SULAWESI BARAT;MAMUJU;KALUKKU;BEBANGA;757;447;208;5;64;5;2;23;0;754;3;AGUSTUS
4690;SULAWESI BARAT;MAMUJU;KALUKKU;KALUKKU;676;235;174;8;186;24;1;28;0;656;20;AGUSTUS
4691;SULAWESI BARAT;MAMUJU;KALUKKU;SINYONYOI SELATAN;270;132;69;5;32;3;0;23;0;264;6;AGUSTUS
4692;SULAWESI BARAT;MAMUJU;KALUKKU;SONDOANG;275;117;86;1;63;1;0;5;1;274;1;AGUSTUS
4693;SULAWESI BARAT;MAMUJU;KALUKKU;BERU-BERU;548;319;84;3;128;2;0;11;1;548;0;AGUSTUS
4694;SULAWESI BARAT;MAMUJU;KALUKKU;BELANG BELANG;377;154;118;2;91;2;0;10;0;377;0;AGUSTUS
4695;SULAWESI BARAT;MAMUJU;KALUKKU;KABULOANG;358;138;131;3;69;1;1;10;1;354;4;AGUSTUS
4696;SULAWESI BARAT;MAMUJU;KALUKKU;KEANG;237;71;128;1;28;1;0;7;0;236;1;AGUSTUS
4697;SULAWESI BARAT;MAMUJU;KALUKKU;POKKANG;201;85;41;2;61;3;1;8;0;201;0;AGUSTUS
4698;SULAWESI BARAT;MAMUJU;KALUKKU;GULILING;152;48;63;0;36;0;0;2;2;151;1;AGUSTUS
4699;SULAWESI BARAT;MAMUJU;KALUKKU;UHAIMATE;124;79;36;0;9;0;0;0;0;124;0;AGUSTUS
4700;SULAWESI BARAT;MAMUJU;KALUKKU;KALUKKU BARAT;474;280;67;1;121;2;0;3;0;474;0;AGUSTUS
4701;SULAWESI BARAT;MAMUJU;KALUKKU;PAMMULUKANG;231;113;74;7;23;0;0;12;1;230;1;AGUSTUS
4702;SULAWESI BARAT;POLEWALI MANDAR;LUYO;BATUPANGA;235;115;41;4;61;2;1;7;0;231;4;AGUSTUS
4703;SULAWESI BARAT;POLEWALI MANDAR;LUYO;MAMBU;207;111;27;2;41;1;1;12;3;198;9;AGUSTUS
4704;SULAWESI BARAT;POLEWALI MANDAR;LUYO;TENGGELANG;267;136;55;11;47;0;1;7;0;257;10;AGUSTUS
4705;SULAWESI BARAT;POLEWALI MANDAR;LUYO;BARU;284;92;80;27;43;8;0;22;0;272;12;AGUSTUS
4706;SULAWESI BARAT;POLEWALI MANDAR;LUYO;PUSSUI;187;103;31;2;43;0;1;5;1;186;1;AGUSTUS
4707;SULAWESI BARAT;POLEWALI MANDAR;LUYO;MAPILI BARAT;190;110;40;12;18;0;0;10;0;190;0;AGUSTUS
4708;SULAWESI BARAT;POLEWALI MANDAR;LUYO;SAMBALI WALI;270;156;46;14;39;3;0;3;0;261;9;AGUSTUS
4709;SULAWESI BARAT;POLEWALI MANDAR;LUYO;BATUPANGA DAALA;322;154;50;3;108;0;1;6;0;322;0;AGUSTUS
4710;SULAWESI BARAT;POLEWALI MANDAR;LUYO;LUYO;198;98;25;5;51;2;2;14;0;197;1;AGUSTUS
4711;SULAWESI BARAT;POLEWALI MANDAR;LUYO;PUSSUI BARAT;115;55;17;3;23;13;1;2;0;114;1;AGUSTUS
4712;SULAWESI BARAT;POLEWALI MANDAR;LUYO;PUCCADI;203;144;23;0;25;3;0;8;0;203;0;AGUSTUS
4713;SULAWESI BARAT;POLEWALI MANDAR;MAPILLI;MAPILI;112;40;9;6;38;4;0;15;0;112;0;AGUSTUS
4714;SULAWESI BARAT;POLEWALI MANDAR;MAPILLI;UGIBARU;237;57;57;37;36;8;0;25;0;220;17;AGUSTUS
4715;SULAWESI BARAT;POLEWALI MANDAR;MAPILLI;RUMPA;175;94;22;4;48;4;0;3;0;175;0;AGUSTUS
4716;SULAWESI BARAT;POLEWALI MANDAR;MAPILLI;KURMA;294;159;49;0;71;2;0;13;0;294;0;AGUSTUS
4717;SULAWESI BARAT;POLEWALI MANDAR;MAPILLI;BUKU;229;158;33;4;26;2;0;2;0;225;4;AGUSTUS
4718;SULAWESI BARAT;POLEWALI MANDAR;MAPILLI;BONNE BONNE;133;45;17;10;45;9;0;7;0;133;0;AGUSTUS
4719;SULAWESI BARAT;POLEWALI MANDAR;MAPILLI;BEROANGIN;222;71;28;1;98;4;0;15;1;218;4;AGUSTUS
4720;SULAWESI BARAT;POLEWALI MANDAR;MAPILLI;SEGERANG;162;94;35;4;21;1;0;7;0;162;0;AGUSTUS
4721;SULAWESI BARAT;POLEWALI MANDAR;MAPILLI;BONRA;167;76;50;0;32;1;0;8;0;167;0;AGUSTUS
4722;SULAWESI BARAT;POLEWALI MANDAR;MAPILLI;SATTOKO;86;20;9;0;51;1;0;5;0;86;0;AGUSTUS
4723;SULAWESI BARAT;POLEWALI MANDAR;MAPILLI;RAPPANG BARAT;302;94;106;2;69;5;0;25;0;301;1;AGUSTUS
4724;SULAWESI BARAT;POLEWALI MANDAR;MAPILLI;LANDI KANUSUANG;322;120;39;1;146;0;0;16;0;322;0;AGUSTUS
4725;SULAWESI BARAT;MAMUJU;SAMPAGA;BUNDE;507;248;125;2;126;1;0;5;0;507;0;AGUSTUS
4726;SULAWESI BARAT;MAMUJU;SAMPAGA;KALONDING;447;177;181;8;73;4;0;3;0;446;1;AGUSTUS
4727;SULAWESI BARAT;MAMUJU;SAMPAGA;TARAILU;260;119;80;0;49;5;0;7;0;260;0;AGUSTUS
4728;SULAWESI BARAT;MAMUJU;SAMPAGA;SAMPAGA;187;92;64;2;25;1;0;2;1;187;0;AGUSTUS
4729;SULAWESI BARAT;MAMUJU;SAMPAGA;TANAMBUAH;70;26;24;1;18;0;0;1;0;70;0;AGUSTUS
4730;SULAWESI BARAT;MAMUJU;SAMPAGA;SALUBARANA;71;33;19;1;15;1;0;2;0;71;0;AGUSTUS
4731;SULAWESI BARAT;MAMUJU;SAMPAGA;LOSSO;133;49;29;0;54;0;0;0;0;132;1;AGUSTUS
4732;SULAWESI BARAT;MAMUJU;TAPALANG;GALUNG;254;57;102;5;42;25;0;19;1;251;3;AGUSTUS
4733;SULAWESI BARAT;MAMUJU;TAPALANG;KASAMBANG;207;81;54;0;58;2;0;10;1;206;1;AGUSTUS
4734;SULAWESI BARAT;MAMUJU;TAPALANG;DAYANGINNA;126;37;39;9;25;6;0;7;0;123;3;AGUSTUS
4735;SULAWESI BARAT;MAMUJU;TAPALANG;OROBATU;95;34;32;11;3;8;0;7;0;95;0;AGUSTUS
4736;SULAWESI BARAT;MAMUJU;TAPALANG;TAKANDEANG;181;64;35;5;58;14;1;4;0;181;0;AGUSTUS
4737;SULAWESI BARAT;MAMUJU;TAPALANG;BELA;49;33;7;0;9;0;0;0;0;49;0;AGUSTUS
4738;SULAWESI BARAT;MAMUJU;TAPALANG;TAAN;217;79;76;1;51;2;0;7;0;216;1;AGUSTUS
4739;SULAWESI BARAT;MAMUJU;TAPALANG;TAMPALANG;159;69;33;2;38;3;0;10;1;156;3;AGUSTUS
4740;SULAWESI BARAT;MAMUJU;TAPALANG;RANTEDODA;76;34;14;13;10;0;0;5;0;76;0;AGUSTUS
4741;SULAWESI BARAT;MAMUJU;TAPALANG;KOPEANG;70;43;19;0;8;0;0;0;0;70;0;AGUSTUS
4742;SULAWESI BARAT;POLEWALI MANDAR;WONOMULYO;SIDODADI;391;202;85;3;55;29;0;14;1;389;2;AGUSTUS
4743;SULAWESI BARAT;POLEWALI MANDAR;WONOMULYO;SIDOREJO;288;154;67;12;24;12;0;17;0;286;2;AGUSTUS
4744;SULAWESI BARAT;POLEWALI MANDAR;WONOMULYO;SUMBEREJO;472;216;88;26;94;37;0;5;1;467;5;AGUSTUS
4745;SULAWESI BARAT;POLEWALI MANDAR;WONOMULYO;BUMIAYU;392;142;83;24;50;59;0;16;1;375;17;AGUSTUS
4746;SULAWESI BARAT;POLEWALI MANDAR;WONOMULYO;KEBUNSARI;262;97;44;8;40;40;1;11;0;241;21;AGUSTUS
4747;SULAWESI BARAT;POLEWALI MANDAR;WONOMULYO;BANUA BARU;178;87;29;6;19;16;0;9;0;166;12;AGUSTUS
4748;SULAWESI BARAT;POLEWALI MANDAR;WONOMULYO;NEPO;255;154;46;3;35;9;1;4;0;252;3;AGUSTUS
4749;SULAWESI BARAT;POLEWALI MANDAR;WONOMULYO;SUGIHWARAS;508;237;126;15;78;28;0;12;0;496;12;AGUSTUS
4750;SULAWESI BARAT;POLEWALI MANDAR;WONOMULYO;CAMPURJO;233;112;40;7;38;16;0;19;0;232;1;AGUSTUS
4751;SULAWESI BARAT;POLEWALI MANDAR;WONOMULYO;BUMIMULYO;175;88;43;0;31;10;0;1;0;173;2;AGUSTUS
4752;SULAWESI BARAT;POLEWALI MANDAR;WONOMULYO;TUMPILING;233;118;54;3;34;4;0;9;0;222;11;AGUSTUS
4753;SULAWESI BARAT;POLEWALI MANDAR;WONOMULYO;BAKKA-BAKKA;185;99;35;3;31;7;0;6;0;181;4;AGUSTUS
4754;SULAWESI BARAT;POLEWALI MANDAR;WONOMULYO;ARJO SARI;257;128;78;3;12;19;0;8;0;248;9;AGUSTUS
4755;SULAWESI BARAT;POLEWALI MANDAR;WONOMULYO;GALESON;245;166;32;3;26;5;0;8;0;240;5;AGUSTUS
4756;SULAWESI BARAT;POLEWALI MANDAR;TUTAR;TARAMANU;200;92;33;6;46;1;12;10;0;200;0;AGUSTUS
4757;SULAWESI BARAT;POLEWALI MANDAR;TUTAR;AMBOPADANG;275;93;53;0;125;2;0;2;0;275;0;AGUSTUS
4758;SULAWESI BARAT;POLEWALI MANDAR;TUTAR;TUBBI;136;43;71;4;7;3;0;8;0;136;0;AGUSTUS
4759;SULAWESI BARAT;POLEWALI MANDAR;TUTAR;RATTE;184;82;60;2;37;1;1;0;1;184;0;AGUSTUS
4760;SULAWESI BARAT;POLEWALI MANDAR;TUTAR;BESOANGIN;122;68;8;2;44;0;0;0;0;122;0;AGUSTUS
4761;SULAWESI BARAT;POLEWALI MANDAR;TUTAR;PIRIANG TAPIKO;116;36;58;0;20;0;0;2;0;116;0;AGUSTUS
4762;SULAWESI BARAT;POLEWALI MANDAR;TUTAR;PEBURRU;187;107;43;2;28;2;0;5;0;187;0;AGUSTUS
4763;SULAWESI BARAT;POLEWALI MANDAR;TUTAR;TALOBA;98;33;43;0;18;0;0;3;0;97;1;AGUSTUS
4764;SULAWESI BARAT;POLEWALI MANDAR;TUTAR;POLLEWANI;263;134;91;2;33;0;0;3;0;263;0;AGUSTUS
4765;SULAWESI BARAT;POLEWALI MANDAR;TUTAR;ARABUA;157;94;35;0;11;0;14;3;0;157;0;AGUSTUS
4766;SULAWESI BARAT;POLEWALI MANDAR;TUTAR;BESOANGIN UTARA;109;53;22;1;32;0;0;1;0;109;0;AGUSTUS
4767;SULAWESI BARAT;POLEWALI MANDAR;TUTAR;PODA;120;47;53;4;12;0;1;3;0;120;0;AGUSTUS
4768;SULAWESI BARAT;POLEWALI MANDAR;TUTAR;TARAMANU TUA;172;29;53;2;79;3;0;3;0;169;3;AGUSTUS
4769;SULAWESI BARAT;POLEWALI MANDAR;MATAKALI;MATAKALI;332;159;80;14;55;11;0;13;0;332;0;AGUSTUS
4770;SULAWESI BARAT;POLEWALI MANDAR;MATAKALI;PETAMPANUA;283;133;87;3;37;16;2;5;0;283;0;AGUSTUS
4771;SULAWESI BARAT;POLEWALI MANDAR;MATAKALI;BARUMBUNG;200;87;59;4;43;5;0;2;0;200;0;AGUSTUS
4772;SULAWESI BARAT;POLEWALI MANDAR;MATAKALI;PASIANG;401;138;80;11;136;11;0;21;0;397;4;AGUSTUS
4773;SULAWESI BARAT;POLEWALI MANDAR;MATAKALI;TONROLIMA;234;121;53;2;33;5;0;11;2;227;7;AGUSTUS
4774;SULAWESI BARAT;POLEWALI MANDAR;MATAKALI;INDOMAKKOMBONG;386;186;101;3;72;5;0;11;2;380;6;AGUSTUS
4775;SULAWESI BARAT;POLEWALI MANDAR;MATAKALI;BUNGA-BUNGA;145;67;47;6;20;1;0;4;0;145;0;AGUSTUS
4776;SULAWESI BARAT;MAMUJU;KALUMPANG;KALUMPANG;51;26;13;0;6;0;0;3;0;48;3;AGUSTUS
4777;SULAWESI BARAT;MAMUJU;KALUMPANG;KARATAUN;177;99;38;0;37;0;0;1;0;175;2;AGUSTUS
4778;SULAWESI BARAT;MAMUJU;KALUMPANG;KARAMA;125;53;48;0;23;0;0;1;0;125;0;AGUSTUS
4779;SULAWESI BARAT;MAMUJU;KALUMPANG;SIRAUN;96;56;21;0;18;0;0;0;1;96;0;AGUSTUS
4780;SULAWESI BARAT;MAMUJU;KALUMPANG;TUMOGA;76;34;15;0;22;0;0;0;0;71;5;AGUSTUS
4781;SULAWESI BARAT;MAMUJU;KALUMPANG;SALUMAKKI;92;64;14;0;12;0;0;0;0;90;2;AGUSTUS
4782;SULAWESI BARAT;MAMUJU;KALUMPANG;POLIO;62;31;22;0;9;0;0;0;0;62;0;AGUSTUS
4783;SULAWESI BARAT;MAMUJU;KALUMPANG;LIMBONG;89;25;18;0;44;1;0;1;0;89;0;AGUSTUS
4784;SULAWESI BARAT;MAMUJU;KALUMPANG;SANDAPANG;92;27;5;0;58;0;0;1;0;91;1;AGUSTUS
4785;SULAWESI BARAT;MAMUJU;KALUMPANG;KONDO BULO;84;50;27;0;5;0;0;1;0;83;1;AGUSTUS
4786;SULAWESI BARAT;MAMUJU;KALUMPANG;MAKKALIKI;71;35;19;0;17;0;0;0;0;71;0;AGUSTUS
4787;SULAWESI BARAT;MAMUJU;KALUMPANG;BATU MAKKADA;77;34;35;0;7;0;0;0;0;76;1;AGUSTUS
4788;SULAWESI BARAT;MAMUJU;KALUMPANG;LASA';117;72;25;0;16;0;0;0;1;114;3;AGUSTUS
4789;SULAWESI BARAT;MAMUJU;KEP. BALA BALAKANG;BALA BALAKANG;124;60;52;2;9;0;0;0;0;123;1;AGUSTUS
4790;SULAWESI BARAT;MAMUJU;KEP. BALA BALAKANG;BALA-BALAKANG TIMUR;97;29;66;1;0;0;1;0;0;97;0;AGUSTUS
4791;SULAWESI BARAT;MAMUJU TENGAH;BUDONG-BUDONG;BABANA;620;294;99;12;177;21;2;14;0;619;1;AGUSTUS
4792;SULAWESI BARAT;MAMUJU TENGAH;BUDONG-BUDONG;LUMU;245;108;30;0;93;4;0;8;0;243;2;AGUSTUS
4793;SULAWESI BARAT;MAMUJU TENGAH;BUDONG-BUDONG;PONTANAKAYANG;327;189;24;10;91;5;0;1;1;321;6;AGUSTUS
4794;SULAWESI BARAT;MAMUJU TENGAH;BUDONG-BUDONG;SALOGATTA;549;208;99;14;191;11;0;9;0;532;17;AGUSTUS
4795;SULAWESI BARAT;MAMUJU TENGAH;BUDONG-BUDONG;KIRE;152;46;33;0;71;0;0;2;0;152;0;AGUSTUS
4796;SULAWESI BARAT;MAMUJU TENGAH;BUDONG-BUDONG;TINALI;220;110;35;0;68;1;0;6;0;220;0;AGUSTUS
4797;SULAWESI BARAT;MAMUJU TENGAH;BUDONG-BUDONG;SALUMANURUNG;150;65;52;3;22;3;0;5;0;150;0;AGUSTUS
4798;SULAWESI BARAT;MAMUJU TENGAH;BUDONG-BUDONG;PASAPA;169;75;44;1;36;0;0;8;0;164;5;AGUSTUS
4799;SULAWESI BARAT;MAMUJU TENGAH;BUDONG-BUDONG;BOJO;234;99;58;1;65;5;0;6;0;234;0;AGUSTUS
4800;SULAWESI BARAT;MAMUJU TENGAH;BUDONG-BUDONG;BARAKKANG;120;56;20;3;38;1;0;2;0;120;0;AGUSTUS
4801;SULAWESI BARAT;MAMUJU TENGAH;BUDONG-BUDONG;LEMBAH HADA;58;27;11;0;18;1;0;1;0;58;0;AGUSTUS
4802;SULAWESI BARAT;MAMUJU TENGAH;TOBADAK;MAHAHE;326;133;66;11;86;14;0;11;4;325;1;AGUSTUS
4803;SULAWESI BARAT;MAMUJU TENGAH;TOBADAK;SALOBAJA;342;173;45;15;95;5;0;9;0;342;0;AGUSTUS
4804;SULAWESI BARAT;MAMUJU TENGAH;TOBADAK;TOBADAK;1306;550;266;23;326;44;2;33;1;1245;61;AGUSTUS
4805;SULAWESI BARAT;MAMUJU TENGAH;TOBADAK;PALONGAAN;283;101;88;5;68;4;0;16;0;282;1;AGUSTUS
4806;SULAWESI BARAT;MAMUJU TENGAH;TOBADAK;BATU PARIGI;728;162;243;14;253;24;1;22;0;719;9;AGUSTUS
4807;SULAWESI BARAT;MAMUJU TENGAH;TOBADAK;BAMBADARU;183;59;48;8;59;2;1;6;0;183;0;AGUSTUS
4808;SULAWESI BARAT;MAMUJU TENGAH;TOBADAK;SEJATI;151;84;29;2;29;2;0;5;0;151;0;AGUSTUS
4809;SULAWESI BARAT;MAMUJU TENGAH;TOBADAK;SALOADAK;260;118;22;2;98;10;0;8;0;258;2;AGUSTUS
4810;SULAWESI BARAT;PASANGKAYU;BAMBAIRA;BAMBAIRA;261;79;43;6;108;10;0;12;0;258;3;AGUSTUS
4811;SULAWESI BARAT;PASANGKAYU;BAMBAIRA;KASOLOANG;171;67;19;0;64;11;0;10;0;171;0;AGUSTUS
4812;SULAWESI BARAT;PASANGKAYU;BAMBAIRA;TAMPAURE;226;91;52;1;57;6;0;12;1;220;6;AGUSTUS
4813;SULAWESI BARAT;PASANGKAYU;BAMBAIRA;KALUKU NANGKA;290;139;63;3;67;5;0;13;0;290;0;AGUSTUS
4814;SULAWESI BARAT;PASANGKAYU;BAMBALAMOTU;BAMBALAMOTU;389;175;77;4;82;24;0;26;0;388;1;AGUSTUS
4815;SULAWESI BARAT;PASANGKAYU;BAMBALAMOTU;POLEWALI;434;156;137;2;91;31;0;17;0;434;0;AGUSTUS
4816;SULAWESI BARAT;PASANGKAYU;BAMBALAMOTU;RANDOMAYANG;437;149;65;2;156;19;0;36;0;427;10;AGUSTUS
4817;SULAWESI BARAT;PASANGKAYU;BAMBALAMOTU;PANGIANG;184;98;40;2;22;14;0;8;0;184;0;AGUSTUS
4818;SULAWESI BARAT;PASANGKAYU;BAMBALAMOTU;KALOLA;462;128;106;0;196;19;0;13;0;462;0;AGUSTUS
4819;SULAWESI BARAT;PASANGKAYU;BAMBALAMOTU;WULAI;266;63;69;0;115;6;0;13;0;266;0;AGUSTUS
4820;SULAWESI BARAT;PASANGKAYU;BULU TABA;LILIMORI;282;105;37;7;79;33;0;21;0;282;0;AGUSTUS
4821;SULAWESI BARAT;PASANGKAYU;BULU TABA;KARAVE;251;93;41;20;63;8;0;12;0;237;14;AGUSTUS
4822;SULAWESI BARAT;PASANGKAYU;BULU TABA;BUKIT HARAPAN;143;58;37;0;33;10;1;4;0;143;0;AGUSTUS
4823;SULAWESI BARAT;PASANGKAYU;BULU TABA;KASTABUANA;158;91;25;1;27;7;0;6;0;157;1;AGUSTUS
4824;SULAWESI BARAT;PASANGKAYU;BULU TABA;SUMBER SARI;30;24;5;0;1;0;0;0;0;30;0;AGUSTUS
4825;SULAWESI BARAT;PASANGKAYU;BULU TABA;LELEJAE;157;70;25;2;39;11;0;9;1;157;0;AGUSTUS
4826;SULAWESI BARAT;PASANGKAYU;BULU TABA;OMPI;100;44;30;3;18;3;0;2;0;100;0;AGUSTUS
4827;SULAWESI BARAT;PASANGKAYU;BARAS;BARAS;276;101;27;2;95;38;0;13;0;276;0;AGUSTUS
4828;SULAWESI BARAT;PASANGKAYU;BARAS;BALANTI;354;177;70;2;85;10;0;7;0;351;3;AGUSTUS
4829;SULAWESI BARAT;PASANGKAYU;BARAS;MOTU;556;197;124;10;127;62;0;33;0;553;3;AGUSTUS
4830;SULAWESI BARAT;PASANGKAYU;BARAS;BULU PARIGI;169;67;10;2;83;6;0;1;0;169;0;AGUSTUS
4831;SULAWESI BARAT;PASANGKAYU;BARAS;TOWONI;164;43;41;2;64;7;0;5;0;162;2;AGUSTUS
4832;SULAWESI BARAT;PASANGKAYU;BARAS;KASANO;294;179;32;0;71;10;0;2;0;294;0;AGUSTUS
4833;SULAWESI BARAT;MAMASA;BALLA;BALLA;163;28;28;2;82;11;0;11;0;162;1;AGUSTUS
4834;SULAWESI BARAT;MAMASA;BALLA;BALLA BARAT;85;38;13;0;34;0;0;0;0;85;0;AGUSTUS
4835;SULAWESI BARAT;MAMASA;BALLA;BALLA SATANETEAN;151;59;13;2;63;9;0;3;0;149;2;AGUSTUS
4836;SULAWESI BARAT;MAMASA;BALLA;BALLA TUMUKA;118;38;37;0;41;1;0;1;0;118;0;AGUSTUS
4837;SULAWESI BARAT;MAMASA;BALLA;SEPAKUAN;158;55;11;2;86;2;0;2;0;158;0;AGUSTUS
4838;SULAWESI BARAT;MAMASA;BALLA;PIDARA;65;27;9;0;27;1;0;1;0;65;0;AGUSTUS
4839;SULAWESI BARAT;MAMASA;BALLA;BAMBAPUANG;62;30;15;1;16;0;0;0;0;62;0;AGUSTUS
4840;SULAWESI BARAT;MAMASA;BALLA;BALLA TIMUR;33;7;1;0;22;1;0;2;0;33;0;AGUSTUS
4841;SULAWESI BARAT;MAMUJU;MAMUJU;BINANGA;788;456;161;15;71;56;1;17;2;779;9;AGUSTUS
4842;SULAWESI BARAT;MAMUJU;MAMUJU;MAMUNYU;591;299;155;38;51;28;1;15;0;587;4;AGUSTUS
4843;SULAWESI BARAT;MAMUJU;MAMUJU;KAREMA;858;447;117;38;103;63;2;32;0;802;56;AGUSTUS
4844;SULAWESI BARAT;MAMUJU;MAMUJU;RIMUKU;677;293;145;31;53;75;2;33;1;633;44;AGUSTUS
4845;SULAWESI BARAT;MAMUJU;MAMUJU;BAMBU;345;193;76;14;43;4;0;15;0;345;0;AGUSTUS
4846;SULAWESI BARAT;MAMUJU;MAMUJU;KARAMPUANG;479;352;67;2;31;10;0;14;0;476;3;AGUSTUS
4847;SULAWESI BARAT;MAMUJU;MAMUJU;TADUI;481;162;201;0;66;6;0;28;2;465;16;AGUSTUS
4848;SULAWESI BARAT;MAMUJU;MAMUJU;BATU PANNU;179;128;33;0;11;3;0;4;0;179;0;AGUSTUS
4849;SULAWESI BARAT;MAMUJU;SIMBORO;SIMBORO;1537;606;182;72;167;249;1;70;5;1352;185;AGUSTUS
4850;SULAWESI BARAT;MAMUJU;SIMBORO;RANGAS;564;169;152;21;129;19;3;12;0;505;59;AGUSTUS
4851;SULAWESI BARAT;MAMUJU;SIMBORO;BOTTENG;186;102;47;1;21;2;0;12;0;185;1;AGUSTUS
4852;SULAWESI BARAT;MAMUJU;SIMBORO;SALETTO;285;134;75;5;44;4;1;22;0;285;0;AGUSTUS
4853;SULAWESI BARAT;MAMUJU;SIMBORO;SUMARE;224;106;80;2;26;10;0;0;0;224;0;AGUSTUS
4854;SULAWESI BARAT;MAMUJU;SIMBORO;BOTTENG UTARA;362;145;94;1;102;5;1;0;0;348;14;AGUSTUS
4855;SULAWESI BARAT;MAMUJU;SIMBORO;TAPANDULLU;48;29;1;0;14;0;2;2;0;48;0;AGUSTUS
4856;SULAWESI BARAT;MAMUJU;SIMBORO;PATI'DI;186;104;41;1;36;1;0;3;0;186;0;AGUSTUS
4857;SULAWESI BARAT;MAMUJU;TAPALANG BARAT;DUNGKAIT;247;100;98;5;35;3;1;3;0;245;2;AGUSTUS
4858;SULAWESI BARAT;MAMUJU;TAPALANG BARAT;LEBANI;118;43;50;0;8;0;0;4;2;107;11;AGUSTUS
4859;SULAWESI BARAT;MAMUJU;TAPALANG BARAT;LABUANG RANO;215;115;69;0;15;4;0;2;0;205;10;AGUSTUS
4860;SULAWESI BARAT;MAMUJU;TAPALANG BARAT;PASABU;156;48;59;6;18;8;0;13;2;154;2;AGUSTUS
4861;SULAWESI BARAT;MAMUJU;TAPALANG BARAT;TANETE PAO;44;31;10;0;2;0;0;0;0;43;1;AGUSTUS
4862;SULAWESI BARAT;MAMUJU;TAPALANG BARAT;PANGASAAN;54;23;19;2;4;4;0;0;0;52;2;AGUSTUS
4863;SULAWESI BARAT;MAMUJU;TAPALANG BARAT;AHU;171;96;56;2;7;0;0;2;0;163;8;AGUSTUS
4864;SULAWESI BARAT;POLEWALI MANDAR;BINUANG;AMASSANGAN;302;136;55;2;73;2;0;34;0;302;0;AGUSTUS
4865;SULAWESI BARAT;POLEWALI MANDAR;BINUANG;TONYAMAN;498;202;149;4;96;13;0;13;2;479;19;AGUSTUS
4866;SULAWESI BARAT;POLEWALI MANDAR;BINUANG;KUAJANG;385;168;82;11;107;4;0;13;0;385;0;AGUSTUS
4867;SULAWESI BARAT;POLEWALI MANDAR;BINUANG;PAKU;157;74;42;11;19;0;0;10;1;157;0;AGUSTUS
4868;SULAWESI BARAT;POLEWALI MANDAR;BINUANG;MIRRING;222;115;40;5;40;1;0;18;0;219;3;AGUSTUS
4869;SULAWESI BARAT;POLEWALI MANDAR;BINUANG;BATETANGNGA;691;398;150;10;80;5;0;18;2;663;28;AGUSTUS
4870;SULAWESI BARAT;POLEWALI MANDAR;BINUANG;MAMMI;245;80;57;8;86;3;0;10;0;244;1;AGUSTUS
4871;SULAWESI BARAT;POLEWALI MANDAR;BINUANG;KALEOK;150;50;63;2;30;0;0;5;0;150;0;AGUSTUS
4872;SULAWESI BARAT;POLEWALI MANDAR;BINUANG;AMOLA;157;94;23;2;35;0;1;2;0;157;0;AGUSTUS
4873;SULAWESI BARAT;POLEWALI MANDAR;BINUANG;REA;217;91;67;6;29;1;2;18;0;214;3;AGUSTUS
4874;SULAWESI BARAT;PASANGKAYU;SARUDU;SARUDU;406;231;64;4;78;13;1;13;0;404;2;AGUSTUS
4875;SULAWESI BARAT;PASANGKAYU;SARUDU;BULU MARIO;326;109;58;23;94;25;0;17;0;326;0;AGUSTUS
4876;SULAWESI BARAT;PASANGKAYU;SARUDU;KUMASARI;254;119;43;4;71;9;0;6;1;253;1;AGUSTUS
4877;SULAWESI BARAT;PASANGKAYU;SARUDU;PATIKA;65;19;19;0;13;3;0;6;0;60;5;AGUSTUS
4878;SULAWESI BARAT;PASANGKAYU;SARUDU;DODA;286;130;68;3;78;4;0;3;0;286;0;AGUSTUS
4879;SULAWESI BARAT;MAMASA;ARALLE;ARALLE;110;40;57;1;8;1;0;3;0;110;0;AGUSTUS
4880;SULAWESI BARAT;MAMASA;ARALLE;RALLE ANAK;35;8;18;0;6;0;0;3;0;35;0;AGUSTUS
4881;SULAWESI BARAT;MAMASA;ARALLE;PANETEAN;69;51;16;1;1;0;0;0;0;69;0;AGUSTUS
4882;SULAWESI BARAT;MAMASA;ARALLE;UHAILANU;69;20;30;0;10;3;0;5;0;68;1;AGUSTUS
4883;SULAWESI BARAT;MAMASA;ARALLE;ARALLE UTARA;61;30;29;0;2;0;0;0;0;61;0;AGUSTUS
4884;SULAWESI BARAT;MAMASA;ARALLE;UHAIDAHO;54;6;41;2;5;0;0;0;0;54;0;AGUSTUS
4885;SULAWESI BARAT;MAMASA;ARALLE;BARURU;92;65;25;0;1;0;0;0;1;92;0;AGUSTUS
4886;SULAWESI BARAT;MAMASA;ARALLE;RALLEANAK UTARA;37;16;18;0;2;0;0;1;0;37;0;AGUSTUS
4887;SULAWESI BARAT;MAMASA;ARALLE;PAMOSEANG PANGGA;38;17;18;2;1;0;0;0;0;38;0;AGUSTUS
4888;SULAWESI BARAT;MAMASA;ARALLE;KALABE;63;26;34;0;3;0;0;0;0;63;0;AGUSTUS
4889;SULAWESI BARAT;MAMASA;ARALLE;ARALLE SELATAN;31;10;18;0;2;0;0;1;0;31;0;AGUSTUS
4890;SULAWESI BARAT;MAMASA;ARALLE;HAHANGAN;37;16;15;0;6;0;0;0;0;37;0;AGUSTUS
4891;SULAWESI BARAT;MAMASA;MAMASA;MAMASA;367;60;49;3;175;60;0;20;0;367;0;AGUSTUS
4892;SULAWESI BARAT;MAMASA;MAMASA;RAMBUSARATU;251;87;80;16;51;11;0;6;0;251;0;AGUSTUS
4893;SULAWESI BARAT;MAMASA;MAMASA;OSANGO;453;87;70;10;179;88;0;14;1;449;4;AGUSTUS
4894;SULAWESI BARAT;MAMASA;MAMASA;LAMBANAN;220;67;48;8;85;6;0;6;0;220;0;AGUSTUS
4895;SULAWESI BARAT;MAMASA;MAMASA;LEMBANA SALULO;87;14;16;1;44;5;0;6;0;86;1;AGUSTUS
4896;SULAWESI BARAT;MAMASA;MAMASA;TAUPE;228;46;32;7;139;1;1;2;0;228;0;AGUSTUS
4897;SULAWESI BARAT;MAMASA;MAMASA;BUNTU BUDA;291;77;30;12;104;24;0;5;0;252;39;AGUSTUS
4898;SULAWESI BARAT;MAMASA;MAMASA;TONDOK BAKARU;244;74;78;14;60;10;0;7;0;243;1;AGUSTUS
4899;SULAWESI BARAT;MAMASA;MAMASA;PEBASSIAN;93;24;23;2;41;1;0;2;0;93;0;AGUSTUS
4900;SULAWESI BARAT;MAMASA;MAMASA;MAMBULILING;120;55;21;2;37;2;0;1;0;118;2;AGUSTUS
4901;SULAWESI BARAT;MAMASA;MAMASA;BOMBONG LAMBE;149;47;18;2;67;14;0;1;0;149;0;AGUSTUS
4902;SULAWESI BARAT;MAMASA;MAMASA;BUBUN BATU;125;24;12;3;75;3;0;2;0;119;6;AGUSTUS
4903;SULAWESI BARAT;POLEWALI MANDAR;LIMBORO;LIMBORO;105;32;19;14;17;2;0;8;0;92;13;AGUSTUS
4904;SULAWESI BARAT;POLEWALI MANDAR;LIMBORO;LEMBANG LEMBANG;212;88;40;26;39;6;0;13;0;212;0;AGUSTUS
4905;SULAWESI BARAT;POLEWALI MANDAR;LIMBORO;TANDASURA;132;70;14;9;26;3;0;9;0;131;1;AGUSTUS
4906;SULAWESI BARAT;POLEWALI MANDAR;LIMBORO;SAMASUNDU;143;48;48;9;25;6;0;7;0;143;0;AGUSTUS
4907;SULAWESI BARAT;POLEWALI MANDAR;LIMBORO;NAPO;154;84;19;2;39;0;0;10;0;154;0;AGUSTUS
4908;SULAWESI BARAT;POLEWALI MANDAR;LIMBORO;TODANG TODANG;37;16;14;4;2;0;0;1;0;37;0;AGUSTUS
4909;SULAWESI BARAT;POLEWALI MANDAR;LIMBORO;PENDULANGAN;58;35;19;0;2;0;0;2;0;58;0;AGUSTUS
4910;SULAWESI BARAT;POLEWALI MANDAR;LIMBORO;RENGGEANG;104;35;28;6;30;0;0;5;0;104;0;AGUSTUS
4911;SULAWESI BARAT;POLEWALI MANDAR;LIMBORO;SALARRI;56;24;15;5;11;0;0;1;0;56;0;AGUSTUS
4912;SULAWESI BARAT;POLEWALI MANDAR;LIMBORO;TANGAN BARU;81;30;10;1;35;0;0;5;0;81;0;AGUSTUS
4913;SULAWESI BARAT;POLEWALI MANDAR;LIMBORO;PALECE;112;25;35;31;14;4;0;3;0;112;0;AGUSTUS
4914;SULAWESI BARAT;POLEWALI MANDAR;CAMPALAGIAN;PAPPANG;151;84;13;12;9;6;0;13;1;138;13;AGUSTUS
4915;SULAWESI BARAT;POLEWALI MANDAR;CAMPALAGIAN;LALIKO;180;109;42;4;6;3;0;16;0;180;0;AGUSTUS
4916;SULAWESI BARAT;POLEWALI MANDAR;CAMPALAGIAN;BONDE;164;91;34;4;13;10;0;12;0;164;0;AGUSTUS
4917;SULAWESI BARAT;POLEWALI MANDAR;CAMPALAGIAN;KATUMBANGAN LEMO;160;87;37;12;15;6;0;3;0;160;0;AGUSTUS
4918;SULAWESI BARAT;POLEWALI MANDAR;CAMPALAGIAN;PANYAMPA;216;133;50;5;11;3;0;12;1;215;1;AGUSTUS
4919;SULAWESI BARAT;POLEWALI MANDAR;CAMPALAGIAN;SURUANG;147;79;36;7;10;1;0;8;0;141;6;AGUSTUS
4920;SULAWESI BARAT;POLEWALI MANDAR;CAMPALAGIAN;LAMPOKO;222;145;53;8;7;2;0;7;0;222;0;AGUSTUS
4921;SULAWESI BARAT;POLEWALI MANDAR;CAMPALAGIAN;KATUMBANGAN;299;132;45;10;59;38;0;12;0;296;3;AGUSTUS
4922;SULAWESI BARAT;POLEWALI MANDAR;CAMPALAGIAN;LAPEO;126;71;25;4;12;2;0;11;0;125;1;AGUSTUS
4923;SULAWESI BARAT;POLEWALI MANDAR;CAMPALAGIAN;PARAPPE;280;176;56;4;37;3;0;2;0;278;2;AGUSTUS
4924;SULAWESI BARAT;POLEWALI MANDAR;CAMPALAGIAN;ONGKO;93;24;14;12;33;7;0;3;0;93;0;AGUSTUS
4925;SULAWESI BARAT;POLEWALI MANDAR;CAMPALAGIAN;KENJE;146;100;11;8;18;3;0;6;0;146;0;AGUSTUS
4926;SULAWESI BARAT;POLEWALI MANDAR;CAMPALAGIAN;SUMARRANG;449;244;133;4;62;6;0;0;0;449;0;AGUSTUS
4927;SULAWESI BARAT;POLEWALI MANDAR;CAMPALAGIAN;BOTTO;249;121;59;0;57;3;0;7;0;247;2;AGUSTUS
4928;SULAWESI BARAT;POLEWALI MANDAR;CAMPALAGIAN;GATTUNGAN;165;52;26;16;47;15;0;8;0;164;1;AGUSTUS
4929;SULAWESI BARAT;POLEWALI MANDAR;CAMPALAGIAN;PADANG TIMUR;132;61;25;3;37;2;0;4;0;132;0;AGUSTUS
4930;SULAWESI BARAT;POLEWALI MANDAR;CAMPALAGIAN;PADANG;76;46;9;5;12;0;0;1;0;73;3;AGUSTUS
4931;SULAWESI BARAT;POLEWALI MANDAR;CAMPALAGIAN;LAGI-AGI;218;155;33;3;16;2;0;9;0;218;0;AGUSTUS
4932;SULAWESI BARAT;MAMASA;PANA;PANA;61;16;37;1;6;1;0;0;0;61;0;AGUSTUS
4933;SULAWESI BARAT;MAMASA;PANA;MANIPI;122;60;43;3;13;1;0;1;0;121;1;AGUSTUS
4934;SULAWESI BARAT;MAMASA;PANA;MAMULLU;63;11;38;0;12;1;0;1;0;63;0;AGUSTUS
4935;SULAWESI BARAT;MAMASA;PANA;SAPAN;59;14;24;0;21;0;0;0;0;59;0;AGUSTUS
4936;SULAWESI BARAT;MAMASA;PANA;DATUBARINGAN;81;27;38;1;15;0;0;0;0;81;0;AGUSTUS
4937;SULAWESI BARAT;MAMASA;PANA;PANURA;60;15;39;0;6;0;0;0;0;60;0;AGUSTUS
4938;SULAWESI BARAT;MAMASA;PANA;TALLANG BULAWAN;71;18;37;4;11;0;0;1;0;71;0;AGUSTUS
4939;SULAWESI BARAT;MAMASA;PANA;KARAKA;63;25;31;0;6;0;0;1;0;63;0;AGUSTUS
4940;SULAWESI BARAT;MAMASA;PANA;ULUSALU;57;5;52;0;0;0;0;0;0;57;0;AGUSTUS
4941;SULAWESI BARAT;MAMASA;PANA;WERI;53;8;36;2;5;1;0;1;0;53;0;AGUSTUS
4942;SULAWESI BARAT;MAMASA;PANA;SALUTAMBUN;58;0;58;0;0;0;0;0;0;58;0;AGUSTUS
4943;SULAWESI BARAT;MAMASA;PANA;SALOAN;97;30;57;0;9;0;0;0;0;96;1;AGUSTUS
4944;SULAWESI BARAT;MAMASA;PANA;ULUSALU INDAH;54;16;38;0;0;0;0;0;0;54;0;AGUSTUS
4945;SULAWESI BARAT;PASANGKAYU;LARIANG;PARABU;133;30;19;9;37;21;0;10;0;126;7;AGUSTUS
4946;SULAWESI BARAT;PASANGKAYU;LARIANG;KENANGAN;53;12;6;2;19;7;0;5;0;51;2;AGUSTUS
4947;SULAWESI BARAT;PASANGKAYU;LARIANG;BAJAWALI;123;25;23;5;47;12;0;11;0;123;0;AGUSTUS
4948;SULAWESI BARAT;PASANGKAYU;LARIANG;SINGGANI;176;75;47;0;34;9;0;9;0;174;2;AGUSTUS
4949;SULAWESI BARAT;PASANGKAYU;LARIANG;KULU;97;31;31;0;23;9;0;2;0;96;1;AGUSTUS
4950;SULAWESI BARAT;PASANGKAYU;LARIANG;BATU MATORU;94;32;21;0;24;7;0;10;0;94;0;AGUSTUS
4951;SULAWESI BARAT;PASANGKAYU;LARIANG;BAMBAKORO;148;52;29;1;47;10;0;9;0;148;0;AGUSTUS
4952;SULAWESI BARAT;MAMASA;TABULAHAN;LAKAHANG;270;86;157;2;13;3;2;7;0;270;0;AGUSTUS
4953;SULAWESI BARAT;MAMASA;TABULAHAN;PERIANGAN;68;17;49;0;2;0;0;0;0;68;0;AGUSTUS
4954;SULAWESI BARAT;MAMASA;TABULAHAN;MALATIRO;143;54;82;0;2;0;0;2;0;140;3;AGUSTUS
4955;SULAWESI BARAT;MAMASA;TABULAHAN;TABULAHAN;57;19;34;0;1;1;0;2;0;57;0;AGUSTUS
4956;SULAWESI BARAT;MAMASA;TABULAHAN;SALULEANG;35;12;22;0;1;0;0;0;0;35;0;AGUSTUS
4957;SULAWESI BARAT;MAMASA;TABULAHAN;TAMPAK KURRA;175;49;119;1;4;0;1;1;0;175;0;AGUSTUS
4958;SULAWESI BARAT;MAMASA;TABULAHAN;GANDANG DEWATA;36;13;19;0;4;0;0;0;0;36;0;AGUSTUS
4959;SULAWESI BARAT;MAMASA;TABULAHAN;BURANA;98;27;65;0;4;0;1;1;0;98;0;AGUSTUS
4960;SULAWESI BARAT;MAMASA;TABULAHAN;SALUBAKKA;96;56;38;0;0;0;0;2;0;96;0;AGUSTUS
4961;SULAWESI BARAT;MAMASA;TABULAHAN;PANGANDARAN;133;45;84;0;4;0;0;0;0;133;0;AGUSTUS
4962;SULAWESI BARAT;MAMASA;TABULAHAN;TALOPAK;54;17;31;0;6;0;0;0;0;54;0;AGUSTUS
4963;SULAWESI BARAT;MAMASA;TABULAHAN;PEU';50;17;33;0;0;0;0;0;0;50;0;AGUSTUS
4964;SULAWESI BARAT;MAMASA;TABULAHAN;TIMORO;44;11;23;0;7;1;0;2;0;44;0;AGUSTUS
4965;SULAWESI BARAT;MAMASA;TABULAHAN;LAKAHANG UTAMA;74;26;42;0;2;0;0;3;0;73;1;AGUSTUS
4966;SULAWESI BARAT;MAMASA;RANTEBULAHAN TIMUR;SALUMOKANAN;93;44;14;0;28;6;0;1;0;93;0;AGUSTUS
4967;SULAWESI BARAT;MAMASA;RANTEBULAHAN TIMUR;SALUMOKANAN BARAT;107;45;26;0;33;0;0;0;1;105;2;AGUSTUS
4968;SULAWESI BARAT;MAMASA;RANTEBULAHAN TIMUR;BUANGIN;94;65;19;0;9;0;0;0;0;93;1;AGUSTUS
4969;SULAWESI BARAT;MAMASA;RANTEBULAHAN TIMUR;BAMBANG BUDA;116;29;63;2;19;1;0;2;0;116;0;AGUSTUS
4970;SULAWESI BARAT;MAMASA;RANTEBULAHAN TIMUR;LEKO;21;5;11;0;5;0;0;0;0;21;0;AGUSTUS
4971;SULAWESI BARAT;MAMASA;RANTEBULAHAN TIMUR;KIRAK;75;53;16;0;6;0;0;0;0;75;0;AGUSTUS
4972;SULAWESI BARAT;MAMASA;RANTEBULAHAN TIMUR;SALUMOKANAN UTARA;113;70;6;1;34;1;0;1;0;113;0;AGUSTUS
4973;SULAWESI BARAT;MAMASA;RANTEBULAHAN TIMUR;SAMPALE;49;16;13;0;20;0;0;0;0;49;0;AGUSTUS
4974;SULAWESI BARAT;MAMASA;SUMARORONG;SUMARORONG;142;45;38;6;33;7;0;11;0;140;2;AGUSTUS
4975;SULAWESI BARAT;MAMASA;SUMARORONG;TABONE;94;26;37;0;30;0;0;1;0;94;0;AGUSTUS
4976;SULAWESI BARAT;MAMASA;SUMARORONG;BATANG URU;98;38;45;0;12;2;0;1;0;98;0;AGUSTUS
4977;SULAWESI BARAT;MAMASA;SUMARORONG;SASAKAN;156;51;86;1;10;7;0;0;0;155;1;AGUSTUS
4978;SULAWESI BARAT;MAMASA;SUMARORONG;TADISI;55;13;38;0;3;0;0;1;0;55;0;AGUSTUS
4979;SULAWESI BARAT;MAMASA;SUMARORONG;SIBANAWA;101;27;51;0;22;0;0;1;0;101;0;AGUSTUS
4980;SULAWESI BARAT;MAMASA;SUMARORONG;BATANGNGURU TIMUR;106;34;66;0;6;0;0;0;0;106;0;AGUSTUS
4981;SULAWESI BARAT;MAMASA;SUMARORONG;SALUBALO;121;47;45;0;27;0;0;2;0;121;0;AGUSTUS
4982;SULAWESI BARAT;MAMASA;SUMARORONG;BANEA;66;20;35;0;8;1;0;2;0;66;0;AGUSTUS
4983;SULAWESI BARAT;MAMASA;SUMARORONG;RANTE KAMASE;162;76;29;4;41;5;0;7;0;162;0;AGUSTUS
4984;SULAWESI BARAT;MAMASA;SESENAPADANG;OROBUA;202;39;18;2;118;15;0;5;3;200;2;AGUSTUS
4985;SULAWESI BARAT;MAMASA;SESENAPADANG;PALADAN;64;9;7;0;44;1;0;0;0;61;3;AGUSTUS
4986;SULAWESI BARAT;MAMASA;SESENAPADANG;OROBUA TIMUR;37;14;7;0;14;1;0;1;0;37;0;AGUSTUS
4987;SULAWESI BARAT;MAMASA;SESENAPADANG;RANTE PUANG;97;25;20;0;46;2;0;2;0;95;2;AGUSTUS
4988;SULAWESI BARAT;MAMASA;SESENAPADANG;SATENETEAN;45;9;20;0;14;1;0;1;0;45;0;AGUSTUS
4989;SULAWESI BARAT;MAMASA;SESENAPADANG;LISUAN ADA;66;32;10;0;24;0;0;0;0;66;0;AGUSTUS
4990;SULAWESI BARAT;MAMASA;SESENAPADANG;OROBUA SELATAN;63;17;9;0;20;17;0;0;0;63;0;AGUSTUS
4991;SULAWESI BARAT;MAMASA;SESENAPADANG;MALANGKENA PADANG;68;10;3;0;54;0;0;0;1;68;0;AGUSTUS
4992;SULAWESI BARAT;MAMASA;SESENAPADANG;MALIMBONG;23;6;1;0;15;0;0;1;0;23;0;AGUSTUS
4993;SULAWESI BARAT;MAMASA;SESENAPADANG;MARAMPAN OROBUA;31;12;0;0;9;9;0;0;0;30;1;AGUSTUS
4994;SULAWESI BARAT;PASANGKAYU;SARJO;SARJO;273;80;49;27;64;12;0;41;0;273;0;AGUSTUS
4995;SULAWESI BARAT;PASANGKAYU;SARJO;MAPONU;133;44;31;0;42;10;0;4;1;132;1;AGUSTUS
4996;SULAWESI BARAT;PASANGKAYU;SARJO;LETAWA;206;78;26;16;59;9;1;16;0;205;1;AGUSTUS
4997;SULAWESI BARAT;PASANGKAYU;SARJO;SARUDE;241;53;47;30;76;13;0;21;0;240;1;AGUSTUS
4998;SULAWESI BARAT;MAMASA;MESSAWA;MESSAWA;35;10;15;0;5;0;0;5;0;35;0;AGUSTUS
4999;SULAWESI BARAT;MAMASA;MESSAWA;RIPPUNG;129;60;53;0;14;1;0;0;0;128;1;AGUSTUS
5000;SULAWESI BARAT;MAMASA;MESSAWA;MAKUANG;104;58;30;1;15;0;0;0;0;104;0;AGUSTUS
5001;SULAWESI BARAT;MAMASA;MESSAWA;SEPANG;73;31;33;0;8;0;0;1;0;73;0;AGUSTUS
5002;SULAWESI BARAT;MAMASA;MESSAWA;MALIMBONG;53;17;30;0;5;0;0;1;0;53;0;AGUSTUS
5003;SULAWESI BARAT;MAMASA;MESSAWA;MATANDE;83;16;50;5;7;3;0;2;0;83;0;AGUSTUS
5004;SULAWESI BARAT;MAMASA;MESSAWA;SIPAI;79;38;32;0;9;0;0;0;0;79;0;AGUSTUS
5005;SULAWESI BARAT;MAMASA;MESSAWA;PASMA MAMBU;49;12;21;0;15;0;0;1;0;49;0;AGUSTUS
5006;SULAWESI BARAT;MAMASA;MESSAWA;TANETE BATU;54;26;23;0;3;0;0;1;0;53;1;AGUSTUS
5007;SULAWESI BARAT;MAMUJU;TOMMO;TOMMO;337;119;72;2;129;6;0;9;0;337;0;AGUSTUS
5008;SULAWESI BARAT;MAMUJU;TOMMO;CAMPALOGA;293;84;118;14;66;6;0;1;0;289;4;AGUSTUS
5009;SULAWESI BARAT;MAMUJU;TOMMO;BUANA SAKTI;215;81;49;2;82;1;0;0;0;215;0;AGUSTUS
5010;SULAWESI BARAT;MAMUJU;TOMMO;TAMEMONGGA;222;77;107;0;33;2;0;3;0;222;0;AGUSTUS
5011;SULAWESI BARAT;MAMUJU;TOMMO;TAMEJARRA;200;68;58;4;50;7;1;12;0;200;0;AGUSTUS
5012;SULAWESI BARAT;MAMUJU;TOMMO;RANTEMARIO;161;61;63;3;19;6;0;5;0;157;4;AGUSTUS
5013;SULAWESI BARAT;MAMUJU;TOMMO;MALINO;76;42;20;6;4;1;0;2;0;75;1;AGUSTUS
5014;SULAWESI BARAT;MAMUJU;TOMMO;KAKULLASANG;374;153;146;7;54;1;0;6;2;369;5;AGUSTUS
5015;SULAWESI BARAT;MAMUJU;TOMMO;LELING;138;39;68;0;29;0;0;2;0;138;0;AGUSTUS
5016;SULAWESI BARAT;MAMUJU;TOMMO;KALEPU;109;52;51;1;4;1;0;0;0;109;0;AGUSTUS
5017;SULAWESI BARAT;MAMUJU;TOMMO;SANDANA;133;50;52;1;18;2;0;9;1;133;0;AGUSTUS
5018;SULAWESI BARAT;MAMUJU;TOMMO;LELING BARAT;204;58;89;3;45;5;0;3;0;203;1;AGUSTUS
5019;SULAWESI BARAT;MAMUJU;TOMMO;LELING UTARA;197;71;105;0;21;0;0;0;0;197;0;AGUSTUS
5020;SULAWESI BARAT;MAMUJU;TOMMO;SALUDENGEN;136;69;59;0;7;0;0;1;0;136;0;AGUSTUS
5021;SULAWESI BARAT;PASANGKAYU;PASANGKAYU;PASANGKAYU;1496;633;371;33;149;230;24;51;0;1491;5;AGUSTUS
5022;SULAWESI BARAT;PASANGKAYU;PASANGKAYU;MARTAJAYA;180;61;33;4;44;24;0;14;0;180;0;AGUSTUS
5023;SULAWESI BARAT;PASANGKAYU;PASANGKAYU;PAKAVA;383;203;100;5;69;4;0;2;0;383;0;AGUSTUS
5024;SULAWESI BARAT;PASANGKAYU;PASANGKAYU;KARYA BERSAMA;323;154;54;3;80;24;0;8;0;323;0;AGUSTUS
5025;SULAWESI BARAT;PASANGKAYU;PASANGKAYU;AKO;427;197;84;4;75;42;0;15;0;417;10;AGUSTUS
5026;SULAWESI BARAT;PASANGKAYU;PASANGKAYU;GUNUNG SARI;529;284;78;7;103;24;0;25;0;521;8;AGUSTUS
5027;SULAWESI BARAT;MAJENE;BANGGAE;BANGGAE;339;96;112;16;65;35;1;14;0;339;0;AGUSTUS
5028;SULAWESI BARAT;MAJENE;BANGGAE;BARU;532;155;142;16;182;14;0;23;0;532;0;AGUSTUS
5029;SULAWESI BARAT;MAJENE;BANGGAE;PANGALI ALI;885;297;263;11;210;64;1;33;0;879;6;AGUSTUS
5030;SULAWESI BARAT;MAJENE;BANGGAE;TOTOLI;453;154;110;18;140;12;1;18;0;453;0;AGUSTUS
5031;SULAWESI BARAT;MAJENE;BANGGAE;RANGAS;900;356;335;16;141;33;1;16;2;900;0;AGUSTUS
5032;SULAWESI BARAT;MAJENE;BANGGAE;GALUNG;246;43;39;28;75;24;0;35;0;244;2;AGUSTUS
5033;SULAWESI BARAT;MAJENE;BANGGAE;PALIPI SOREANG;247;109;42;19;57;10;0;10;0;247;0;AGUSTUS
5034;SULAWESI BARAT;MAJENE;BANGGAE;PAMBOBORANG;246;48;79;16;76;5;0;21;0;245;1;AGUSTUS
5035;SULAWESI BARAT;MAJENE;ULUMANDA;KABIRAAN;148;96;19;2;25;2;0;4;0;148;0;AGUSTUS
5036;SULAWESI BARAT;MAJENE;ULUMANDA;SAMBABO;94;46;16;2;26;0;0;2;0;92;2;AGUSTUS
5037;SULAWESI BARAT;MAJENE;ULUMANDA;TANDEALLO;133;65;43;3;5;1;2;13;0;132;1;AGUSTUS
5038;SULAWESI BARAT;MAJENE;ULUMANDA;ULUMANDA;147;45;76;3;8;4;1;10;0;147;0;AGUSTUS
5039;SULAWESI BARAT;MAJENE;ULUMANDA;SALUTAMBUNG;113;77;19;2;11;0;0;4;0;113;0;AGUSTUS
5040;SULAWESI BARAT;MAJENE;ULUMANDA;POPENGA;80;58;18;0;1;0;0;3;0;80;0;AGUSTUS
5041;SULAWESI BARAT;MAJENE;ULUMANDA;SULAI;128;54;46;6;15;0;0;6;0;127;1;AGUSTUS
5042;SULAWESI BARAT;MAJENE;ULUMANDA;PANGGALO;106;55;36;2;8;2;0;1;0;104;2;AGUSTUS
5043;SULAWESI BARAT;MAMASA;TAWALIAN;TAWALIAN;244;100;45;0;78;9;0;8;3;243;1;AGUSTUS
5044;SULAWESI BARAT;MAMASA;TAWALIAN;TAWALIAN TIMUR;170;66;49;2;50;1;0;1;0;169;1;AGUSTUS
5045;SULAWESI BARAT;MAMASA;TAWALIAN;KARIANGO;204;77;51;0;76;0;0;0;0;204;0;AGUSTUS
5046;SULAWESI BARAT;MAMASA;TAWALIAN;RANTETANGNGA;140;23;40;4;64;4;0;4;0;139;1;AGUSTUS
5047;SULAWESI BARAT;MAMASA;TANDUK KALUA;MINAKE;82;27;6;1;44;2;0;2;0;82;0;AGUSTUS
5048;SULAWESI BARAT;MAMASA;TANDUK KALUA;MALABO;51;23;12;0;6;7;0;3;0;51;0;AGUSTUS
5049;SULAWESI BARAT;MAMASA;TANDUK KALUA;SINDAGAMANIK;138;81;18;0;37;1;0;1;0;138;0;AGUSTUS
5050;SULAWESI BARAT;MAMASA;TANDUK KALUA;PARONDOBULAWAN;105;70;10;1;20;1;0;3;0;105;0;AGUSTUS
5051;SULAWESI BARAT;MAMASA;TANDUK KALUA;TAMALANTIK;158;63;55;0;32;4;0;1;1;156;2;AGUSTUS
5052;SULAWESI BARAT;MAMASA;TANDUK KALUA;MANNABABA;69;30;2;0;37;0;0;0;0;69;0;AGUSTUS
5053;SULAWESI BARAT;MAMASA;TANDUK KALUA;MESAKADA;120;52;27;0;41;0;0;0;0;120;0;AGUSTUS
5054;SULAWESI BARAT;MAMASA;TANDUK KALUA;BALLABATU;144;23;15;0;103;2;0;1;0;144;0;AGUSTUS
5055;SULAWESI BARAT;MAMASA;TANDUK KALUA;PAMBE;86;22;18;1;42;2;1;0;0;86;0;AGUSTUS
5056;SULAWESI BARAT;MAMASA;TANDUK KALUA;SALURANO;72;30;13;0;28;1;0;0;0;72;0;AGUSTUS
5057;SULAWESI BARAT;MAMASA;TANDUK KALUA;TALIMBUNG;89;46;37;0;5;0;0;1;0;89;0;AGUSTUS
5058;SULAWESI BARAT;MAMASA;TANDUK KALUA;KANAN;116;43;26;0;35;8;0;2;0;114;2;AGUSTUS
5059;SULAWESI BARAT;MAMUJU TENGAH;PANGALE;POLO PANGALE;248;58;60;8;113;5;0;3;0;247;1;AGUSTUS
5060;SULAWESI BARAT;MAMUJU TENGAH;PANGALE;PANGALE;207;51;84;10;43;9;1;9;0;207;0;AGUSTUS
5061;SULAWESI BARAT;MAMUJU TENGAH;PANGALE;SARTANAMAJU;75;26;15;9;15;5;0;5;0;75;0;AGUSTUS
5062;SULAWESI BARAT;MAMUJU TENGAH;PANGALE;POLO LERENG;220;64;54;6;84;4;0;4;0;216;4;AGUSTUS
5063;SULAWESI BARAT;MAMUJU TENGAH;PANGALE;KUO;417;203;59;4;129;14;0;6;2;417;0;AGUSTUS
5064;SULAWESI BARAT;MAMUJU TENGAH;PANGALE;POLO CAMBA;148;51;49;8;34;1;0;2;3;148;0;AGUSTUS
5065;SULAWESI BARAT;MAMUJU TENGAH;PANGALE;LAMBA-LAMBA;127;44;35;4;41;2;0;1;0;127;0;AGUSTUS
5066;SULAWESI BARAT;MAMUJU TENGAH;PANGALE;KOMBILING;217;67;43;9;84;3;0;8;0;214;3;AGUSTUS
5067;SULAWESI BARAT;MAMUJU TENGAH;PANGALE;LEMO-LEMO;136;53;41;1;37;3;1;0;0;136;0;AGUSTUS
5068;SULAWESI BARAT;PASANGKAYU;DURIPOKU;TAMMARUNANG;179;58;47;12;47;5;0;10;0;179;0;AGUSTUS
5069;SULAWESI BARAT;PASANGKAYU;DURIPOKU;SAPTANAJAYA;204;116;39;1;35;10;0;3;0;204;0;AGUSTUS
5070;SULAWESI BARAT;PASANGKAYU;DURIPOKU;TARANGGI;93;15;24;6;40;7;0;1;0;93;0;AGUSTUS
5071;SULAWESI BARAT;PASANGKAYU;DURIPOKU;SIPAKAINGA;87;46;26;1;12;2;0;0;0;87;0;AGUSTUS
5072;SULAWESI BARAT;MAMASA;TABANG;TABANG;86;37;22;0;8;18;0;1;0;86;0;AGUSTUS
5073;SULAWESI BARAT;MAMASA;TABANG;TADOKALUA;91;37;25;1;19;1;0;3;0;86;5;AGUSTUS
5074;SULAWESI BARAT;MAMASA;TABANG;TABANG BARAT;154;70;47;1;33;2;0;0;1;154;0;AGUSTUS
5075;SULAWESI BARAT;MAMASA;TABANG;MASUPU;79;8;66;0;4;0;0;0;1;79;0;AGUSTUS
5076;SULAWESI BARAT;MAMASA;TABANG;KALAMA;68;11;20;0;21;3;0;2;0;57;11;AGUSTUS
5077;SULAWESI BARAT;MAMASA;TABANG;BAKADISURA;97;23;54;0;18;1;0;1;0;97;0;AGUSTUS
5078;SULAWESI BARAT;MAMASA;TABANG;SALUKONA;100;47;44;0;8;1;0;0;0;100;0;AGUSTUS
5079;SULAWESI BARAT;MAJENE;TUBO SENDANA;ONANG;335;103;58;19;119;8;14;12;0;333;2;AGUSTUS
5080;SULAWESI BARAT;MAJENE;TUBO SENDANA;TUBO;89;16;15;34;7;12;1;4;0;89;0;AGUSTUS
5081;SULAWESI BARAT;MAJENE;TUBO SENDANA;ONANG UTARA;97;22;22;2;33;12;4;2;0;97;0;AGUSTUS
5082;SULAWESI BARAT;MAJENE;TUBO SENDANA;TUBO SELATAN;101;31;21;0;27;15;2;5;0;101;0;AGUSTUS
5083;SULAWESI BARAT;MAJENE;TUBO SENDANA;BONDE BONDE;87;21;12;9;20;14;6;5;0;87;0;AGUSTUS
5084;SULAWESI BARAT;MAJENE;TUBO SENDANA;TUBO TENGAH;94;23;25;4;17;15;1;9;0;94;0;AGUSTUS
5085;SULAWESI BARAT;MAJENE;TUBO SENDANA;TUBO POANG;92;36;33;9;7;2;0;5;0;92;0;AGUSTUS
5086;SULAWESI BARAT;MAJENE;MALUNDA;MALUNDA;146;49;41;15;21;12;3;5;0;146;0;AGUSTUS
5087;SULAWESI BARAT;MAJENE;MALUNDA;LAMUNGANG BATU;128;46;45;1;19;4;0;12;0;127;1;AGUSTUS
5088;SULAWESI BARAT;MAJENE;MALUNDA;BAMBANGAN;159;82;39;3;33;2;0;0;0;159;0;AGUSTUS
5089;SULAWESI BARAT;MAJENE;MALUNDA;LOMBANG;94;53;18;1;19;1;0;2;0;94;0;AGUSTUS
5090;SULAWESI BARAT;MAJENE;MALUNDA;LOMBONG;217;59;99;7;24;6;0;20;0;215;2;AGUSTUS
5091;SULAWESI BARAT;MAJENE;MALUNDA;MEKKATTA;218;100;28;13;60;5;0;8;0;214;4;AGUSTUS
5092;SULAWESI BARAT;MAJENE;MALUNDA;MALIAYA;157;71;34;7;35;3;0;7;0;157;0;AGUSTUS
5093;SULAWESI BARAT;MAJENE;MALUNDA;LOMBANG TIMUR;153;92;49;2;9;1;0;0;0;153;0;AGUSTUS
5094;SULAWESI BARAT;MAJENE;MALUNDA;SALUTAHONGAN;98;63;26;0;6;1;0;1;0;97;1;AGUSTUS
5095;SULAWESI BARAT;MAJENE;MALUNDA;LOMBONG TIMUR;97;16;26;11;5;20;0;19;0;97;0;AGUSTUS
5096;SULAWESI BARAT;MAJENE;MALUNDA;MEKKATTA SELATAN;124;42;33;4;31;7;0;5;1;123;1;AGUSTUS
5097;SULAWESI BARAT;MAJENE;MALUNDA;KAYUANGIN;170;85;37;10;10;12;0;13;0;167;3;AGUSTUS
5098;SULAWESI BARAT;PASANGKAYU;DAPURANG;DAPURANG;412;227;66;4;81;19;1;7;0;405;7;AGUSTUS
5099;SULAWESI BARAT;PASANGKAYU;DAPURANG;BENGGAULU;269;111;74;0;65;6;0;13;0;269;0;AGUSTUS
5100;SULAWESI BARAT;PASANGKAYU;DAPURANG;TIRTABUANA;145;86;17;2;33;2;0;5;0;145;0;AGUSTUS
5101;SULAWESI BARAT;PASANGKAYU;DAPURANG;BULU BONGGU;237;63;40;3;116;6;0;3;0;231;6;AGUSTUS
5102;SULAWESI BARAT;PASANGKAYU;DAPURANG;SARASA;184;103;48;1;21;7;0;3;0;183;1;AGUSTUS
5103;SULAWESI BARAT;MAJENE;TAMMERODO SENDANA;SEPPONG;104;55;27;4;10;4;0;4;0;104;0;AGUSTUS
5104;SULAWESI BARAT;MAJENE;TAMMERODO SENDANA;TAMMERODO;146;67;27;3;13;21;4;9;0;144;2;AGUSTUS
5105;SULAWESI BARAT;MAJENE;TAMMERODO SENDANA;ULIDANG;162;92;25;4;17;7;2;14;0;161;1;AGUSTUS
5106;SULAWESI BARAT;MAJENE;TAMMERODO SENDANA;TALLAMBALAO;126;61;39;0;3;2;0;21;0;126;0;AGUSTUS
5107;SULAWESI BARAT;MAJENE;TAMMERODO SENDANA;TAMMERODO UTARA;164;81;35;6;15;19;0;8;0;164;0;AGUSTUS
5108;SULAWESI BARAT;MAJENE;TAMMERODO SENDANA;MANYAMBA;118;84;17;0;12;4;0;1;0;118;0;AGUSTUS
5109;SULAWESI BARAT;MAJENE;TAMMERODO SENDANA;AWO;152;83;31;1;8;9;6;11;0;149;3;AGUSTUS
5110;SULAWESI BARAT;POLEWALI MANDAR;ALLU;PETOOSANG;81;26;19;7;15;3;0;9;0;79;2;AGUSTUS
5111;SULAWESI BARAT;POLEWALI MANDAR;ALLU;MOMBI;133;59;25;6;32;0;4;5;1;132;1;AGUSTUS
5112;SULAWESI BARAT;POLEWALI MANDAR;ALLU;KALUMAMMANG;94;37;31;0;20;0;0;6;0;94;0;AGUSTUS
5113;SULAWESI BARAT;POLEWALI MANDAR;ALLU;PAO-PAO;199;76;58;0;63;0;0;2;0;199;0;AGUSTUS
5114;SULAWESI BARAT;POLEWALI MANDAR;ALLU;PUPPU URING;212;84;85;1;23;0;1;1;2;197;15;AGUSTUS
5115;SULAWESI BARAT;POLEWALI MANDAR;ALLU;SARAGIAN;122;61;30;6;17;0;0;8;0;122;0;AGUSTUS
5116;SULAWESI BARAT;POLEWALI MANDAR;ALLU;SAYOANG;41;18;17;0;4;1;0;1;0;41;0;AGUSTUS
5117;SULAWESI BARAT;POLEWALI MANDAR;ALLU;ALU;123;52;36;12;20;1;0;2;0;123;0;AGUSTUS
5118;SULAWESI BARAT;MAJENE;PAMBOANG;LALAMPANUA;108;21;9;19;36;7;0;13;2;107;1;AGUSTUS
5119;SULAWESI BARAT;MAJENE;PAMBOANG;SIRINDU;134;29;15;3;63;10;0;14;0;134;0;AGUSTUS
5120;SULAWESI BARAT;MAJENE;PAMBOANG;ADOLANG;99;24;5;1;60;3;0;6;0;99;0;AGUSTUS
5121;SULAWESI BARAT;MAJENE;PAMBOANG;BABABULO;181;87;26;8;45;7;1;7;0;181;0;AGUSTUS
5122;SULAWESI BARAT;MAJENE;PAMBOANG;BONDE;213;125;49;4;12;8;0;13;0;211;2;AGUSTUS
5123;SULAWESI BARAT;MAJENE;PAMBOANG;BETTENG;103;62;9;0;28;1;0;3;0;103;0;AGUSTUS
5124;SULAWESI BARAT;MAJENE;PAMBOANG;SIMBANG;58;13;13;6;19;3;1;3;0;58;0;AGUSTUS
5125;SULAWESI BARAT;MAJENE;PAMBOANG;BONDE UTARA;345;213;49;6;39;12;2;16;0;337;8;AGUSTUS
5126;SULAWESI BARAT;MAJENE;PAMBOANG;BABABULO UTARA;108;54;20;12;13;3;0;6;0;108;0;AGUSTUS
5127;SULAWESI BARAT;MAJENE;PAMBOANG;BUTTU PAMBOANG;102;45;18;2;26;4;0;7;0;102;0;AGUSTUS
5128;SULAWESI BARAT;MAJENE;PAMBOANG;BANUA ADOLANG;82;25;24;0;29;1;0;3;0;82;0;AGUSTUS
5129;SULAWESI BARAT;MAJENE;PAMBOANG;ADOLANG DHUA;94;39;3;2;37;0;1;8;0;90;4;AGUSTUS
5130;SULAWESI BARAT;MAJENE;PAMBOANG;TINAMBUNG;193;47;48;18;52;6;0;22;0;193;0;AGUSTUS
5131;SULAWESI BARAT;MAJENE;PAMBOANG;PESULOANG;96;29;8;6;38;1;3;11;0;96;0;AGUSTUS
5132;SULAWESI BARAT;MAJENE;PAMBOANG;BALOMBONG;97;25;10;2;49;6;0;5;0;97;0;AGUSTUS
5133;SULAWESI BARAT;MAJENE;BANGGAE TIMUR;BAURUNG;492;219;70;24;160;9;1;8;1;492;0;AGUSTUS
5134;SULAWESI BARAT;MAJENE;BANGGAE TIMUR;BARUGA;189;44;24;42;47;12;0;9;0;178;11;AGUSTUS
5135;SULAWESI BARAT;MAJENE;BANGGAE TIMUR;BARUGA DHUA;157;49;31;36;36;2;0;1;0;155;2;AGUSTUS
5136;SULAWESI BARAT;MAJENE;BANGGAE TIMUR;LABUANG;260;54;46;26;105;14;0;15;0;260;0;AGUSTUS
5137;SULAWESI BARAT;MAJENE;BANGGAE TIMUR;TANDE;120;19;24;29;34;4;0;3;0;113;7;AGUSTUS
5138;SULAWESI BARAT;MAJENE;BANGGAE TIMUR;LEMBANG;700;282;162;111;109;24;0;12;0;700;0;AGUSTUS
5139;SULAWESI BARAT;MAJENE;BANGGAE TIMUR;LABUANG UTARA;286;79;68;19;64;30;0;24;0;284;2;AGUSTUS
5140;SULAWESI BARAT;MAJENE;BANGGAE TIMUR;TANDE TIMUR;126;43;18;12;31;11;0;11;0;126;0;AGUSTUS
5141;SULAWESI BARAT;MAJENE;BANGGAE TIMUR;BUTTU BARUGA;61;10;7;1;41;0;0;1;0;60;1;AGUSTUS
5142;SULAWESI BARAT;MAJENE;SENDANA;MOSSO;330;146;86;4;61;20;1;10;1;329;1;AGUSTUS
5143;SULAWESI BARAT;MAJENE;SENDANA;MOSSO DHUA;96;29;23;5;12;12;2;5;0;88;8;AGUSTUS
5144;SULAWESI BARAT;MAJENE;SENDANA;TOTOLISI SENDANA;115;32;42;4;21;7;1;6;0;113;2;AGUSTUS
5145;SULAWESI BARAT;MAJENE;SENDANA;TALLUBANUA;140;44;32;14;12;20;1;7;0;130;10;AGUSTUS
5146;SULAWESI BARAT;MAJENE;SENDANA;LALATEDZONG;84;28;17;3;16;13;0;3;2;82;2;AGUSTUS
5147;SULAWESI BARAT;MAJENE;SENDANA;BINANGA;66;31;8;5;13;6;1;2;0;66;0;AGUSTUS
5148;SULAWESI BARAT;MAJENE;SENDANA;PUTTADA;59;37;14;0;6;1;0;1;0;59;0;AGUSTUS
5149;SULAWESI BARAT;MAJENE;SENDANA;PAMINGGALAN;43;33;10;0;0;0;0;0;0;43;0;AGUSTUS
5150;SULAWESI BARAT;MAJENE;SENDANA;LEPPANGANG;44;23;8;0;7;2;0;4;0;44;0;AGUSTUS
5151;SULAWESI BARAT;MAJENE;SENDANA;PUNDAU;62;4;25;5;22;3;0;3;0;62;0;AGUSTUS
5152;SULAWESI BARAT;MAJENE;SENDANA;SENDANA;73;35;23;1;0;6;1;7;0;73;0;AGUSTUS
5153;SULAWESI BARAT;MAJENE;SENDANA;BANUA SENDANA;96;57;11;4;1;18;0;5;0;96;0;AGUSTUS
5154;SULAWESI BARAT;MAJENE;SENDANA;TALLUBANUA UTARA;153;66;48;2;5;28;0;4;0;153;0;AGUSTUS
5155;SULAWESI BARAT;MAJENE;SENDANA;LIMBORO RAMBU-RAMBU;90;19;23;2;37;4;0;0;0;85;5;AGUSTUS
5156;SULAWESI BARAT;MAJENE;SENDANA;LIMBUA;92;31;24;2;19;12;0;4;0;92;0;AGUSTUS
5157;SULAWESI BARAT;MAJENE;SENDANA;BUKIT SAMANG;117;38;24;7;24;14;4;6;0;117;0;AGUSTUS
5158;SULAWESI BARAT;MAMUJU TENGAH;KAROSSA;KAROSSA;615;292;117;8;168;12;1;16;1;615;0;AGUSTUS
5159;SULAWESI BARAT;MAMUJU TENGAH;KAROSSA;TASOKKO;432;166;112;7;113;9;0;25;0;432;0;AGUSTUS
5160;SULAWESI BARAT;MAMUJU TENGAH;KAROSSA;LARA;119;36;12;2;61;4;1;3;0;119;0;AGUSTUS
5161;SULAWESI BARAT;MAMUJU TENGAH;KAROSSA;KADAILA;154;49;27;1;73;3;0;1;0;154;0;AGUSTUS
5162;SULAWESI BARAT;MAMUJU TENGAH;KAROSSA;KAYU CALLA;70;25;12;4;27;1;0;0;0;69;1;AGUSTUS
5163;SULAWESI BARAT;MAMUJU TENGAH;KAROSSA;LEMBAH HOPO;144;45;15;9;64;1;0;10;0;144;0;AGUSTUS
5164;SULAWESI BARAT;MAMUJU TENGAH;KAROSSA;BENGGAULU;257;119;60;2;59;9;0;7;0;256;1;AGUSTUS
5165;SULAWESI BARAT;MAMUJU TENGAH;KAROSSA;SUKA MAJU;101;36;37;1;21;2;0;1;0;98;3;AGUSTUS
5166;SULAWESI BARAT;MAMUJU TENGAH;KAROSSA;KAMBUNONG;285;148;68;1;50;6;0;11;0;284;1;AGUSTUS
5167;SULAWESI BARAT;MAMUJU TENGAH;KAROSSA;SALUBIRO;158;83;32;1;33;0;0;9;0;158;0;AGUSTUS
5168;SULAWESI BARAT;MAMUJU TENGAH;KAROSSA;SANJANGO;149;49;36;2;54;1;4;3;0;149;0;AGUSTUS
5169;SULAWESI BARAT;MAMUJU TENGAH;TOPOYO;BUDONG-BUDONG;244;100;66;4;48;8;0;10;0;236;8;AGUSTUS
5170;SULAWESI BARAT;MAMUJU TENGAH;TOPOYO;TOPOYO;909;302;215;16;184;58;0;26;0;801;108;AGUSTUS
5171;SULAWESI BARAT;MAMUJU TENGAH;TOPOYO;TUMBU;314;146;64;3;67;19;0;13;0;312;2;AGUSTUS
5172;SULAWESI BARAT;MAMUJU TENGAH;TOPOYO;KABUBU;273;76;41;18;120;13;1;4;0;273;0;AGUSTUS
5173;SULAWESI BARAT;MAMUJU TENGAH;TOPOYO;WAEPUTEH;281;150;26;18;76;5;0;3;0;278;3;AGUSTUS
5174;SULAWESI BARAT;MAMUJU TENGAH;TOPOYO;TANGKOU;124;58;28;0;31;3;0;2;2;124;0;AGUSTUS
5175;SULAWESI BARAT;MAMUJU TENGAH;TOPOYO;TABOLANG;447;158;100;12;107;8;1;10;2;398;49;AGUSTUS
5176;SULAWESI BARAT;MAMUJU TENGAH;TOPOYO;PARAILI;170;98;28;1;26;12;1;4;0;170;0;AGUSTUS
5177;SULAWESI BARAT;MAMUJU TENGAH;TOPOYO;SALUPANGKANG;464;133;63;11;244;8;0;3;1;463;1;AGUSTUS
5178;SULAWESI BARAT;MAMUJU TENGAH;TOPOYO;SALUPANGKANG IV;56;34;4;0;17;0;0;1;0;56;0;AGUSTUS
5179;SULAWESI BARAT;MAMUJU TENGAH;TOPOYO;TAPPILINA;152;45;38;11;36;15;0;7;0;152;0;AGUSTUS
5180;SULAWESI BARAT;MAMUJU TENGAH;TOPOYO;BAMBAMANURUNG;149;65;9;4;63;6;0;0;2;149;0;AGUSTUS
5181;SULAWESI BARAT;MAMUJU TENGAH;TOPOYO;SALULEKBO;386;152;88;5;137;2;0;1;0;385;1;AGUSTUS
5182;SULAWESI BARAT;MAMUJU TENGAH;TOPOYO;PANGALLOANG;256;83;58;2;105;6;0;2;0;256;0;AGUSTUS
5183;SULAWESI BARAT;MAMUJU TENGAH;TOPOYO;SINABATTA;104;49;28;1;15;6;0;2;0;101;3;AGUSTUS
0;SULAWESI BARAT;PASANGKAYU;BAMBAIRA;BAMBAIRA;258;81;45;5;103;9;0;12;0;255;3;SEPTEMBER
1;SULAWESI BARAT;PASANGKAYU;BAMBAIRA;KASOLOANG;172;67;19;0;64;11;0;11;0;172;0;SEPTEMBER
2;SULAWESI BARAT;PASANGKAYU;BAMBAIRA;TAMPAURE;227;92;51;1;58;6;0;12;1;221;6;SEPTEMBER
3;SULAWESI BARAT;PASANGKAYU;BAMBAIRA;KALUKU NANGKA;288;136;63;3;68;5;0;13;0;288;0;SEPTEMBER
4;SULAWESI BARAT;PASANGKAYU;BAMBALAMOTU;BAMBALAMOTU;385;171;73;4;86;23;0;26;0;383;2;SEPTEMBER
5;SULAWESI BARAT;PASANGKAYU;BAMBALAMOTU;POLEWALI;434;157;138;2;89;31;0;17;0;434;0;SEPTEMBER
6;SULAWESI BARAT;PASANGKAYU;BAMBALAMOTU;RANDOMAYANG;433;142;65;2;161;19;0;35;0;424;9;SEPTEMBER
7;SULAWESI BARAT;PASANGKAYU;BAMBALAMOTU;PANGIANG;183;98;38;2;23;14;0;8;0;183;0;SEPTEMBER
8;SULAWESI BARAT;PASANGKAYU;BAMBALAMOTU;KALOLA;464;131;102;0;199;19;0;13;0;464;0;SEPTEMBER
9;SULAWESI BARAT;PASANGKAYU;BAMBALAMOTU;WULAI;272;64;70;0;119;6;0;13;0;272;0;SEPTEMBER
10;SULAWESI BARAT;PASANGKAYU;BARAS;BARAS;276;100;28;2;95;38;0;13;0;276;0;SEPTEMBER
11;SULAWESI BARAT;PASANGKAYU;BARAS;BALANTI;352;176;70;2;84;10;0;7;0;349;3;SEPTEMBER
12;SULAWESI BARAT;PASANGKAYU;BARAS;MOTU;554;196;124;10;126;62;0;33;0;551;3;SEPTEMBER
13;SULAWESI BARAT;PASANGKAYU;BARAS;BULU PARIGI;167;66;11;2;81;6;0;1;0;167;0;SEPTEMBER
14;SULAWESI BARAT;PASANGKAYU;BARAS;TOWONI;162;42;44;1;63;7;0;5;0;162;0;SEPTEMBER
15;SULAWESI BARAT;PASANGKAYU;BARAS;KASANO;294;179;32;0;71;10;0;2;0;294;0;SEPTEMBER
16;SULAWESI BARAT;PASANGKAYU;BULU TABA;LILIMORI;282;105;37;7;79;33;0;21;0;282;0;SEPTEMBER
17;SULAWESI BARAT;PASANGKAYU;BULU TABA;KARAVE;250;91;41;20;64;8;0;12;0;236;14;SEPTEMBER
18;SULAWESI BARAT;PASANGKAYU;BULU TABA;BUKIT HARAPAN;141;58;35;0;33;10;1;4;0;141;0;SEPTEMBER
19;SULAWESI BARAT;PASANGKAYU;BULU TABA;KASTABUANA;161;91;25;1;30;7;0;6;0;160;1;SEPTEMBER
20;SULAWESI BARAT;PASANGKAYU;BULU TABA;SUMBER SARI;30;23;5;0;1;1;0;0;0;30;0;SEPTEMBER
21;SULAWESI BARAT;PASANGKAYU;BULU TABA;LELEJAE;157;70;24;2;40;11;0;9;1;157;0;SEPTEMBER
22;SULAWESI BARAT;PASANGKAYU;BULU TABA;OMPI;100;44;30;3;18;3;0;2;0;100;0;SEPTEMBER
23;SULAWESI BARAT;PASANGKAYU;DAPURANG;DAPURANG;411;225;67;4;82;19;1;7;0;405;6;SEPTEMBER
24;SULAWESI BARAT;PASANGKAYU;DAPURANG;BENGGAULU;269;113;73;0;64;6;0;13;0;269;0;SEPTEMBER
25;SULAWESI BARAT;PASANGKAYU;DAPURANG;TIRTABUANA;146;86;18;2;33;2;0;5;0;146;0;SEPTEMBER
26;SULAWESI BARAT;PASANGKAYU;DAPURANG;BULU BONGGU;236;62;38;3;117;6;0;4;0;230;6;SEPTEMBER
27;SULAWESI BARAT;PASANGKAYU;DAPURANG;SARASA;184;105;46;1;21;7;0;3;0;183;1;SEPTEMBER
28;SULAWESI BARAT;PASANGKAYU;DURIPOKU;TAMMARUNANG;176;55;48;12;47;5;0;9;0;176;0;SEPTEMBER
29;SULAWESI BARAT;PASANGKAYU;DURIPOKU;SAPTANAJAYA;202;117;38;1;33;10;0;3;0;202;0;SEPTEMBER
30;SULAWESI BARAT;PASANGKAYU;DURIPOKU;TARANGGI;88;15;20;6;40;5;0;1;0;87;1;SEPTEMBER
31;SULAWESI BARAT;PASANGKAYU;DURIPOKU;SIPAKAINGA;89;48;26;1;12;2;0;0;0;89;0;SEPTEMBER
32;SULAWESI BARAT;PASANGKAYU;LARIANG;PARABU;131;27;20;9;36;21;0;11;0;124;7;SEPTEMBER
33;SULAWESI BARAT;PASANGKAYU;LARIANG;KENANGAN;50;11;6;2;19;6;0;5;0;49;1;SEPTEMBER
34;SULAWESI BARAT;PASANGKAYU;LARIANG;BAJAWALI;122;24;21;5;48;12;0;12;0;122;0;SEPTEMBER
35;SULAWESI BARAT;PASANGKAYU;LARIANG;SINGGANI;176;75;47;0;34;9;0;9;0;174;2;SEPTEMBER
36;SULAWESI BARAT;PASANGKAYU;LARIANG;KULU;94;28;32;0;22;9;0;2;0;93;1;SEPTEMBER
37;SULAWESI BARAT;PASANGKAYU;LARIANG;BATU MATORU;85;28;18;0;22;8;0;9;0;85;0;SEPTEMBER
38;SULAWESI BARAT;PASANGKAYU;LARIANG;BAMBAKORO;147;54;27;1;47;9;0;9;0;147;0;SEPTEMBER
39;SULAWESI BARAT;PASANGKAYU;PASANGKAYU;PASANGKAYU;1493;624;373;33;153;230;24;51;0;1488;5;SEPTEMBER
40;SULAWESI BARAT;PASANGKAYU;PASANGKAYU;MARTAJAYA;179;60;33;4;44;24;0;14;0;179;0;SEPTEMBER
41;SULAWESI BARAT;PASANGKAYU;PASANGKAYU;PAKAVA;380;202;100;4;68;4;0;2;0;380;0;SEPTEMBER
42;SULAWESI BARAT;PASANGKAYU;PASANGKAYU;KARYA BERSAMA;326;153;55;3;79;28;0;8;0;326;0;SEPTEMBER
43;SULAWESI BARAT;PASANGKAYU;PASANGKAYU;AKO;426;194;85;4;76;42;0;15;0;416;10;SEPTEMBER
44;SULAWESI BARAT;PASANGKAYU;PASANGKAYU;GUNUNG SARI;521;282;75;7;102;24;0;23;0;513;8;SEPTEMBER
45;SULAWESI BARAT;PASANGKAYU;PEDONGGA;MALEI;227;112;61;2;35;15;0;2;0;227;0;SEPTEMBER
46;SULAWESI BARAT;PASANGKAYU;PEDONGGA;PEDANDA;201;54;55;3;76;6;0;6;0;200;1;SEPTEMBER
47;SULAWESI BARAT;PASANGKAYU;PEDONGGA;BATU OGE;147;62;27;2;47;8;0;1;0;147;0;SEPTEMBER
48;SULAWESI BARAT;PASANGKAYU;PEDONGGA;MARTASARI;547;200;64;5;241;24;0;11;0;545;2;SEPTEMBER
49;SULAWESI BARAT;PASANGKAYU;SARJO;SARJO;279;83;50;27;67;12;0;40;0;279;0;SEPTEMBER
50;SULAWESI BARAT;PASANGKAYU;SARJO;MAPONU;136;48;31;0;41;10;0;4;1;135;1;SEPTEMBER
51;SULAWESI BARAT;PASANGKAYU;SARJO;LETAWA;207;85;24;17;55;8;1;16;0;206;1;SEPTEMBER
52;SULAWESI BARAT;PASANGKAYU;SARJO;SARUDE;244;52;48;35;74;13;0;21;0;243;1;SEPTEMBER
53;SULAWESI BARAT;PASANGKAYU;SARUDU;SARUDU;400;230;61;4;77;12;1;13;0;398;2;SEPTEMBER
54;SULAWESI BARAT;PASANGKAYU;SARUDU;BULU MARIO;322;109;57;21;94;25;0;16;0;322;0;SEPTEMBER
55;SULAWESI BARAT;PASANGKAYU;SARUDU;KUMASARI;235;111;39;4;65;8;0;6;1;234;1;SEPTEMBER
56;SULAWESI BARAT;PASANGKAYU;SARUDU;PATIKA;55;16;13;0;9;4;0;6;0;48;7;SEPTEMBER
57;SULAWESI BARAT;PASANGKAYU;SARUDU;DODA;273;123;63;2;78;4;0;3;0;273;0;SEPTEMBER
58;SULAWESI BARAT;PASANGKAYU;TIKKE RAYA;TIKKE;313;89;52;3;102;41;0;12;1;300;13;SEPTEMBER
59;SULAWESI BARAT;PASANGKAYU;TIKKE RAYA;MAKMUR JAYA;474;175;117;4;128;26;0;20;1;471;3;SEPTEMBER
60;SULAWESI BARAT;PASANGKAYU;TIKKE RAYA;LARIANG;400;138;78;0;154;16;0;10;0;396;4;SEPTEMBER
61;SULAWESI BARAT;PASANGKAYU;TIKKE RAYA;PAJALELE;360;130;83;3;100;23;0;15;1;355;5;SEPTEMBER
62;SULAWESI BARAT;PASANGKAYU;TIKKE RAYA;JENGENG RAYA;184;57;39;9;52;19;0;8;0;184;0;SEPTEMBER
63;SULAWESI BARAT;MAMUJU;MAMUJU;BINANGA;788;451;161;15;72;59;1;18;2;779;9;SEPTEMBER
64;SULAWESI BARAT;MAMUJU;MAMUJU;MAMUNYU;591;299;155;38;51;28;1;15;0;587;4;SEPTEMBER
65;SULAWESI BARAT;MAMUJU;MAMUJU;KAREMA;859;447;117;38;103;63;2;33;0;803;56;SEPTEMBER
66;SULAWESI BARAT;MAMUJU;MAMUJU;RIMUKU;677;293;145;31;54;75;2;32;1;633;44;SEPTEMBER
67;SULAWESI BARAT;MAMUJU;MAMUJU;BAMBU;345;185;83;14;44;4;0;15;0;345;0;SEPTEMBER
68;SULAWESI BARAT;MAMUJU;MAMUJU;KARAMPUANG;483;350;69;1;35;11;0;14;0;480;3;SEPTEMBER
69;SULAWESI BARAT;MAMUJU;MAMUJU;TADUI;472;160;194;0;67;6;0;27;2;456;16;SEPTEMBER
70;SULAWESI BARAT;MAMUJU;MAMUJU;BATU PANNU;180;126;35;0;11;4;0;4;0;180;0;SEPTEMBER
71;SULAWESI BARAT;MAMUJU;TAPALANG;GALUNG;252;56;103;5;40;25;0;19;1;249;3;SEPTEMBER
72;SULAWESI BARAT;MAMUJU;TAPALANG;KASAMBANG;208;82;53;0;59;2;0;10;1;207;1;SEPTEMBER
73;SULAWESI BARAT;MAMUJU;TAPALANG;DAYANGINNA;125;37;38;8;25;5;0;7;0;120;5;SEPTEMBER
74;SULAWESI BARAT;MAMUJU;TAPALANG;OROBATU;90;29;32;10;3;9;0;7;0;90;0;SEPTEMBER
75;SULAWESI BARAT;MAMUJU;TAPALANG;TAKANDEANG;184;67;36;5;57;14;1;4;0;184;0;SEPTEMBER
76;SULAWESI BARAT;MAMUJU;TAPALANG;BELA;48;34;5;0;8;0;0;0;0;47;1;SEPTEMBER
77;SULAWESI BARAT;MAMUJU;TAPALANG;TAAN;207;74;72;1;50;2;0;7;0;206;1;SEPTEMBER
78;SULAWESI BARAT;MAMUJU;TAPALANG;TAMPALANG;161;69;35;2;38;3;0;10;1;158;3;SEPTEMBER
79;SULAWESI BARAT;MAMUJU;TAPALANG;RANTEDODA;77;34;14;13;11;0;0;5;0;77;0;SEPTEMBER
80;SULAWESI BARAT;MAMUJU;TAPALANG;KOPEANG;70;43;19;0;8;0;0;0;0;70;0;SEPTEMBER
81;SULAWESI BARAT;MAMUJU;KALUKKU;SINYONYOI;449;228;137;11;47;4;0;11;0;438;11;SEPTEMBER
82;SULAWESI BARAT;MAMUJU;KALUKKU;BEBANGA;761;447;210;5;65;6;2;23;0;758;3;SEPTEMBER
83;SULAWESI BARAT;MAMUJU;KALUKKU;KALUKKU;676;229;172;9;192;24;1;29;0;656;20;SEPTEMBER
84;SULAWESI BARAT;MAMUJU;KALUKKU;SINYONYOI SELATAN;282;137;72;6;34;3;0;25;0;277;5;SEPTEMBER
85;SULAWESI BARAT;MAMUJU;KALUKKU;SONDOANG;275;117;86;1;63;1;0;5;1;274;1;SEPTEMBER
86;SULAWESI BARAT;MAMUJU;KALUKKU;BERU-BERU;548;316;85;4;129;2;0;11;1;548;0;SEPTEMBER
87;SULAWESI BARAT;MAMUJU;KALUKKU;BELANG BELANG;353;132;112;1;97;1;0;10;0;353;0;SEPTEMBER
88;SULAWESI BARAT;MAMUJU;KALUKKU;KABULOANG;358;139;130;3;69;1;1;10;1;354;4;SEPTEMBER
89;SULAWESI BARAT;MAMUJU;KALUKKU;KEANG;238;71;128;1;28;2;0;7;0;237;1;SEPTEMBER
90;SULAWESI BARAT;MAMUJU;KALUKKU;POKKANG;193;82;37;2;59;3;1;9;0;193;0;SEPTEMBER
91;SULAWESI BARAT;MAMUJU;KALUKKU;GULILING;151;47;63;0;36;0;0;2;2;150;1;SEPTEMBER
92;SULAWESI BARAT;MAMUJU;KALUKKU;UHAIMATE;124;79;36;0;9;0;0;0;0;124;0;SEPTEMBER
93;SULAWESI BARAT;MAMUJU;KALUKKU;KALUKKU BARAT;474;277;66;1;125;2;0;3;0;474;0;SEPTEMBER
94;SULAWESI BARAT;MAMUJU;KALUKKU;PAMMULUKANG;231;113;74;7;23;0;0;12;1;230;1;SEPTEMBER
95;SULAWESI BARAT;MAMUJU;BONEHAU;BONEHAU;167;44;86;3;23;2;0;3;0;161;6;SEPTEMBER
96;SULAWESI BARAT;MAMUJU;BONEHAU;SALUTIWO;92;33;38;2;19;0;0;0;0;92;0;SEPTEMBER
97;SULAWESI BARAT;MAMUJU;BONEHAU;BUTTUADA;203;9;171;3;16;1;0;1;0;201;2;SEPTEMBER
98;SULAWESI BARAT;MAMUJU;BONEHAU;TAMALEA;48;4;36;0;7;0;0;1;0;48;0;SEPTEMBER
99;SULAWESI BARAT;MAMUJU;BONEHAU;LUMIKA;128;37;56;2;32;1;0;0;0;128;0;SEPTEMBER
100;SULAWESI BARAT;MAMUJU;BONEHAU;MAPPU;73;16;44;0;12;0;0;1;0;73;0;SEPTEMBER
101;SULAWESI BARAT;MAMUJU;BONEHAU;BANUADA;98;12;80;1;3;0;0;2;0;98;0;SEPTEMBER
102;SULAWESI BARAT;MAMUJU;BONEHAU;HINUA;103;30;23;7;36;1;0;3;1;101;2;SEPTEMBER
103;SULAWESI BARAT;MAMUJU;BONEHAU;KINATANG;113;21;89;1;0;0;0;2;0;113;0;SEPTEMBER
104;SULAWESI BARAT;MAMUJU;KALUMPANG;KALUMPANG;51;26;12;0;7;0;0;3;0;48;3;SEPTEMBER
105;SULAWESI BARAT;MAMUJU;KALUMPANG;KARATAUN;177;99;38;0;37;0;0;1;0;175;2;SEPTEMBER
106;SULAWESI BARAT;MAMUJU;KALUMPANG;KARAMA;127;53;48;0;25;0;0;1;0;127;0;SEPTEMBER
107;SULAWESI BARAT;MAMUJU;KALUMPANG;SIRAUN;96;56;21;0;18;0;0;0;1;96;0;SEPTEMBER
108;SULAWESI BARAT;MAMUJU;KALUMPANG;TUMOGA;76;34;15;0;22;0;0;0;0;71;5;SEPTEMBER
109;SULAWESI BARAT;MAMUJU;KALUMPANG;SALUMAKKI;92;64;14;0;12;0;0;0;0;90;2;SEPTEMBER
110;SULAWESI BARAT;MAMUJU;KALUMPANG;POLIO;62;31;22;0;9;0;0;0;0;62;0;SEPTEMBER
111;SULAWESI BARAT;MAMUJU;KALUMPANG;LIMBONG;89;25;18;0;44;1;0;1;0;89;0;SEPTEMBER
112;SULAWESI BARAT;MAMUJU;KALUMPANG;SANDAPANG;92;27;5;0;58;0;0;1;0;91;1;SEPTEMBER
113;SULAWESI BARAT;MAMUJU;KALUMPANG;KONDO BULO;85;51;26;0;6;0;0;1;0;84;1;SEPTEMBER
114;SULAWESI BARAT;MAMUJU;KALUMPANG;MAKKALIKI;71;35;18;0;18;0;0;0;0;71;0;SEPTEMBER
115;SULAWESI BARAT;MAMUJU;KALUMPANG;BATU MAKKADA;77;34;35;0;7;0;0;0;0;76;1;SEPTEMBER
116;SULAWESI BARAT;MAMUJU;KALUMPANG;LASA';117;72;25;0;16;0;0;0;1;114;3;SEPTEMBER
117;SULAWESI BARAT;MAMUJU;KEP. BALA BALAKANG;BALA BALAKANG;124;60;52;2;9;0;0;0;0;123;1;SEPTEMBER
118;SULAWESI BARAT;MAMUJU;KEP. BALA BALAKANG;BALA-BALAKANG TIMUR;97;29;66;1;0;0;1;0;0;97;0;SEPTEMBER
119;SULAWESI BARAT;MAMUJU;SAMPAGA;BUNDE;507;247;126;2;126;1;0;5;0;507;0;SEPTEMBER
120;SULAWESI BARAT;MAMUJU;SAMPAGA;KALONDING;443;175;180;8;72;4;0;3;0;442;1;SEPTEMBER
121;SULAWESI BARAT;MAMUJU;SAMPAGA;TARAILU;260;119;80;0;49;5;0;7;0;260;0;SEPTEMBER
122;SULAWESI BARAT;MAMUJU;SAMPAGA;SAMPAGA;187;96;60;2;24;1;0;3;1;187;0;SEPTEMBER
123;SULAWESI BARAT;MAMUJU;SAMPAGA;TANAMBUAH;70;22;24;1;22;0;0;1;0;70;0;SEPTEMBER
124;SULAWESI BARAT;MAMUJU;SAMPAGA;SALUBARANA;68;33;16;1;15;1;0;2;0;68;0;SEPTEMBER
125;SULAWESI BARAT;MAMUJU;SAMPAGA;LOSSO;133;49;29;0;54;0;0;0;0;132;1;SEPTEMBER
126;SULAWESI BARAT;MAMUJU;PAPALANG;TOABO;636;275;153;4;190;9;0;4;0;635;1;SEPTEMBER
127;SULAWESI BARAT;MAMUJU;PAPALANG;PAPALANG;682;314;182;8;136;3;0;5;0;648;34;SEPTEMBER
128;SULAWESI BARAT;MAMUJU;PAPALANG;BONDA;316;175;87;3;48;1;0;1;0;315;1;SEPTEMBER
129;SULAWESI BARAT;MAMUJU;PAPALANG;TOPORE;189;99;40;7;34;1;0;2;0;183;6;SEPTEMBER
130;SULAWESI BARAT;MAMUJU;PAPALANG;SALUKAYU;251;123;86;2;31;3;0;6;0;251;0;SEPTEMBER
131;SULAWESI BARAT;MAMUJU;PAPALANG;SUKADAMAI;98;50;32;1;11;0;0;4;0;98;0;SEPTEMBER
132;SULAWESI BARAT;MAMUJU;PAPALANG;BODA-BODA;188;97;71;1;18;0;0;1;0;188;0;SEPTEMBER
133;SULAWESI BARAT;MAMUJU;PAPALANG;SISANGO;102;29;63;0;5;3;0;1;0;101;1;SEPTEMBER
134;SULAWESI BARAT;MAMUJU;PAPALANG;BATU AMPA;162;49;85;11;17;0;0;0;0;162;0;SEPTEMBER
135;SULAWESI BARAT;MAMUJU;SIMBORO;SIMBORO;1539;608;179;71;167;252;1;71;5;1354;185;SEPTEMBER
136;SULAWESI BARAT;MAMUJU;SIMBORO;RANGAS;554;165;149;21;126;20;3;11;0;495;59;SEPTEMBER
137;SULAWESI BARAT;MAMUJU;SIMBORO;BOTTENG;187;99;45;1;25;3;0;13;0;186;1;SEPTEMBER
138;SULAWESI BARAT;MAMUJU;SIMBORO;SALETTO;284;132;74;6;45;4;1;22;0;284;0;SEPTEMBER
139;SULAWESI BARAT;MAMUJU;SIMBORO;SUMARE;224;103;82;2;28;9;0;0;0;224;0;SEPTEMBER
140;SULAWESI BARAT;MAMUJU;SIMBORO;BOTTENG UTARA;364;140;95;1;108;5;1;0;0;350;14;SEPTEMBER
141;SULAWESI BARAT;MAMUJU;SIMBORO;TAPANDULLU;48;29;0;0;14;1;2;2;0;48;0;SEPTEMBER
142;SULAWESI BARAT;MAMUJU;SIMBORO;PATI'DI;180;101;37;1;36;1;0;4;0;180;0;SEPTEMBER
143;SULAWESI BARAT;MAMUJU;TAPALANG BARAT;DUNGKAIT;249;100;98;5;37;3;1;3;0;247;2;SEPTEMBER
144;SULAWESI BARAT;MAMUJU;TAPALANG BARAT;LEBANI;118;43;50;0;8;0;0;4;2;107;11;SEPTEMBER
145;SULAWESI BARAT;MAMUJU;TAPALANG BARAT;LABUANG RANO;208;109;69;0;14;4;0;2;0;198;10;SEPTEMBER
146;SULAWESI BARAT;MAMUJU;TAPALANG BARAT;PASABU;152;46;58;5;19;7;0;15;1;151;1;SEPTEMBER
147;SULAWESI BARAT;MAMUJU;TAPALANG BARAT;TANETE PAO;44;30;10;0;2;0;0;1;0;43;1;SEPTEMBER
148;SULAWESI BARAT;MAMUJU;TAPALANG BARAT;PANGASAAN;48;21;16;1;4;4;0;0;0;46;2;SEPTEMBER
149;SULAWESI BARAT;MAMUJU;TAPALANG BARAT;AHU;162;92;53;2;7;0;0;1;0;155;7;SEPTEMBER
150;SULAWESI BARAT;MAMUJU;TOMMO;TOMMO;337;118;72;3;129;6;0;9;0;337;0;SEPTEMBER
151;SULAWESI BARAT;MAMUJU;TOMMO;CAMPALOGA;294;83;117;13;70;6;0;1;0;290;4;SEPTEMBER
152;SULAWESI BARAT;MAMUJU;TOMMO;BUANA SAKTI;214;78;49;1;85;1;0;0;0;214;0;SEPTEMBER
153;SULAWESI BARAT;MAMUJU;TOMMO;TAMEMONGGA;223;74;110;0;34;2;0;3;0;223;0;SEPTEMBER
154;SULAWESI BARAT;MAMUJU;TOMMO;TAMEJARRA;201;66;59;4;52;7;1;12;0;201;0;SEPTEMBER
155;SULAWESI BARAT;MAMUJU;TOMMO;RANTEMARIO;162;64;60;3;20;6;0;5;0;158;4;SEPTEMBER
156;SULAWESI BARAT;MAMUJU;TOMMO;MALINO;75;42;20;6;4;1;0;1;0;74;1;SEPTEMBER
157;SULAWESI BARAT;MAMUJU;TOMMO;KAKULLASANG;373;149;148;6;56;1;0;6;2;368;5;SEPTEMBER
158;SULAWESI BARAT;MAMUJU;TOMMO;LELING;143;37;75;1;28;0;0;2;0;143;0;SEPTEMBER
159;SULAWESI BARAT;MAMUJU;TOMMO;KALEPU;110;53;50;1;5;1;0;0;0;110;0;SEPTEMBER
160;SULAWESI BARAT;MAMUJU;TOMMO;SANDANA;135;50;49;3;21;2;0;9;1;135;0;SEPTEMBER
161;SULAWESI BARAT;MAMUJU;TOMMO;LELING BARAT;205;61;87;3;45;5;0;3;0;204;1;SEPTEMBER
162;SULAWESI BARAT;MAMUJU;TOMMO;LELING UTARA;193;68;100;0;25;0;0;0;0;193;0;SEPTEMBER
163;SULAWESI BARAT;MAMUJU;TOMMO;SALUDENGEN;135;67;59;0;7;0;0;2;0;135;0;SEPTEMBER
164;SULAWESI BARAT;MAJENE;BANGGAE;BANGGAE;337;96;109;16;66;35;1;14;0;337;0;SEPTEMBER
165;SULAWESI BARAT;MAJENE;BANGGAE;BARU;513;147;134;10;184;15;0;23;0;513;0;SEPTEMBER
166;SULAWESI BARAT;MAJENE;BANGGAE;PANGALI ALI;833;285;235;10;197;61;1;37;0;826;7;SEPTEMBER
167;SULAWESI BARAT;MAJENE;BANGGAE;TOTOLI;441;148;105;18;137;13;1;19;0;441;0;SEPTEMBER
168;SULAWESI BARAT;MAJENE;BANGGAE;RANGAS;898;352;341;15;139;33;1;15;2;898;0;SEPTEMBER
169;SULAWESI BARAT;MAJENE;BANGGAE;GALUNG;241;42;37;24;75;24;0;37;0;239;2;SEPTEMBER
170;SULAWESI BARAT;MAJENE;BANGGAE;PALIPI SOREANG;238;111;40;16;50;10;0;11;0;238;0;SEPTEMBER
171;SULAWESI BARAT;MAJENE;BANGGAE;PAMBOBORANG;235;44;77;15;72;5;0;21;0;234;1;SEPTEMBER
172;SULAWESI BARAT;MAJENE;MALUNDA;MALUNDA;147;51;41;14;21;12;3;5;0;147;0;SEPTEMBER
173;SULAWESI BARAT;MAJENE;MALUNDA;LAMUNGANG BATU;127;45;44;1;19;4;0;13;0;126;1;SEPTEMBER
174;SULAWESI BARAT;MAJENE;MALUNDA;BAMBANGAN;159;81;39;3;33;2;0;1;0;159;0;SEPTEMBER
175;SULAWESI BARAT;MAJENE;MALUNDA;LOMBANG;92;52;17;1;19;1;0;2;0;92;0;SEPTEMBER
176;SULAWESI BARAT;MAJENE;MALUNDA;LOMBONG;218;59;97;8;25;7;0;20;0;216;2;SEPTEMBER
177;SULAWESI BARAT;MAJENE;MALUNDA;MEKKATTA;218;98;28;13;62;5;0;8;0;214;4;SEPTEMBER
178;SULAWESI BARAT;MAJENE;MALUNDA;MALIAYA;158;73;33;7;35;3;0;7;0;158;0;SEPTEMBER
179;SULAWESI BARAT;MAJENE;MALUNDA;LOMBANG TIMUR;153;89;50;2;11;1;0;0;0;153;0;SEPTEMBER
180;SULAWESI BARAT;MAJENE;MALUNDA;SALUTAHONGAN;97;62;26;0;6;1;0;1;0;96;1;SEPTEMBER
181;SULAWESI BARAT;MAJENE;MALUNDA;LOMBONG TIMUR;94;15;24;11;6;19;0;19;0;94;0;SEPTEMBER
182;SULAWESI BARAT;MAJENE;MALUNDA;MEKKATTA SELATAN;124;44;31;4;31;7;0;5;1;123;1;SEPTEMBER
183;SULAWESI BARAT;MAJENE;MALUNDA;KAYUANGIN;165;81;36;10;10;12;0;13;0;162;3;SEPTEMBER
184;SULAWESI BARAT;MAJENE;BANGGAE TIMUR;BAURUNG;455;199;62;20;156;9;1;7;1;455;0;SEPTEMBER
185;SULAWESI BARAT;MAJENE;BANGGAE TIMUR;BARUGA;187;44;23;40;48;12;0;10;0;177;10;SEPTEMBER
186;SULAWESI BARAT;MAJENE;BANGGAE TIMUR;BARUGA DHUA;149;45;31;34;30;3;0;2;0;145;4;SEPTEMBER
187;SULAWESI BARAT;MAJENE;BANGGAE TIMUR;LABUANG;243;57;39;18;98;14;0;17;0;243;0;SEPTEMBER
188;SULAWESI BARAT;MAJENE;BANGGAE TIMUR;TANDE;117;18;26;27;32;2;0;4;1;110;7;SEPTEMBER
189;SULAWESI BARAT;MAJENE;BANGGAE TIMUR;LEMBANG;673;268;154;111;103;24;0;13;0;673;0;SEPTEMBER
190;SULAWESI BARAT;MAJENE;BANGGAE TIMUR;LABUANG UTARA;249;65;59;18;59;25;0;21;0;247;2;SEPTEMBER
191;SULAWESI BARAT;MAJENE;BANGGAE TIMUR;TANDE TIMUR;119;43;16;8;30;11;0;11;0;119;0;SEPTEMBER
192;SULAWESI BARAT;MAJENE;BANGGAE TIMUR;BUTTU BARUGA;61;11;6;1;41;0;0;1;0;60;1;SEPTEMBER
193;SULAWESI BARAT;MAJENE;PAMBOANG;LALAMPANUA;104;20;7;18;37;7;0;13;1;103;1;SEPTEMBER
194;SULAWESI BARAT;MAJENE;PAMBOANG;SIRINDU;135;30;13;4;64;10;0;14;0;135;0;SEPTEMBER
195;SULAWESI BARAT;MAJENE;PAMBOANG;ADOLANG;93;24;6;0;54;3;0;6;0;93;0;SEPTEMBER
196;SULAWESI BARAT;MAJENE;PAMBOANG;BABABULO;171;88;18;7;43;7;1;7;0;171;0;SEPTEMBER
197;SULAWESI BARAT;MAJENE;PAMBOANG;BONDE;201;114;42;14;12;7;0;12;0;201;0;SEPTEMBER
198;SULAWESI BARAT;MAJENE;PAMBOANG;BETTENG;97;57;8;0;29;1;0;2;0;97;0;SEPTEMBER
199;SULAWESI BARAT;MAJENE;PAMBOANG;SIMBANG;43;10;6;5;16;2;1;3;0;43;0;SEPTEMBER
200;SULAWESI BARAT;MAJENE;PAMBOANG;BONDE UTARA;345;214;49;6;39;12;2;16;0;338;7;SEPTEMBER
201;SULAWESI BARAT;MAJENE;PAMBOANG;BABABULO UTARA;95;43;19;11;13;3;0;6;0;95;0;SEPTEMBER
202;SULAWESI BARAT;MAJENE;PAMBOANG;BUTTU PAMBOANG;94;38;15;3;27;4;0;7;0;94;0;SEPTEMBER
203;SULAWESI BARAT;MAJENE;PAMBOANG;BANUA ADOLANG;78;29;19;0;26;1;0;3;0;78;0;SEPTEMBER
204;SULAWESI BARAT;MAJENE;PAMBOANG;ADOLANG DHUA;99;39;4;2;41;0;1;8;0;95;4;SEPTEMBER
205;SULAWESI BARAT;MAJENE;PAMBOANG;TINAMBUNG;189;44;47;16;54;6;0;22;0;189;0;SEPTEMBER
206;SULAWESI BARAT;MAJENE;PAMBOANG;PESULOANG;92;29;7;6;35;1;3;11;0;92;0;SEPTEMBER
207;SULAWESI BARAT;MAJENE;PAMBOANG;BALOMBONG;96;24;10;2;48;6;0;6;0;96;0;SEPTEMBER
208;SULAWESI BARAT;MAJENE;SENDANA;MOSSO;330;144;88;4;64;17;1;10;1;329;1;SEPTEMBER
209;SULAWESI BARAT;MAJENE;SENDANA;MOSSO DHUA;84;23;20;4;10;12;2;5;0;76;8;SEPTEMBER
210;SULAWESI BARAT;MAJENE;SENDANA;TOTOLISI SENDANA;100;27;32;3;24;6;1;6;0;99;1;SEPTEMBER
211;SULAWESI BARAT;MAJENE;SENDANA;TALLUBANUA;120;43;29;12;7;15;1;7;0;114;6;SEPTEMBER
212;SULAWESI BARAT;MAJENE;SENDANA;LALATEDZONG;76;25;16;2;13;13;0;3;2;74;2;SEPTEMBER
213;SULAWESI BARAT;MAJENE;SENDANA;BINANGA;53;23;3;0;17;7;1;2;0;53;0;SEPTEMBER
214;SULAWESI BARAT;MAJENE;SENDANA;PUTTADA;51;33;13;0;3;1;0;1;0;51;0;SEPTEMBER
215;SULAWESI BARAT;MAJENE;SENDANA;PAMINGGALAN;43;33;10;0;0;0;0;0;0;43;0;SEPTEMBER
216;SULAWESI BARAT;MAJENE;SENDANA;LEPPANGANG;23;10;2;0;5;2;0;4;0;23;0;SEPTEMBER
217;SULAWESI BARAT;MAJENE;SENDANA;PUNDAU;36;3;8;1;17;3;0;3;0;35;1;SEPTEMBER
218;SULAWESI BARAT;MAJENE;SENDANA;SENDANA;51;26;10;1;0;7;1;6;0;51;0;SEPTEMBER
219;SULAWESI BARAT;MAJENE;SENDANA;BANUA SENDANA;94;53;12;4;2;17;0;6;0;94;0;SEPTEMBER
220;SULAWESI BARAT;MAJENE;SENDANA;TALLUBANUA UTARA;122;53;31;2;2;29;0;5;0;122;0;SEPTEMBER
221;SULAWESI BARAT;MAJENE;SENDANA;LIMBORO RAMBU-RAMBU;71;13;19;1;31;3;0;0;0;67;4;SEPTEMBER
222;SULAWESI BARAT;MAJENE;SENDANA;LIMBUA;81;26;16;2;21;12;0;4;0;81;0;SEPTEMBER
223;SULAWESI BARAT;MAJENE;SENDANA;BUKIT SAMANG;74;21;14;6;12;10;4;7;0;74;0;SEPTEMBER
224;SULAWESI BARAT;MAJENE;TAMMERODO SENDANA;SEPPONG;98;52;25;4;9;4;0;4;0;98;0;SEPTEMBER
225;SULAWESI BARAT;MAJENE;TAMMERODO SENDANA;TAMMERODO;146;65;28;3;15;20;4;9;0;144;2;SEPTEMBER
226;SULAWESI BARAT;MAJENE;TAMMERODO SENDANA;ULIDANG;147;87;21;3;15;7;2;11;0;146;1;SEPTEMBER
227;SULAWESI BARAT;MAJENE;TAMMERODO SENDANA;TALLAMBALAO;138;67;44;0;5;2;0;20;0;138;0;SEPTEMBER
228;SULAWESI BARAT;MAJENE;TAMMERODO SENDANA;TAMMERODO UTARA;164;84;35;6;13;18;0;8;0;164;0;SEPTEMBER
229;SULAWESI BARAT;MAJENE;TAMMERODO SENDANA;MANYAMBA;112;79;16;0;13;2;0;2;0;112;0;SEPTEMBER
230;SULAWESI BARAT;MAJENE;TAMMERODO SENDANA;AWO;138;78;25;0;6;9;6;11;0;135;3;SEPTEMBER
231;SULAWESI BARAT;MAJENE;TUBO SENDANA;ONANG;261;66;36;11;110;8;16;11;0;258;3;SEPTEMBER
232;SULAWESI BARAT;MAJENE;TUBO SENDANA;TUBO;83;16;15;26;7;13;1;5;0;83;0;SEPTEMBER
233;SULAWESI BARAT;MAJENE;TUBO SENDANA;ONANG UTARA;61;11;14;2;18;10;4;2;0;61;0;SEPTEMBER
234;SULAWESI BARAT;MAJENE;TUBO SENDANA;TUBO SELATAN;72;23;10;0;18;13;2;5;0;71;1;SEPTEMBER
235;SULAWESI BARAT;MAJENE;TUBO SENDANA;BONDE BONDE;54;10;5;3;12;13;6;5;0;54;0;SEPTEMBER
236;SULAWESI BARAT;MAJENE;TUBO SENDANA;TUBO TENGAH;84;19;17;3;18;16;1;10;0;84;0;SEPTEMBER
237;SULAWESI BARAT;MAJENE;TUBO SENDANA;TUBO POANG;65;26;17;9;7;2;0;4;0;65;0;SEPTEMBER
238;SULAWESI BARAT;MAJENE;ULUMANDA;KABIRAAN;126;84;16;1;21;1;0;3;0;126;0;SEPTEMBER
239;SULAWESI BARAT;MAJENE;ULUMANDA;SAMBABO;61;38;10;0;7;0;0;2;0;57;4;SEPTEMBER
240;SULAWESI BARAT;MAJENE;ULUMANDA;TANDEALLO;132;62;45;3;5;1;2;13;0;131;1;SEPTEMBER
241;SULAWESI BARAT;MAJENE;ULUMANDA;ULUMANDA;142;45;71;3;8;5;1;9;0;142;0;SEPTEMBER
242;SULAWESI BARAT;MAJENE;ULUMANDA;SALUTAMBUNG;103;72;14;3;10;0;1;3;0;103;0;SEPTEMBER
243;SULAWESI BARAT;MAJENE;ULUMANDA;POPENGA;77;55;16;1;1;0;0;4;0;77;0;SEPTEMBER
244;SULAWESI BARAT;MAJENE;ULUMANDA;SULAI;127;51;45;6;17;0;0;8;0;127;0;SEPTEMBER
245;SULAWESI BARAT;MAJENE;ULUMANDA;PANGGALO;106;52;37;2;10;2;0;1;0;104;2;SEPTEMBER
246;SULAWESI BARAT;POLEWALI MANDAR;ALLU;PETOOSANG;81;25;21;7;15;2;0;9;0;79;2;SEPTEMBER
247;SULAWESI BARAT;POLEWALI MANDAR;ALLU;MOMBI;127;56;25;6;29;0;3;7;0;126;1;SEPTEMBER
248;SULAWESI BARAT;POLEWALI MANDAR;ALLU;KALUMAMMANG;95;32;33;0;24;0;0;6;0;95;0;SEPTEMBER
249;SULAWESI BARAT;POLEWALI MANDAR;ALLU;PAO-PAO;169;64;49;0;55;0;0;1;0;169;0;SEPTEMBER
250;SULAWESI BARAT;POLEWALI MANDAR;ALLU;PUPPU URING;211;83;84;1;24;0;1;1;2;196;15;SEPTEMBER
251;SULAWESI BARAT;POLEWALI MANDAR;ALLU;SARAGIAN;101;54;16;5;17;0;0;9;0;101;0;SEPTEMBER
252;SULAWESI BARAT;POLEWALI MANDAR;ALLU;SAYOANG;31;15;9;0;5;1;0;1;0;31;0;SEPTEMBER
253;SULAWESI BARAT;POLEWALI MANDAR;ALLU;ALU;120;54;33;12;18;1;0;2;0;120;0;SEPTEMBER
254;SULAWESI BARAT;POLEWALI MANDAR;ANREAPI;ANREAPI;166;33;52;6;48;11;0;13;1;164;2;SEPTEMBER
255;SULAWESI BARAT;POLEWALI MANDAR;ANREAPI;DUAMPANUA;398;117;145;25;85;3;0;17;0;392;6;SEPTEMBER
256;SULAWESI BARAT;POLEWALI MANDAR;ANREAPI;KELAPA DUA;272;75;122;3;54;2;2;13;0;271;1;SEPTEMBER
257;SULAWESI BARAT;POLEWALI MANDAR;ANREAPI;PAPPANDANGAN;248;91;69;10;64;2;3;8;0;247;1;SEPTEMBER
258;SULAWESI BARAT;POLEWALI MANDAR;ANREAPI;KUNYI;239;39;108;4;66;4;0;11;1;233;6;SEPTEMBER
259;SULAWESI BARAT;POLEWALI MANDAR;BALANIPA;BALANIPA;182;81;35;15;34;6;0;11;0;182;0;SEPTEMBER
260;SULAWESI BARAT;POLEWALI MANDAR;BALANIPA;TAMMAJARRA;175;124;12;17;15;4;0;3;0;175;0;SEPTEMBER
261;SULAWESI BARAT;POLEWALI MANDAR;BALANIPA;TAMANGGALLE;110;60;19;0;27;1;0;2;1;110;0;SEPTEMBER
262;SULAWESI BARAT;POLEWALI MANDAR;BALANIPA;MOSSO;77;53;14;5;4;0;0;1;0;77;0;SEPTEMBER
263;SULAWESI BARAT;POLEWALI MANDAR;BALANIPA;GALUNG TULUK;184;97;37;18;20;1;0;11;0;184;0;SEPTEMBER
264;SULAWESI BARAT;POLEWALI MANDAR;BALANIPA;SABANG SUBIK;205;124;24;9;24;5;0;19;0;205;0;SEPTEMBER
265;SULAWESI BARAT;POLEWALI MANDAR;BALANIPA;PAMBUSUANG;415;234;71;11;33;10;1;28;1;389;26;SEPTEMBER
266;SULAWESI BARAT;POLEWALI MANDAR;BALANIPA;BALA;323;244;30;2;20;5;0;19;0;320;3;SEPTEMBER
267;SULAWESI BARAT;POLEWALI MANDAR;BALANIPA;LAMBANAN;13;5;2;3;2;0;0;1;0;13;0;SEPTEMBER
268;SULAWESI BARAT;POLEWALI MANDAR;BALANIPA;LEGO;106;70;23;0;5;0;0;8;0;106;0;SEPTEMBER
269;SULAWESI BARAT;POLEWALI MANDAR;BALANIPA;PALLIS;29;14;8;1;3;1;0;2;0;29;0;SEPTEMBER
270;SULAWESI BARAT;POLEWALI MANDAR;BINUANG;AMASSANGAN;295;133;55;2;72;2;0;31;0;295;0;SEPTEMBER
271;SULAWESI BARAT;POLEWALI MANDAR;BINUANG;TONYAMAN;495;199;148;4;97;13;0;13;2;476;19;SEPTEMBER
272;SULAWESI BARAT;POLEWALI MANDAR;BINUANG;KUAJANG;389;168;87;11;106;4;0;13;0;389;0;SEPTEMBER
273;SULAWESI BARAT;POLEWALI MANDAR;BINUANG;PAKU;141;69;29;11;21;0;0;10;1;141;0;SEPTEMBER
274;SULAWESI BARAT;POLEWALI MANDAR;BINUANG;MIRRING;216;110;39;5;41;1;0;17;0;213;3;SEPTEMBER
275;SULAWESI BARAT;POLEWALI MANDAR;BINUANG;BATETANGNGA;692;402;147;10;79;5;0;19;2;664;28;SEPTEMBER
276;SULAWESI BARAT;POLEWALI MANDAR;BINUANG;MAMMI;244;80;56;8;86;3;0;10;0;243;1;SEPTEMBER
277;SULAWESI BARAT;POLEWALI MANDAR;BINUANG;KALEOK;140;53;58;1;23;0;0;5;0;140;0;SEPTEMBER
278;SULAWESI BARAT;POLEWALI MANDAR;BINUANG;AMOLA;150;92;22;2;31;0;1;2;0;150;0;SEPTEMBER
279;SULAWESI BARAT;POLEWALI MANDAR;BINUANG;REA;187;74;48;7;30;1;2;18;0;180;7;SEPTEMBER
280;SULAWESI BARAT;POLEWALI MANDAR;BULO;BULO;108;19;12;2;73;2;0;0;0;108;0;SEPTEMBER
281;SULAWESI BARAT;POLEWALI MANDAR;BULO;PULLIWA;306;100;50;3;139;3;0;10;0;305;1;SEPTEMBER
282;SULAWESI BARAT;POLEWALI MANDAR;BULO;PATAMBANUA;145;27;108;0;7;0;0;1;0;143;2;SEPTEMBER
283;SULAWESI BARAT;POLEWALI MANDAR;BULO;KAROMBANG;140;80;20;0;37;2;0;1;0;140;0;SEPTEMBER
284;SULAWESI BARAT;POLEWALI MANDAR;BULO;DAALA TIMUR;127;43;60;2;21;0;0;1;0;127;0;SEPTEMBER
285;SULAWESI BARAT;POLEWALI MANDAR;BULO;LENGGO;54;17;31;1;4;1;0;0;0;54;0;SEPTEMBER
286;SULAWESI BARAT;POLEWALI MANDAR;BULO;SABURA;67;30;28;0;8;0;0;1;0;67;0;SEPTEMBER
287;SULAWESI BARAT;POLEWALI MANDAR;BULO;SEPPORRAKI;98;29;24;0;43;0;0;2;0;98;0;SEPTEMBER
288;SULAWESI BARAT;POLEWALI MANDAR;BULO;IHING;116;26;27;2;56;1;0;1;0;113;3;SEPTEMBER
289;SULAWESI BARAT;POLEWALI MANDAR;CAMPALAGIAN;PAPPANG;151;85;13;11;9;6;0;13;1;138;13;SEPTEMBER
290;SULAWESI BARAT;POLEWALI MANDAR;CAMPALAGIAN;LALIKO;180;109;42;4;6;3;0;16;0;180;0;SEPTEMBER
291;SULAWESI BARAT;POLEWALI MANDAR;CAMPALAGIAN;BONDE;164;91;33;4;13;10;0;13;0;164;0;SEPTEMBER
292;SULAWESI BARAT;POLEWALI MANDAR;CAMPALAGIAN;KATUMBANGAN LEMO;169;85;42;19;15;5;0;3;0;169;0;SEPTEMBER
293;SULAWESI BARAT;POLEWALI MANDAR;CAMPALAGIAN;PANYAMPA;221;136;51;6;11;3;0;13;0;220;1;SEPTEMBER
294;SULAWESI BARAT;POLEWALI MANDAR;CAMPALAGIAN;SURUANG;150;78;40;9;9;1;0;8;0;145;5;SEPTEMBER
295;SULAWESI BARAT;POLEWALI MANDAR;CAMPALAGIAN;LAMPOKO;223;146;51;9;9;2;0;6;0;223;0;SEPTEMBER
296;SULAWESI BARAT;POLEWALI MANDAR;CAMPALAGIAN;KATUMBANGAN;298;130;45;10;59;38;0;12;0;294;4;SEPTEMBER
297;SULAWESI BARAT;POLEWALI MANDAR;CAMPALAGIAN;LAPEO;130;71;26;7;12;2;0;11;0;129;1;SEPTEMBER
298;SULAWESI BARAT;POLEWALI MANDAR;CAMPALAGIAN;PARAPPE;297;186;61;6;36;3;0;3;0;295;2;SEPTEMBER
299;SULAWESI BARAT;POLEWALI MANDAR;CAMPALAGIAN;ONGKO;93;23;14;12;34;7;0;3;0;93;0;SEPTEMBER
300;SULAWESI BARAT;POLEWALI MANDAR;CAMPALAGIAN;KENJE;149;102;11;8;19;3;0;6;0;149;0;SEPTEMBER
301;SULAWESI BARAT;POLEWALI MANDAR;CAMPALAGIAN;SUMARRANG;449;245;132;4;62;6;0;0;0;449;0;SEPTEMBER
302;SULAWESI BARAT;POLEWALI MANDAR;CAMPALAGIAN;BOTTO;250;122;59;0;57;3;0;7;0;248;2;SEPTEMBER
303;SULAWESI BARAT;POLEWALI MANDAR;CAMPALAGIAN;GATTUNGAN;170;54;28;17;47;15;0;8;0;169;1;SEPTEMBER
304;SULAWESI BARAT;POLEWALI MANDAR;CAMPALAGIAN;PADANG TIMUR;131;60;25;3;37;2;0;4;0;131;0;SEPTEMBER
305;SULAWESI BARAT;POLEWALI MANDAR;CAMPALAGIAN;PADANG;75;46;9;4;12;0;0;1;0;72;3;SEPTEMBER
306;SULAWESI BARAT;POLEWALI MANDAR;CAMPALAGIAN;LAGI-AGI;219;155;33;3;17;2;0;9;0;219;0;SEPTEMBER
307;SULAWESI BARAT;POLEWALI MANDAR;LIMBORO;LIMBORO;105;32;19;14;18;2;0;7;0;92;13;SEPTEMBER
308;SULAWESI BARAT;POLEWALI MANDAR;LIMBORO;LEMBANG LEMBANG;214;92;37;27;39;6;0;13;0;214;0;SEPTEMBER
309;SULAWESI BARAT;POLEWALI MANDAR;LIMBORO;TANDASURA;132;71;13;9;26;3;0;9;0;131;1;SEPTEMBER
310;SULAWESI BARAT;POLEWALI MANDAR;LIMBORO;SAMASUNDU;141;47;45;7;27;8;0;7;0;141;0;SEPTEMBER
311;SULAWESI BARAT;POLEWALI MANDAR;LIMBORO;NAPO;161;85;20;4;42;0;0;10;0;161;0;SEPTEMBER
312;SULAWESI BARAT;POLEWALI MANDAR;LIMBORO;TODANG TODANG;35;16;12;4;2;0;0;1;0;35;0;SEPTEMBER
313;SULAWESI BARAT;POLEWALI MANDAR;LIMBORO;PENDULANGAN;58;35;19;0;2;0;0;2;0;58;0;SEPTEMBER
314;SULAWESI BARAT;POLEWALI MANDAR;LIMBORO;RENGGEANG;100;37;21;5;32;0;0;5;0;100;0;SEPTEMBER
315;SULAWESI BARAT;POLEWALI MANDAR;LIMBORO;SALARRI;56;24;14;6;11;0;0;1;0;56;0;SEPTEMBER
316;SULAWESI BARAT;POLEWALI MANDAR;LIMBORO;TANGAN BARU;81;30;9;2;35;0;0;5;0;81;0;SEPTEMBER
317;SULAWESI BARAT;POLEWALI MANDAR;LIMBORO;PALECE;113;25;35;31;15;4;0;3;0;113;0;SEPTEMBER
318;SULAWESI BARAT;POLEWALI MANDAR;LUYO;BATUPANGA;233;116;39;4;60;2;1;7;0;229;4;SEPTEMBER
319;SULAWESI BARAT;POLEWALI MANDAR;LUYO;MAMBU;206;111;27;2;40;1;1;12;3;197;9;SEPTEMBER
320;SULAWESI BARAT;POLEWALI MANDAR;LUYO;TENGGELANG;267;145;47;11;47;0;1;7;0;258;9;SEPTEMBER
321;SULAWESI BARAT;POLEWALI MANDAR;LUYO;BARU;284;95;77;27;43;8;0;22;0;272;12;SEPTEMBER
322;SULAWESI BARAT;POLEWALI MANDAR;LUYO;PUSSUI;187;103;31;2;43;0;1;5;1;186;1;SEPTEMBER
323;SULAWESI BARAT;POLEWALI MANDAR;LUYO;MAPILI BARAT;190;110;40;12;18;0;0;10;0;190;0;SEPTEMBER
324;SULAWESI BARAT;POLEWALI MANDAR;LUYO;SAMBALI WALI;275;161;46;14;39;3;0;3;0;266;9;SEPTEMBER
325;SULAWESI BARAT;POLEWALI MANDAR;LUYO;BATUPANGA DAALA;321;153;49;3;109;0;1;6;0;321;0;SEPTEMBER
326;SULAWESI BARAT;POLEWALI MANDAR;LUYO;LUYO;200;100;26;5;50;2;2;14;0;199;1;SEPTEMBER
327;SULAWESI BARAT;POLEWALI MANDAR;LUYO;PUSSUI BARAT;115;55;17;3;23;13;1;2;0;114;1;SEPTEMBER
328;SULAWESI BARAT;POLEWALI MANDAR;LUYO;PUCCADI;203;145;23;0;25;3;0;7;0;203;0;SEPTEMBER
329;SULAWESI BARAT;POLEWALI MANDAR;MAPILLI;MAPILI;112;39;9;6;39;4;0;15;0;112;0;SEPTEMBER
330;SULAWESI BARAT;POLEWALI MANDAR;MAPILLI;UGIBARU;235;56;57;36;36;8;0;26;0;219;16;SEPTEMBER
331;SULAWESI BARAT;POLEWALI MANDAR;MAPILLI;RUMPA;178;97;22;4;48;4;0;3;0;178;0;SEPTEMBER
332;SULAWESI BARAT;POLEWALI MANDAR;MAPILLI;KURMA;289;155;48;0;71;2;0;13;0;289;0;SEPTEMBER
333;SULAWESI BARAT;POLEWALI MANDAR;MAPILLI;BUKU;223;149;34;3;29;2;0;2;0;219;4;SEPTEMBER
334;SULAWESI BARAT;POLEWALI MANDAR;MAPILLI;BONNE BONNE;133;45;17;9;45;9;0;7;0;132;1;SEPTEMBER
335;SULAWESI BARAT;POLEWALI MANDAR;MAPILLI;BEROANGIN;222;71;28;1;98;4;0;15;1;218;4;SEPTEMBER
336;SULAWESI BARAT;POLEWALI MANDAR;MAPILLI;SEGERANG;160;93;34;4;21;1;0;7;0;160;0;SEPTEMBER
337;SULAWESI BARAT;POLEWALI MANDAR;MAPILLI;BONRA;162;75;47;0;32;1;0;7;0;162;0;SEPTEMBER
338;SULAWESI BARAT;POLEWALI MANDAR;MAPILLI;SATTOKO;86;20;9;0;51;1;0;5;0;86;0;SEPTEMBER
339;SULAWESI BARAT;POLEWALI MANDAR;MAPILLI;RAPPANG BARAT;301;94;105;2;69;5;0;25;0;300;1;SEPTEMBER
340;SULAWESI BARAT;POLEWALI MANDAR;MAPILLI;LANDI KANUSUANG;323;120;40;1;146;0;0;16;0;323;0;SEPTEMBER
341;SULAWESI BARAT;POLEWALI MANDAR;MATAKALI;MATAKALI;244;111;47;8;54;10;0;14;0;244;0;SEPTEMBER
342;SULAWESI BARAT;POLEWALI MANDAR;MATAKALI;PETAMPANUA;283;133;87;3;37;16;2;5;0;283;0;SEPTEMBER
343;SULAWESI BARAT;POLEWALI MANDAR;MATAKALI;BARUMBUNG;165;73;44;3;37;7;0;1;0;165;0;SEPTEMBER
344;SULAWESI BARAT;POLEWALI MANDAR;MATAKALI;PASIANG;326;100;48;8;130;9;0;22;0;317;9;SEPTEMBER
345;SULAWESI BARAT;POLEWALI MANDAR;MATAKALI;TONROLIMA;231;116;55;2;33;4;0;12;2;224;7;SEPTEMBER
346;SULAWESI BARAT;POLEWALI MANDAR;MATAKALI;INDOMAKKOMBONG;382;180;99;4;75;5;0;11;2;376;6;SEPTEMBER
347;SULAWESI BARAT;POLEWALI MANDAR;MATAKALI;BUNGA-BUNGA;146;64;49;7;21;1;0;4;0;146;0;SEPTEMBER
348;SULAWESI BARAT;POLEWALI MANDAR;MATANGNGA;MATANGNGA;71;35;5;4;22;2;0;3;0;71;0;SEPTEMBER
349;SULAWESI BARAT;POLEWALI MANDAR;MATANGNGA;LILLI;108;39;16;1;50;0;0;1;0;107;1;SEPTEMBER
350;SULAWESI BARAT;POLEWALI MANDAR;MATANGNGA;RANGOAN;71;24;30;0;15;0;0;0;0;69;2;SEPTEMBER
351;SULAWESI BARAT;POLEWALI MANDAR;MATANGNGA;TAPUA;167;71;30;7;58;0;0;1;0;167;0;SEPTEMBER
352;SULAWESI BARAT;POLEWALI MANDAR;MATANGNGA;MAMBU TAPUA;95;31;15;0;46;0;0;3;0;95;0;SEPTEMBER
353;SULAWESI BARAT;POLEWALI MANDAR;MATANGNGA;BA'BA TAPUA;67;26;10;0;31;0;0;0;0;67;0;SEPTEMBER
354;SULAWESI BARAT;POLEWALI MANDAR;MATANGNGA;KATIMBANG;85;36;21;1;25;1;0;0;0;84;1;SEPTEMBER
355;SULAWESI BARAT;POLEWALI MANDAR;POLEWALI;POLEWALI;508;157;149;40;75;32;0;47;0;500;8;SEPTEMBER
356;SULAWESI BARAT;POLEWALI MANDAR;POLEWALI;WATTANG;187;59;57;12;24;17;0;18;0;187;0;SEPTEMBER
357;SULAWESI BARAT;POLEWALI MANDAR;POLEWALI;SULEWATANG;342;72;172;5;72;6;0;15;0;342;0;SEPTEMBER
358;SULAWESI BARAT;POLEWALI MANDAR;POLEWALI;LANTORA;403;107;156;23;51;34;0;32;0;403;0;SEPTEMBER
359;SULAWESI BARAT;POLEWALI MANDAR;POLEWALI;TAKATIDUNG;503;231;107;25;76;22;0;26;0;487;16;SEPTEMBER
360;SULAWESI BARAT;POLEWALI MANDAR;POLEWALI;PEKKABATA;309;136;57;29;42;26;0;18;0;308;1;SEPTEMBER
361;SULAWESI BARAT;POLEWALI MANDAR;POLEWALI;MADATE;566;196;158;73;86;22;0;31;0;566;0;SEPTEMBER
362;SULAWESI BARAT;POLEWALI MANDAR;POLEWALI;MANDING;398;125;106;17;91;21;0;37;0;397;1;SEPTEMBER
363;SULAWESI BARAT;POLEWALI MANDAR;POLEWALI;DARMA;552;199;164;30;113;15;0;31;0;552;0;SEPTEMBER
364;SULAWESI BARAT;POLEWALI MANDAR;TAPANGO;PELITAKAN;151;86;25;1;13;1;0;10;0;136;15;SEPTEMBER
365;SULAWESI BARAT;POLEWALI MANDAR;TAPANGO;TAPANGO;194;110;33;3;37;5;0;6;0;194;0;SEPTEMBER
366;SULAWESI BARAT;POLEWALI MANDAR;TAPANGO;RAPPANG;226;124;51;2;37;3;0;8;0;225;1;SEPTEMBER
367;SULAWESI BARAT;POLEWALI MANDAR;TAPANGO;DAKKA;152;68;36;3;37;2;0;4;0;150;2;SEPTEMBER
368;SULAWESI BARAT;POLEWALI MANDAR;TAPANGO;BATU;139;75;31;2;22;1;0;6;0;137;2;SEPTEMBER
369;SULAWESI BARAT;POLEWALI MANDAR;TAPANGO;RISO;181;114;2;0;54;4;0;5;0;179;2;SEPTEMBER
370;SULAWESI BARAT;POLEWALI MANDAR;TAPANGO;PALATTA;179;76;52;0;40;0;0;1;0;169;10;SEPTEMBER
371;SULAWESI BARAT;POLEWALI MANDAR;TAPANGO;TAPANGO BARAT;153;82;33;3;24;3;0;8;0;153;0;SEPTEMBER
372;SULAWESI BARAT;POLEWALI MANDAR;TAPANGO;KURRAK;63;38;15;0;9;1;0;0;0;63;0;SEPTEMBER
373;SULAWESI BARAT;POLEWALI MANDAR;TAPANGO;BUSSU;133;75;32;2;20;1;0;3;0;133;0;SEPTEMBER
374;SULAWESI BARAT;POLEWALI MANDAR;TAPANGO;TUTTULA;109;69;19;1;15;1;0;0;0;105;4;SEPTEMBER
375;SULAWESI BARAT;POLEWALI MANDAR;TAPANGO;JAMBU MALEA;193;72;75;3;30;0;0;13;0;193;0;SEPTEMBER
376;SULAWESI BARAT;POLEWALI MANDAR;TAPANGO;KALIMBUA;182;113;39;1;24;0;0;5;0;182;0;SEPTEMBER
377;SULAWESI BARAT;POLEWALI MANDAR;TAPANGO;BANATO REJO;288;176;68;0;33;4;0;3;0;284;4;SEPTEMBER
378;SULAWESI BARAT;POLEWALI MANDAR;TINAMBUNG;TINAMBUNG;119;34;29;2;24;4;0;26;0;119;0;SEPTEMBER
379;SULAWESI BARAT;POLEWALI MANDAR;TINAMBUNG;KARAMA;465;337;42;19;46;2;0;17;0;463;2;SEPTEMBER
380;SULAWESI BARAT;POLEWALI MANDAR;TINAMBUNG;TANGNGA TANGNGA;180;127;29;2;13;1;0;8;0;180;0;SEPTEMBER
381;SULAWESI BARAT;POLEWALI MANDAR;TINAMBUNG;LEKOPADIS;46;13;9;2;17;0;0;5;0;46;0;SEPTEMBER
382;SULAWESI BARAT;POLEWALI MANDAR;TINAMBUNG;GALUNG LOMBOK;81;27;11;4;26;1;0;12;0;81;0;SEPTEMBER
383;SULAWESI BARAT;POLEWALI MANDAR;TINAMBUNG;TANDUNG;104;46;20;6;15;4;0;11;0;102;2;SEPTEMBER
384;SULAWESI BARAT;POLEWALI MANDAR;TINAMBUNG;BATULAYA;96;39;22;11;11;4;1;8;0;96;0;SEPTEMBER
385;SULAWESI BARAT;POLEWALI MANDAR;TINAMBUNG;SEPABATU;90;29;19;10;18;2;0;12;0;90;0;SEPTEMBER
386;SULAWESI BARAT;POLEWALI MANDAR;TUTAR;TARAMANU;200;92;33;6;46;1;12;10;0;200;0;SEPTEMBER
387;SULAWESI BARAT;POLEWALI MANDAR;TUTAR;AMBOPADANG;277;96;53;0;123;2;0;3;0;277;0;SEPTEMBER
388;SULAWESI BARAT;POLEWALI MANDAR;TUTAR;TUBBI;136;43;71;4;7;3;0;8;0;136;0;SEPTEMBER
389;SULAWESI BARAT;POLEWALI MANDAR;TUTAR;RATTE;184;82;60;2;37;1;1;0;1;184;0;SEPTEMBER
390;SULAWESI BARAT;POLEWALI MANDAR;TUTAR;BESOANGIN;122;68;8;2;44;0;0;0;0;122;0;SEPTEMBER
391;SULAWESI BARAT;POLEWALI MANDAR;TUTAR;PIRIANG TAPIKO;116;36;58;0;20;0;0;2;0;116;0;SEPTEMBER
392;SULAWESI BARAT;POLEWALI MANDAR;TUTAR;PEBURRU;187;107;43;2;28;2;0;5;0;187;0;SEPTEMBER
393;SULAWESI BARAT;POLEWALI MANDAR;TUTAR;TALOBA;98;38;38;0;18;0;0;3;0;97;1;SEPTEMBER
394;SULAWESI BARAT;POLEWALI MANDAR;TUTAR;POLLEWANI;262;136;88;2;33;0;0;3;0;262;0;SEPTEMBER
395;SULAWESI BARAT;POLEWALI MANDAR;TUTAR;ARABUA;157;92;37;0;11;0;14;3;0;157;0;SEPTEMBER
396;SULAWESI BARAT;POLEWALI MANDAR;TUTAR;BESOANGIN UTARA;109;53;22;1;32;0;0;1;0;109;0;SEPTEMBER
397;SULAWESI BARAT;POLEWALI MANDAR;TUTAR;PODA;122;47;54;4;13;0;1;3;0;122;0;SEPTEMBER
398;SULAWESI BARAT;POLEWALI MANDAR;TUTAR;TARAMANU TUA;171;30;53;2;77;3;0;3;0;168;3;SEPTEMBER
399;SULAWESI BARAT;POLEWALI MANDAR;WONOMULYO;SIDODADI;392;201;86;3;56;29;0;14;1;390;2;SEPTEMBER
400;SULAWESI BARAT;POLEWALI MANDAR;WONOMULYO;SIDOREJO;292;156;65;13;27;12;0;17;0;290;2;SEPTEMBER
401;SULAWESI BARAT;POLEWALI MANDAR;WONOMULYO;SUMBEREJO;471;219;86;26;93;36;0;5;1;466;5;SEPTEMBER
402;SULAWESI BARAT;POLEWALI MANDAR;WONOMULYO;BUMIAYU;392;142;83;24;50;59;0;16;1;375;17;SEPTEMBER
403;SULAWESI BARAT;POLEWALI MANDAR;WONOMULYO;KEBUNSARI;264;99;44;8;40;40;1;11;0;243;21;SEPTEMBER
404;SULAWESI BARAT;POLEWALI MANDAR;WONOMULYO;BANUA BARU;179;87;29;7;19;16;0;9;0;167;12;SEPTEMBER
405;SULAWESI BARAT;POLEWALI MANDAR;WONOMULYO;NEPO;225;131;43;1;33;8;1;6;0;223;2;SEPTEMBER
406;SULAWESI BARAT;POLEWALI MANDAR;WONOMULYO;SUGIHWARAS;505;235;125;15;78;28;0;12;0;493;12;SEPTEMBER
407;SULAWESI BARAT;POLEWALI MANDAR;WONOMULYO;CAMPURJO;233;112;40;7;38;16;0;19;0;232;1;SEPTEMBER
408;SULAWESI BARAT;POLEWALI MANDAR;WONOMULYO;BUMIMULYO;174;89;41;0;31;10;0;1;0;172;2;SEPTEMBER
409;SULAWESI BARAT;POLEWALI MANDAR;WONOMULYO;TUMPILING;238;123;52;3;34;5;0;9;0;226;12;SEPTEMBER
410;SULAWESI BARAT;POLEWALI MANDAR;WONOMULYO;BAKKA-BAKKA;185;101;35;3;29;7;0;6;0;181;4;SEPTEMBER
411;SULAWESI BARAT;POLEWALI MANDAR;WONOMULYO;ARJO SARI;257;127;78;3;13;19;0;8;0;248;9;SEPTEMBER
412;SULAWESI BARAT;POLEWALI MANDAR;WONOMULYO;GALESON;248;169;32;3;26;5;0;8;0;243;5;SEPTEMBER
413;SULAWESI BARAT;MAMASA;MAMASA;MAMASA;372;60;49;3;180;60;0;20;0;372;0;SEPTEMBER
414;SULAWESI BARAT;MAMASA;MAMASA;RAMBUSARATU;249;84;79;17;51;12;0;6;0;249;0;SEPTEMBER
415;SULAWESI BARAT;MAMASA;MAMASA;OSANGO;458;88;70;9;185;88;0;13;1;454;4;SEPTEMBER
416;SULAWESI BARAT;MAMASA;MAMASA;LAMBANAN;221;67;47;7;89;6;0;5;0;221;0;SEPTEMBER
417;SULAWESI BARAT;MAMASA;MAMASA;LEMBANA SALULO;75;13;15;1;34;5;0;6;0;74;1;SEPTEMBER
418;SULAWESI BARAT;MAMASA;MAMASA;TAUPE;230;45;33;7;141;1;1;2;0;230;0;SEPTEMBER
419;SULAWESI BARAT;MAMASA;MAMASA;BUNTU BUDA;293;77;31;11;104;25;0;6;0;254;39;SEPTEMBER
420;SULAWESI BARAT;MAMASA;MAMASA;TONDOK BAKARU;244;74;78;14;60;10;0;7;0;243;1;SEPTEMBER
421;SULAWESI BARAT;MAMASA;MAMASA;PEBASSIAN;93;25;22;2;41;1;0;2;0;93;0;SEPTEMBER
422;SULAWESI BARAT;MAMASA;MAMASA;MAMBULILING;111;51;19;0;36;2;0;1;0;109;2;SEPTEMBER
423;SULAWESI BARAT;MAMASA;MAMASA;BOMBONG LAMBE;151;49;16;3;68;14;0;1;0;151;0;SEPTEMBER
424;SULAWESI BARAT;MAMASA;MAMASA;BUBUN BATU;122;19;11;2;78;3;0;2;0;115;7;SEPTEMBER
425;SULAWESI BARAT;MAMASA;ARALLE;ARALLE;110;40;57;1;8;1;0;3;0;110;0;SEPTEMBER
426;SULAWESI BARAT;MAMASA;ARALLE;RALLE ANAK;20;3;12;0;4;0;0;1;0;20;0;SEPTEMBER
427;SULAWESI BARAT;MAMASA;ARALLE;PANETEAN;70;51;16;1;2;0;0;0;0;70;0;SEPTEMBER
428;SULAWESI BARAT;MAMASA;ARALLE;UHAILANU;69;24;26;0;10;3;0;5;0;68;1;SEPTEMBER
429;SULAWESI BARAT;MAMASA;ARALLE;ARALLE UTARA;59;32;26;0;1;0;0;0;0;59;0;SEPTEMBER
430;SULAWESI BARAT;MAMASA;ARALLE;UHAIDAHO;48;9;34;0;4;1;0;0;0;48;0;SEPTEMBER
431;SULAWESI BARAT;MAMASA;ARALLE;BARURU;92;65;25;0;1;0;0;0;1;92;0;SEPTEMBER
432;SULAWESI BARAT;MAMASA;ARALLE;RALLEANAK UTARA;36;16;18;0;1;0;0;1;0;36;0;SEPTEMBER
433;SULAWESI BARAT;MAMASA;ARALLE;PAMOSEANG PANGGA;39;19;17;2;1;0;0;0;0;39;0;SEPTEMBER
434;SULAWESI BARAT;MAMASA;ARALLE;KALABE;61;29;29;0;3;0;0;0;0;61;0;SEPTEMBER
435;SULAWESI BARAT;MAMASA;ARALLE;ARALLE SELATAN;31;10;18;0;2;0;0;1;0;31;0;SEPTEMBER
436;SULAWESI BARAT;MAMASA;ARALLE;HAHANGAN;33;13;14;0;6;0;0;0;0;33;0;SEPTEMBER
437;SULAWESI BARAT;MAMASA;BALLA;BALLA;151;25;26;1;77;10;0;11;0;150;1;SEPTEMBER
438;SULAWESI BARAT;MAMASA;BALLA;BALLA BARAT;89;39;15;0;35;0;0;0;0;89;0;SEPTEMBER
439;SULAWESI BARAT;MAMASA;BALLA;BALLA SATANETEAN;152;56;14;2;66;10;0;3;0;151;1;SEPTEMBER
440;SULAWESI BARAT;MAMASA;BALLA;BALLA TUMUKA;96;25;30;0;39;1;0;1;0;96;0;SEPTEMBER
441;SULAWESI BARAT;MAMASA;BALLA;SEPAKUAN;151;50;14;2;81;2;0;2;0;151;0;SEPTEMBER
442;SULAWESI BARAT;MAMASA;BALLA;PIDARA;60;26;6;0;26;1;0;1;0;60;0;SEPTEMBER
443;SULAWESI BARAT;MAMASA;BALLA;BAMBAPUANG;63;30;16;1;16;0;0;0;0;63;0;SEPTEMBER
444;SULAWESI BARAT;MAMASA;BALLA;BALLA TIMUR;34;7;1;0;23;1;0;2;0;34;0;SEPTEMBER
445;SULAWESI BARAT;MAMASA;BAMBANG;MOKALLANG;41;16;21;0;3;0;0;1;0;41;0;SEPTEMBER
446;SULAWESI BARAT;MAMASA;BAMBANG;MASOSO;45;22;11;0;12;0;0;0;0;45;0;SEPTEMBER
447;SULAWESI BARAT;MAMASA;BAMBANG;SALUASSING;125;91;22;4;7;0;0;1;0;125;0;SEPTEMBER
448;SULAWESI BARAT;MAMASA;BAMBANG;SALUBULO;57;18;18;0;9;0;0;0;0;45;12;SEPTEMBER
449;SULAWESI BARAT;MAMASA;BAMBANG;SALUKADI;57;21;29;0;7;0;0;0;0;57;0;SEPTEMBER
450;SULAWESI BARAT;MAMASA;BAMBANG;SALUKEPOPOK;65;29;17;2;16;1;0;0;0;65;0;SEPTEMBER
451;SULAWESI BARAT;MAMASA;BAMBANG;ULUMAMBI BARAT;54;24;30;0;0;0;0;0;0;54;0;SEPTEMBER
452;SULAWESI BARAT;MAMASA;BAMBANG;LIMBADEBATA;98;28;13;0;52;1;0;4;0;98;0;SEPTEMBER
453;SULAWESI BARAT;MAMASA;BAMBANG;TANETE TOMBA;38;23;14;0;1;0;0;0;0;38;0;SEPTEMBER
454;SULAWESI BARAT;MAMASA;BAMBANG;BAMBANG;126;75;18;0;26;3;0;3;0;125;1;SEPTEMBER
455;SULAWESI BARAT;MAMASA;BAMBANG;RANTELEMO;48;10;23;0;13;2;0;0;0;48;0;SEPTEMBER
456;SULAWESI BARAT;MAMASA;BAMBANG;SALUDENGEN;33;8;22;0;2;1;0;0;0;33;0;SEPTEMBER
457;SULAWESI BARAT;MAMASA;BAMBANG;ULUMAMBI;65;10;48;1;0;0;0;0;0;59;6;SEPTEMBER
458;SULAWESI BARAT;MAMASA;BAMBANG;BAMBANG TIMUR;72;46;22;0;2;1;0;1;0;72;0;SEPTEMBER
459;SULAWESI BARAT;MAMASA;BAMBANG;MINANGA;125;41;42;0;37;1;0;4;0;125;0;SEPTEMBER
460;SULAWESI BARAT;MAMASA;BAMBANG;SIKAMASE;55;20;34;0;1;0;0;0;0;55;0;SEPTEMBER
461;SULAWESI BARAT;MAMASA;BAMBANG;RANTETARIMA;28;4;24;0;0;0;0;0;0;28;0;SEPTEMBER
462;SULAWESI BARAT;MAMASA;BAMBANG;SALURURU;28;2;1;3;21;0;0;1;0;28;0;SEPTEMBER
463;SULAWESI BARAT;MAMASA;BAMBANG;SALUTABANG;32;17;8;1;2;2;0;1;1;32;0;SEPTEMBER
464;SULAWESI BARAT;MAMASA;BAMBANG;BALATANA;40;32;7;0;1;0;0;0;0;40;0;SEPTEMBER
465;SULAWESI BARAT;MAMASA;BUNTUMALANGKA;BUNTUMALANGKA;131;28;65;2;26;4;0;5;0;130;1;SEPTEMBER
466;SULAWESI BARAT;MAMASA;BUNTUMALANGKA;RANTEBERAN;111;66;38;0;6;0;0;1;0;111;0;SEPTEMBER
467;SULAWESI BARAT;MAMASA;BUNTUMALANGKA;KEBANGA;43;10;17;0;15;0;0;0;1;43;0;SEPTEMBER
468;SULAWESI BARAT;MAMASA;BUNTUMALANGKA;SALURINDU;53;27;16;1;7;0;0;2;0;53;0;SEPTEMBER
469;SULAWESI BARAT;MAMASA;BUNTUMALANGKA;TAORA;44;14;24;2;2;0;0;2;0;44;0;SEPTEMBER
470;SULAWESI BARAT;MAMASA;BUNTUMALANGKA;KABAE;71;11;55;0;4;0;0;1;0;71;0;SEPTEMBER
471;SULAWESI BARAT;MAMASA;BUNTUMALANGKA;SALUTAMBUN BARAT;51;20;28;0;1;0;0;1;1;51;0;SEPTEMBER
472;SULAWESI BARAT;MAMASA;BUNTUMALANGKA;PENATANGAN;108;49;29;0;20;3;0;1;0;102;6;SEPTEMBER
473;SULAWESI BARAT;MAMASA;BUNTUMALANGKA;SALUTAMBUN TIMUR;39;17;19;0;1;0;0;2;0;39;0;SEPTEMBER
474;SULAWESI BARAT;MAMASA;BUNTUMALANGKA;SALUTAMBUN;28;9;14;0;2;1;0;2;0;28;0;SEPTEMBER
475;SULAWESI BARAT;MAMASA;BUNTUMALANGKA;ARALLE TIMUR;97;36;52;0;3;0;0;1;0;92;5;SEPTEMBER
476;SULAWESI BARAT;MAMASA;MAMBI;MAMBI;80;48;19;2;10;1;0;0;0;80;0;SEPTEMBER
477;SULAWESI BARAT;MAMASA;MAMBI;TALIPUKKI;124;92;11;4;10;2;0;4;0;123;1;SEPTEMBER
478;SULAWESI BARAT;MAMASA;MAMBI;RANTEBULAHAN;49;13;28;0;6;1;0;0;0;48;1;SEPTEMBER
479;SULAWESI BARAT;MAMASA;MAMBI;SONDONGLAYU;35;12;4;5;8;0;0;5;0;34;1;SEPTEMBER
480;SULAWESI BARAT;MAMASA;MAMBI;SALUBANUA;31;13;16;0;1;0;0;0;0;30;1;SEPTEMBER
481;SULAWESI BARAT;MAMASA;MAMBI;TAPALINA;84;48;28;2;0;0;0;1;0;79;5;SEPTEMBER
482;SULAWESI BARAT;MAMASA;MAMBI;SENDANA;149;61;68;3;16;0;0;1;0;149;0;SEPTEMBER
483;SULAWESI BARAT;MAMASA;MAMBI;PAMOSEAN;47;39;7;1;0;0;0;0;0;47;0;SEPTEMBER
484;SULAWESI BARAT;MAMASA;MAMBI;SELUMAKA;111;27;84;0;0;0;0;0;0;111;0;SEPTEMBER
485;SULAWESI BARAT;MAMASA;MAMBI;BUJUNG MANURUNG;42;21;17;1;2;1;0;0;0;42;0;SEPTEMBER
486;SULAWESI BARAT;MAMASA;MAMBI;SALU ALO;65;20;40;0;5;0;0;0;0;65;0;SEPTEMBER
487;SULAWESI BARAT;MAMASA;MAMBI;INDOBANUA;14;5;3;0;2;4;0;0;0;14;0;SEPTEMBER
488;SULAWESI BARAT;MAMASA;MAMBI;SALUDURIAN;91;27;52;0;9;2;0;1;0;91;0;SEPTEMBER
489;SULAWESI BARAT;MAMASA;MEHALAAN;MEHALAAN;49;19;16;1;11;0;0;2;0;49;0;SEPTEMBER
490;SULAWESI BARAT;MAMASA;MEHALAAN;BOTTENG;76;29;15;0;30;0;1;1;0;76;0;SEPTEMBER
491;SULAWESI BARAT;MAMASA;MEHALAAN;SALUKONTA;56;26;10;1;18;0;0;1;0;56;0;SEPTEMBER
492;SULAWESI BARAT;MAMASA;MEHALAAN;MESAKADA;54;20;16;1;16;0;0;1;0;54;0;SEPTEMBER
493;SULAWESI BARAT;MAMASA;MEHALAAN;MEHALAAN BARAT;91;33;25;0;30;0;0;3;0;91;0;SEPTEMBER
494;SULAWESI BARAT;MAMASA;MEHALAAN;SALUAHOK;69;18;23;1;25;0;0;2;0;69;0;SEPTEMBER
495;SULAWESI BARAT;MAMASA;MEHALAAN;SALUBALO;41;22;12;0;7;0;0;0;0;41;0;SEPTEMBER
496;SULAWESI BARAT;MAMASA;MEHALAAN;PASSEMBUK;43;20;11;0;12;0;0;0;0;43;0;SEPTEMBER
497;SULAWESI BARAT;MAMASA;MEHALAAN;KONDO;34;17;9;0;7;0;0;1;0;34;0;SEPTEMBER
498;SULAWESI BARAT;MAMASA;MEHALAAN;LEKO SUKAMAJU;32;12;10;0;9;0;0;1;0;32;0;SEPTEMBER
499;SULAWESI BARAT;MAMASA;MEHALAAN;ULUMEA;26;15;3;0;8;0;0;0;0;26;0;SEPTEMBER
500;SULAWESI BARAT;MAMASA;MESSAWA;MESSAWA;35;10;15;0;5;0;0;5;0;35;0;SEPTEMBER
501;SULAWESI BARAT;MAMASA;MESSAWA;RIPPUNG;121;57;47;0;15;1;0;0;0;120;1;SEPTEMBER
502;SULAWESI BARAT;MAMASA;MESSAWA;MAKUANG;105;57;32;1;15;0;0;0;0;105;0;SEPTEMBER
503;SULAWESI BARAT;MAMASA;MESSAWA;SEPANG;73;31;33;0;8;0;0;1;0;73;0;SEPTEMBER
504;SULAWESI BARAT;MAMASA;MESSAWA;MALIMBONG;53;16;31;0;5;0;0;1;0;53;0;SEPTEMBER
505;SULAWESI BARAT;MAMASA;MESSAWA;MATANDE;83;16;49;6;7;3;0;2;0;83;0;SEPTEMBER
506;SULAWESI BARAT;MAMASA;MESSAWA;SIPAI;79;38;32;0;9;0;0;0;0;79;0;SEPTEMBER
507;SULAWESI BARAT;MAMASA;MESSAWA;PASMA MAMBU;49;12;21;0;15;0;0;1;0;49;0;SEPTEMBER
508;SULAWESI BARAT;MAMASA;MESSAWA;TANETE BATU;53;26;22;0;3;0;0;1;0;52;1;SEPTEMBER
509;SULAWESI BARAT;MAMASA;NOSU;NOSU;79;4;39;1;21;7;0;5;0;77;2;SEPTEMBER
510;SULAWESI BARAT;MAMASA;NOSU;MINANGA;23;4;10;1;7;0;0;1;0;23;0;SEPTEMBER
511;SULAWESI BARAT;MAMASA;NOSU;BATUPAPAN;55;18;20;1;15;1;0;0;0;55;0;SEPTEMBER
512;SULAWESI BARAT;MAMASA;NOSU;MASEWWE;35;13;3;0;18;0;0;1;0;35;0;SEPTEMBER
513;SULAWESI BARAT;MAMASA;NOSU;SIWI;16;9;2;0;5;0;0;0;0;16;0;SEPTEMBER
514;SULAWESI BARAT;MAMASA;NOSU;MINANGA TIMUR;11;3;2;0;6;0;0;0;0;11;0;SEPTEMBER
515;SULAWESI BARAT;MAMASA;NOSU;PARINDING;23;3;15;0;5;0;0;0;0;23;0;SEPTEMBER
516;SULAWESI BARAT;MAMASA;PANA;PANA;61;16;37;1;6;1;0;0;0;61;0;SEPTEMBER
517;SULAWESI BARAT;MAMASA;PANA;MANIPI;122;60;43;3;13;1;0;1;0;121;1;SEPTEMBER
518;SULAWESI BARAT;MAMASA;PANA;MAMULLU;62;11;38;0;11;1;0;1;0;62;0;SEPTEMBER
519;SULAWESI BARAT;MAMASA;PANA;SAPAN;59;14;24;0;21;0;0;0;0;59;0;SEPTEMBER
520;SULAWESI BARAT;MAMASA;PANA;DATUBARINGAN;81;27;38;1;15;0;0;0;0;81;0;SEPTEMBER
521;SULAWESI BARAT;MAMASA;PANA;PANURA;60;15;39;0;6;0;0;0;0;60;0;SEPTEMBER
522;SULAWESI BARAT;MAMASA;PANA;TALLANG BULAWAN;70;16;39;4;11;0;0;0;0;70;0;SEPTEMBER
523;SULAWESI BARAT;MAMASA;PANA;KARAKA;63;24;32;0;6;0;0;1;0;63;0;SEPTEMBER
524;SULAWESI BARAT;MAMASA;PANA;ULUSALU;62;5;55;0;0;0;0;2;0;62;0;SEPTEMBER
525;SULAWESI BARAT;MAMASA;PANA;WERI;53;8;37;1;5;1;0;1;0;53;0;SEPTEMBER
526;SULAWESI BARAT;MAMASA;PANA;SALUTAMBUN;56;0;56;0;0;0;0;0;0;56;0;SEPTEMBER
527;SULAWESI BARAT;MAMASA;PANA;SALOAN;97;30;57;0;9;0;0;0;0;96;1;SEPTEMBER
528;SULAWESI BARAT;MAMASA;PANA;ULUSALU INDAH;54;16;38;0;0;0;0;0;0;54;0;SEPTEMBER
529;SULAWESI BARAT;MAMASA;RANTEBULAHAN TIMUR;SALUMOKANAN;82;37;11;0;27;6;0;1;0;82;0;SEPTEMBER
530;SULAWESI BARAT;MAMASA;RANTEBULAHAN TIMUR;SALUMOKANAN BARAT;103;45;23;0;32;0;0;0;1;101;2;SEPTEMBER
531;SULAWESI BARAT;MAMASA;RANTEBULAHAN TIMUR;BUANGIN;96;67;19;0;9;0;0;0;0;95;1;SEPTEMBER
532;SULAWESI BARAT;MAMASA;RANTEBULAHAN TIMUR;BAMBANG BUDA;106;30;53;1;20;1;0;1;0;106;0;SEPTEMBER
533;SULAWESI BARAT;MAMASA;RANTEBULAHAN TIMUR;LEKO;21;5;11;0;5;0;0;0;0;21;0;SEPTEMBER
534;SULAWESI BARAT;MAMASA;RANTEBULAHAN TIMUR;KIRAK;61;39;17;0;5;0;0;0;0;61;0;SEPTEMBER
535;SULAWESI BARAT;MAMASA;RANTEBULAHAN TIMUR;SALUMOKANAN UTARA;96;54;3;0;37;1;0;1;0;96;0;SEPTEMBER
536;SULAWESI BARAT;MAMASA;RANTEBULAHAN TIMUR;SAMPALE;41;8;6;0;27;0;0;0;0;41;0;SEPTEMBER
537;SULAWESI BARAT;MAMASA;SESENAPADANG;OROBUA;201;36;16;2;122;15;0;5;3;199;2;SEPTEMBER
538;SULAWESI BARAT;MAMASA;SESENAPADANG;PALADAN;64;8;8;0;44;1;0;0;0;61;3;SEPTEMBER
539;SULAWESI BARAT;MAMASA;SESENAPADANG;OROBUA TIMUR;37;14;7;0;14;1;0;1;0;37;0;SEPTEMBER
540;SULAWESI BARAT;MAMASA;SESENAPADANG;RANTE PUANG;97;25;20;0;46;2;0;2;0;95;2;SEPTEMBER
541;SULAWESI BARAT;MAMASA;SESENAPADANG;SATENETEAN;46;8;20;0;16;1;0;1;0;46;0;SEPTEMBER
542;SULAWESI BARAT;MAMASA;SESENAPADANG;LISUAN ADA;66;32;10;0;24;0;0;0;0;66;0;SEPTEMBER
543;SULAWESI BARAT;MAMASA;SESENAPADANG;OROBUA SELATAN;62;17;9;0;19;17;0;0;0;62;0;SEPTEMBER
544;SULAWESI BARAT;MAMASA;SESENAPADANG;MALANGKENA PADANG;68;10;3;0;54;0;0;0;1;68;0;SEPTEMBER
545;SULAWESI BARAT;MAMASA;SESENAPADANG;MALIMBONG;23;6;1;0;15;0;0;1;0;23;0;SEPTEMBER
546;SULAWESI BARAT;MAMASA;SESENAPADANG;MARAMPAN OROBUA;32;14;0;0;9;8;0;0;0;31;1;SEPTEMBER
547;SULAWESI BARAT;MAMASA;SUMARORONG;SUMARORONG;141;45;37;6;33;7;0;11;0;139;2;SEPTEMBER
548;SULAWESI BARAT;MAMASA;SUMARORONG;TABONE;94;26;37;0;30;0;0;1;0;94;0;SEPTEMBER
549;SULAWESI BARAT;MAMASA;SUMARORONG;BATANG  URU;98;38;45;1;11;2;0;1;0;98;0;SEPTEMBER
550;SULAWESI BARAT;MAMASA;SUMARORONG;SASAKAN;159;50;89;1;11;7;0;0;0;158;1;SEPTEMBER
551;SULAWESI BARAT;MAMASA;SUMARORONG;TADISI;55;13;39;0;3;0;0;0;0;55;0;SEPTEMBER
552;SULAWESI BARAT;MAMASA;SUMARORONG;SIBANAWA;101;27;51;0;22;0;0;1;0;101;0;SEPTEMBER
553;SULAWESI BARAT;MAMASA;SUMARORONG;BATANGNGURU TIMUR;106;34;66;0;6;0;0;0;0;106;0;SEPTEMBER
554;SULAWESI BARAT;MAMASA;SUMARORONG;SALUBALO;119;46;43;0;28;0;0;2;0;119;0;SEPTEMBER
555;SULAWESI BARAT;MAMASA;SUMARORONG;BANEA;66;20;35;0;8;1;0;2;0;66;0;SEPTEMBER
556;SULAWESI BARAT;MAMASA;SUMARORONG;RANTE KAMASE;162;76;29;4;41;5;0;7;0;162;0;SEPTEMBER
557;SULAWESI BARAT;MAMASA;TABANG;TABANG;85;37;21;0;8;18;0;1;0;85;0;SEPTEMBER
558;SULAWESI BARAT;MAMASA;TABANG;TADOKALUA;91;37;25;1;19;1;0;3;0;86;5;SEPTEMBER
559;SULAWESI BARAT;MAMASA;TABANG;TABANG BARAT;154;70;47;1;33;2;0;0;1;154;0;SEPTEMBER
560;SULAWESI BARAT;MAMASA;TABANG;MASUPU;56;6;46;0;4;0;0;0;0;56;0;SEPTEMBER
561;SULAWESI BARAT;MAMASA;TABANG;KALAMA;66;8;21;0;21;3;0;2;0;55;11;SEPTEMBER
562;SULAWESI BARAT;MAMASA;TABANG;BAKADISURA;97;23;54;0;18;1;0;1;0;97;0;SEPTEMBER
563;SULAWESI BARAT;MAMASA;TABANG;SALUKONA;94;44;43;0;7;0;0;0;0;94;0;SEPTEMBER
564;SULAWESI BARAT;MAMASA;TABULAHAN;LAKAHANG;269;90;150;2;15;3;2;7;0;269;0;SEPTEMBER
565;SULAWESI BARAT;MAMASA;TABULAHAN;PERIANGAN;68;17;49;0;2;0;0;0;0;68;0;SEPTEMBER
566;SULAWESI BARAT;MAMASA;TABULAHAN;MALATIRO;142;65;69;0;3;0;0;2;0;139;3;SEPTEMBER
567;SULAWESI BARAT;MAMASA;TABULAHAN;TABULAHAN;57;19;34;0;1;1;0;2;0;57;0;SEPTEMBER
568;SULAWESI BARAT;MAMASA;TABULAHAN;SALULEANG;34;12;21;0;1;0;0;0;0;34;0;SEPTEMBER
569;SULAWESI BARAT;MAMASA;TABULAHAN;TAMPAK KURRA;178;49;122;1;4;0;1;1;0;178;0;SEPTEMBER
570;SULAWESI BARAT;MAMASA;TABULAHAN;GANDANG DEWATA;36;13;19;0;4;0;0;0;0;36;0;SEPTEMBER
571;SULAWESI BARAT;MAMASA;TABULAHAN;BURANA;98;27;65;0;4;0;1;1;0;98;0;SEPTEMBER
572;SULAWESI BARAT;MAMASA;TABULAHAN;SALUBAKKA;95;60;33;0;0;0;0;2;0;95;0;SEPTEMBER
573;SULAWESI BARAT;MAMASA;TABULAHAN;PANGANDARAN;132;49;79;0;4;0;0;0;0;132;0;SEPTEMBER
574;SULAWESI BARAT;MAMASA;TABULAHAN;TALOPAK;55;21;30;0;4;0;0;0;0;55;0;SEPTEMBER
575;SULAWESI BARAT;MAMASA;TABULAHAN;PEU';50;17;33;0;0;0;0;0;0;50;0;SEPTEMBER
576;SULAWESI BARAT;MAMASA;TABULAHAN;TIMORO;44;11;23;0;7;1;0;2;0;44;0;SEPTEMBER
577;SULAWESI BARAT;MAMASA;TABULAHAN;LAKAHANG UTAMA;74;26;42;0;3;0;0;2;0;73;1;SEPTEMBER
578;SULAWESI BARAT;MAMASA;TANDUK KALUA;MINAKE;82;27;6;1;44;2;0;2;0;82;0;SEPTEMBER
579;SULAWESI BARAT;MAMASA;TANDUK KALUA;MALABO;50;21;13;0;6;7;0;3;0;50;0;SEPTEMBER
580;SULAWESI BARAT;MAMASA;TANDUK KALUA;SINDAGAMANIK;134;78;16;0;38;1;0;1;0;134;0;SEPTEMBER
581;SULAWESI BARAT;MAMASA;TANDUK KALUA;PARONDOBULAWAN;106;70;10;1;21;1;0;3;0;106;0;SEPTEMBER
582;SULAWESI BARAT;MAMASA;TANDUK KALUA;TAMALANTIK;159;63;55;0;33;4;0;1;1;157;2;SEPTEMBER
583;SULAWESI BARAT;MAMASA;TANDUK KALUA;MANNABABA;68;28;2;0;38;0;0;0;0;68;0;SEPTEMBER
584;SULAWESI BARAT;MAMASA;TANDUK KALUA;MESAKADA;113;55;23;0;35;0;0;0;0;113;0;SEPTEMBER
585;SULAWESI BARAT;MAMASA;TANDUK KALUA;BALLABATU;144;23;15;0;103;2;0;1;0;144;0;SEPTEMBER
586;SULAWESI BARAT;MAMASA;TANDUK KALUA;PAMBE;77;17;14;1;41;3;1;0;0;77;0;SEPTEMBER
587;SULAWESI BARAT;MAMASA;TANDUK KALUA;SALURANO;71;29;13;0;28;1;0;0;0;71;0;SEPTEMBER
588;SULAWESI BARAT;MAMASA;TANDUK KALUA;TALIMBUNG;87;43;38;0;5;0;0;1;0;87;0;SEPTEMBER
589;SULAWESI BARAT;MAMASA;TANDUK KALUA;KANAN;114;44;26;0;34;7;0;1;0;112;2;SEPTEMBER
590;SULAWESI BARAT;MAMASA;TAWALIAN;TAWALIAN;240;98;44;0;78;9;0;7;3;239;1;SEPTEMBER
591;SULAWESI BARAT;MAMASA;TAWALIAN;TAWALIAN TIMUR;170;66;49;2;50;1;0;1;0;169;1;SEPTEMBER
592;SULAWESI BARAT;MAMASA;TAWALIAN;KARIANGO;203;77;51;0;75;0;0;0;0;203;0;SEPTEMBER
593;SULAWESI BARAT;MAMASA;TAWALIAN;RANTETANGNGA;140;23;40;4;64;4;0;4;0;139;1;SEPTEMBER
594;SULAWESI BARAT;MAMUJU TENGAH;TOBADAK;MAHAHE;327;136;65;11;87;13;0;11;3;326;1;SEPTEMBER
595;SULAWESI BARAT;MAMUJU TENGAH;TOBADAK;SALOBAJA;346;173;47;15;97;5;0;9;0;346;0;SEPTEMBER
596;SULAWESI BARAT;MAMUJU TENGAH;TOBADAK;TOBADAK;1309;554;266;23;327;43;2;33;1;1249;60;SEPTEMBER
597;SULAWESI BARAT;MAMUJU TENGAH;TOBADAK;PALONGAAN;286;97;90;5;73;4;0;16;0;285;1;SEPTEMBER
598;SULAWESI BARAT;MAMUJU TENGAH;TOBADAK;BATU PARIGI;729;164;240;16;251;25;1;23;0;720;9;SEPTEMBER
599;SULAWESI BARAT;MAMUJU TENGAH;TOBADAK;BAMBADARU;184;60;50;8;57;2;1;6;0;184;0;SEPTEMBER
600;SULAWESI BARAT;MAMUJU TENGAH;TOBADAK;SEJATI;152;82;31;2;29;2;0;5;1;152;0;SEPTEMBER
601;SULAWESI BARAT;MAMUJU TENGAH;TOBADAK;SALOADAK;269;119;35;1;95;10;0;7;0;267;2;SEPTEMBER
602;SULAWESI BARAT;MAMUJU TENGAH;PANGALE;POLO PANGALE;244;58;55;8;114;5;0;3;0;243;1;SEPTEMBER
603;SULAWESI BARAT;MAMUJU TENGAH;PANGALE;PANGALE;205;49;84;11;44;7;1;9;0;205;0;SEPTEMBER
604;SULAWESI BARAT;MAMUJU TENGAH;PANGALE;SARTANAMAJU;75;24;17;9;16;4;0;5;0;75;0;SEPTEMBER
605;SULAWESI BARAT;MAMUJU TENGAH;PANGALE;POLO LERENG;223;68;55;5;84;4;0;4;0;220;3;SEPTEMBER
606;SULAWESI BARAT;MAMUJU TENGAH;PANGALE;KUO;417;200;61;4;131;13;0;6;2;417;0;SEPTEMBER
607;SULAWESI BARAT;MAMUJU TENGAH;PANGALE;POLO CAMBA;148;49;50;9;34;1;0;2;3;148;0;SEPTEMBER
608;SULAWESI BARAT;MAMUJU TENGAH;PANGALE;LAMBA-LAMBA;127;40;36;6;42;2;0;1;0;127;0;SEPTEMBER
609;SULAWESI BARAT;MAMUJU TENGAH;PANGALE;KOMBILING;206;63;42;7;80;3;0;8;0;203;3;SEPTEMBER
610;SULAWESI BARAT;MAMUJU TENGAH;PANGALE;LEMO-LEMO;138;53;40;1;39;4;1;0;0;138;0;SEPTEMBER
611;SULAWESI BARAT;MAMUJU TENGAH;BUDONG-BUDONG;BABANA;623;291;100;12;181;21;2;15;0;622;1;SEPTEMBER
612;SULAWESI BARAT;MAMUJU TENGAH;BUDONG-BUDONG;LUMU;248;108;30;0;95;4;0;9;0;246;2;SEPTEMBER
613;SULAWESI BARAT;MAMUJU TENGAH;BUDONG-BUDONG;PONTANAKAYANG;324;185;23;11;90;5;0;2;1;317;7;SEPTEMBER
614;SULAWESI BARAT;MAMUJU TENGAH;BUDONG-BUDONG;SALOGATTA;550;208;98;15;191;12;0;9;0;533;17;SEPTEMBER
615;SULAWESI BARAT;MAMUJU TENGAH;BUDONG-BUDONG;KIRE;154;44;32;0;75;0;0;3;0;154;0;SEPTEMBER
616;SULAWESI BARAT;MAMUJU TENGAH;BUDONG-BUDONG;TINALI;221;110;36;0;68;1;0;6;0;221;0;SEPTEMBER
617;SULAWESI BARAT;MAMUJU TENGAH;BUDONG-BUDONG;SALUMANURUNG;151;66;51;3;22;3;0;6;0;151;0;SEPTEMBER
618;SULAWESI BARAT;MAMUJU TENGAH;BUDONG-BUDONG;PASAPA;169;75;44;1;36;0;0;8;0;164;5;SEPTEMBER
619;SULAWESI BARAT;MAMUJU TENGAH;BUDONG-BUDONG;BOJO;231;96;56;1;67;5;0;6;0;231;0;SEPTEMBER
620;SULAWESI BARAT;MAMUJU TENGAH;BUDONG-BUDONG;BARAKKANG;120;56;20;3;38;1;0;2;0;120;0;SEPTEMBER
621;SULAWESI BARAT;MAMUJU TENGAH;BUDONG-BUDONG;LEMBAH HADA;58;27;11;0;18;1;0;1;0;58;0;SEPTEMBER
622;SULAWESI BARAT;MAMUJU TENGAH;TOPOYO;BUDONG-BUDONG;246;102;67;5;47;8;0;10;0;239;7;SEPTEMBER
623;SULAWESI BARAT;MAMUJU TENGAH;TOPOYO;TOPOYO;910;301;215;16;185;58;0;27;0;802;108;SEPTEMBER
624;SULAWESI BARAT;MAMUJU TENGAH;TOPOYO;TUMBU;319;145;63;3;71;20;0;15;0;317;2;SEPTEMBER
625;SULAWESI BARAT;MAMUJU TENGAH;TOPOYO;KABUBU;272;71;38;19;127;12;1;4;0;272;0;SEPTEMBER
626;SULAWESI BARAT;MAMUJU TENGAH;TOPOYO;WAEPUTEH;283;155;25;17;75;5;0;3;0;280;3;SEPTEMBER
627;SULAWESI BARAT;MAMUJU TENGAH;TOPOYO;TANGKOU;125;58;28;0;32;3;0;2;2;125;0;SEPTEMBER
628;SULAWESI BARAT;MAMUJU TENGAH;TOPOYO;TABOLANG;450;160;99;12;108;9;1;10;2;401;49;SEPTEMBER
629;SULAWESI BARAT;MAMUJU TENGAH;TOPOYO;PARAILI;153;82;23;1;23;21;0;3;0;153;0;SEPTEMBER
630;SULAWESI BARAT;MAMUJU TENGAH;TOPOYO;SALUPANGKANG;467;133;61;11;249;8;0;3;1;466;1;SEPTEMBER
631;SULAWESI BARAT;MAMUJU TENGAH;TOPOYO;SALUPANGKANG IV;55;33;4;0;17;0;0;1;0;55;0;SEPTEMBER
632;SULAWESI BARAT;MAMUJU TENGAH;TOPOYO;TAPPILINA;152;45;38;11;36;15;0;7;0;152;0;SEPTEMBER
633;SULAWESI BARAT;MAMUJU TENGAH;TOPOYO;BAMBAMANURUNG;151;65;9;4;64;7;0;0;2;151;0;SEPTEMBER
634;SULAWESI BARAT;MAMUJU TENGAH;TOPOYO;SALULEKBO;387;153;86;6;137;3;0;1;0;386;1;SEPTEMBER
635;SULAWESI BARAT;MAMUJU TENGAH;TOPOYO;PANGALLOANG;255;83;57;2;105;6;0;2;0;255;0;SEPTEMBER
636;SULAWESI BARAT;MAMUJU TENGAH;TOPOYO;SINABATTA;98;43;31;1;15;5;0;2;0;97;1;SEPTEMBER
637;SULAWESI BARAT;MAMUJU TENGAH;KAROSSA;KAROSSA;614;290;118;7;169;12;1;16;1;614;0;SEPTEMBER
638;SULAWESI BARAT;MAMUJU TENGAH;KAROSSA;TASOKKO;429;167;108;7;113;9;0;25;0;429;0;SEPTEMBER
639;SULAWESI BARAT;MAMUJU TENGAH;KAROSSA;LARA;120;39;12;2;59;4;1;3;0;120;0;SEPTEMBER
640;SULAWESI BARAT;MAMUJU TENGAH;KAROSSA;KADAILA;152;49;27;0;72;3;0;1;0;152;0;SEPTEMBER
641;SULAWESI BARAT;MAMUJU TENGAH;KAROSSA;KAYU CALLA;70;25;12;5;26;1;0;0;0;69;1;SEPTEMBER
642;SULAWESI BARAT;MAMUJU TENGAH;KAROSSA;LEMBAH HOPO;131;40;11;9;58;1;0;11;0;130;1;SEPTEMBER
643;SULAWESI BARAT;MAMUJU TENGAH;KAROSSA;BENGGAULU;251;116;59;2;58;8;0;7;0;250;1;SEPTEMBER
644;SULAWESI BARAT;MAMUJU TENGAH;KAROSSA;SUKA MAJU;105;38;38;1;23;2;0;1;0;103;2;SEPTEMBER
645;SULAWESI BARAT;MAMUJU TENGAH;KAROSSA;KAMBUNONG;284;147;68;1;50;6;0;11;0;283;1;SEPTEMBER
646;SULAWESI BARAT;MAMUJU TENGAH;KAROSSA;SALUBIRO;158;82;33;1;33;0;0;9;0;158;0;SEPTEMBER
647;SULAWESI BARAT;MAMUJU TENGAH;KAROSSA;SANJANGO;150;57;35;0;50;1;4;3;0;150;0;SEPTEMBER
